gene_symbol	peps	Count
MRPS34	DSQIYAVDYETLTR,DSQIYAVDYETLTRPFSGR	2
TRIM32	IIDTAGLSEAVGLIMCR	1
SDHA	HTLSFVDVGTGK,VTLEYRPVIDKTLNEADCATIPPAIR,TLNEADCATIPPAIR,KHTLSFVDVGTGK	4
RPL14	GTAAAAAAAAAAAAAK,GTAAAAAAAAAAAAAAAK,GTAAAAAAAAAAAAAAAKVPAKK,GTAAAAAAAAAAAK,GTAAAAAAAAAAAAK,KAPGTKGTAAAAAAAAAAAAK,GTAAAAAAAAAAAAKVPAK,GTAAAAAAAAAAAAKVPAKK,KAPGTKGTAAAAAAAAAAAAAAAK	9
HPS4	DEAASTSSTYNFTYYDR	1
MAGEC1	TQSTFEGFPQSPLQIPVSR	1
LVRN	LQFIDDAFSLSK	1
MUC5AC	MDDPTEQCQDPVPEPPR,SHPEVSIEHLGQVVQCSHEEGLVCR,ICHRPEEITR,WFDVDFPSPGPQGGDKETYNNIIR,SSTTSAVTTSTTSGPETTPR,WFDVDFPSPGPQGGDK,EEGLVCQNQDQQGPFK,TCGLCGDFNGMPVVR,TTSAPTTSTTSVPTTSTISGPK,DVWGLEGCYPK,AKSHPEVSIEHLGQVVQCSHEEGLVCR,VPTASTTFAPTTR,GCPVTSASVTAPSTPSGR	13
KANK3	ELELLHASLEHQR,QEEDMAVVQR,SEGALQVLYGEVGSLDGTPQTR	3
C2orf72	AVFPPEPGAGKPGGAAAEGAGPGAAR	1
GFAP	QLQSLTCNLESLRGTNESLER,KTSLDTKSVSEGHLK,QLQSLTCNLESLR,VIPIQAHQIVNGAPPAR	4
PDCD6IP	EPSAPSIPTPAYQSLPAGGHAPTPPTPAPR,DLQQSIAREPSAPSIPTPAYQSLPAGGHAPTPPTPAPR,TMQGSEVVSVLK	3
ZNF154	LHTGEKPYECQECGK	1
ASCC2	TAYILQAVESAWEGVHR	1
DLAT	QTIPHYYLSINVNMGEVLLVR	1
TPSAB1	IIRDDMLCAGNSQR,YWMHFCGGSLIHPQWVLTAAHCLGPDVK,DRYWMHFCGGSLIHPQWVLTAAHCLGPDVK,IIRDDMLCAGNTR,DSCKGDSGGPLVCK,DDMLCAGNSQR	6
CFAP74	VVGVAIDLPVWVPKPSVDLK	1
EPPK1	EGQGEGETQEAAAAAAAR,EGQGEGETQEAAAAAAR,VIAETEER,VPVDVACR,EELLAEFGSGTLDLPVLTR,AEAEAGSPRPEPR,LAAELSATLEQAAATAR,QVVSAVTALVEAAER,GMLQPGTALVLLEAQAATGFVIDPVR,FLNPNTLER,LTAIIEEAEEAPGARPQLQDTWR,EELLAESGSGTLDLPALTR,LTAIIEEAEEAPGAWPQLQDAWR,GFFDPNTHENLTYVQLLQR,EGQGEGETQEATAAAR,RLTAIIEEAEEAPGARPQLQDTWR,EGQGEGETQEAAAAAAAAR,STTQELMEDDCVKR,CRPQEDTGWVLFPVNK,AVPVWDVLVSGYVSGAAR,EGQGEGETQEAAAAAAAAAR,MSIYQAMWKGMLQPGTALVLLEAQAATGFVIDPVR,EGQGEGETQEAAAATR	23
GSTM1	LGLDFPNGMLGSLVAQLSFPGFPSIQLPYLIDGTHK,HSLCGETEEEKIR	2
HEATR1	QEIFHQFVSLSTSGGK,LVPDLLAIVQHK	2
SPRR3	VPEPDYTK,VPVPGYTKVPEPCPSTVTPGPAQQK,VPEPDYTKVPEPGSIK,VPEPDYTKVPEPGSIKVPDQGFIK,VPEPCPSTVTPGPAQQK	5
OVGP1	EIPENSAVDQEA,TEITGATTVTSVGHQSMTPGEK,KEIPENSAVDQEA,TLTPVGHQSVSPGGTTMTPVHFQTETLR,TEITGATTMTSVGHQSMTPGEK	5
DAPL1	IQTLDALNDTLEK,IQTPDALNDALEK	2
ALDH1A3	LECGGSAVEDK	1
PDLIM5	ILGEVINALK,ISNSAAYSGSVAPANSALGQTQPSDQDTLVQRAEHIPAGK,ISNSAAYSGSVAPANSALGQTQPSDQDTLVQR,SMPESLDSPTSGRPGVTSLTTAAAFK,KILGEVINALK,PGVTSLTTAAAFKPVGSTGVIK,VTSTNNMAYNKAPRPFGSVFSPK,SMPESLDSPTSGRPGVTSLTTAAAFKPVGSTGVIK	8
MASP1	KNEINLESELKSEQVTE	1
MRPS2	LQGQKEPGDQGPAHPPGADMSR,EPGDQGPAHPPGADMSR	2
GDA	NYTSMYDKNNLLTNK,NYTSMYDK	2
GPX1	LAAAAAAQSVYAFSARPLAGGEPVSLGSLR,RFQTIDIEPDIETLLSQGPSCA	2
HSD17B4	TALDAFGRIDVVVNNAGILRDHSFAR,LSGDRNPLHIDPNFASLAGFDKPILHGLCTFGFSAR	2
IRAK4	LAAMVDITTEELKQQFNQEIK,MNDADSTSVETMYSVASQCLHEK	2
SFTPD	TAGFVKPFTEAQLLCTQAGGQLATPR	1
PFAS	SPVLHFYVRPSGHEGAASGHTR,RNGQGDAPPTPPPTPVDLELEWVLGK,GAHVVAGTAGYCFGNLHIPGYNLPWEDLSFQYPGNFAR	3
ASAH2	NSVQNQNHQTFLTVEK	1
PDE11A	LLASTASSSSPASVMVAKEDRN,VNLPQYPPTAIDYK	2
CYB5R2	THPDQFDLWYTLDRPPIGWK,TLADHLGMIAGGTGITPMWQLIR	2
FKBP15	LSEIQETSEQAQSK,CLSLQAQITALTK,FGAAVLGNHTTR,LSEIQETSEQAQSKFKSEK,LSEIQETSEQAQSKFK	5
PLEC	LQEAGILSAEELQQLAQGHTTVDELAR,AHAFVVQQK,LQAEEKAHAFVVQQK,KVPAQRLQEAGILSAEELQR,LAQGHTTVDELAWR,MLLQGSGCLAGIYLEDTK,FLEVQYLTGGLIEPDMPGR,GANVIAGVWLEEVGQK,VQSGSESVIQEYVDLRTR,EQLQQEQALLEEIERHGEKVEECQR,LKAGVAAPATQVVQVTLQSVQR,AGVAAPATQVVQVTLQSVQR,EQLQQEQALLEEIER,TRYSELTTLTSQYIK,SQVMDEAMALQLR,AHAFVVQQKEQELQQTLQQEQSVLDQLRGEAEAAR,FLEVQYLTGGLIEPDMPGRVPLDEALQR,HGYFDEEMNR	18
SORBS1	ASGSFAPISQAPPSFSPPPPLVPPAPEDLRR,NASGLVLPTDMDPTK,AVMNGLAPGSNGQDKDMDPTK,SEMSCIDGEK,SKSEMSCIDGEK	5
CTSG	NRNVSPVALPR,NVSPVALPR	2
ATF7IP	ADNNIDAIEETLETDDTTICSDRPPENEK,NKADNNIDAIEETLETDDTTICSDRPPENEK	2
ZZEF1	AVHEEVRPVDFK,AVHEEVRPVDFKQR	2
WASHC2C	LAAQESSEAEDMSIPR,RLAAQESSEAEDMSIPR,GLFDDEDEESDLFMEAPQDR	3
PSMB3	FGIQAQLVTTDFQK	1
ZMYM5	HEESEMHINNSVK	1
LRRC15	LYLSNNHISQLPPSIFMQLPQLNR,ELSLGIFGPMPNLR	2
PCM1	ALNVPPSLDCR,SKDASTSPPNRETIGSAQCK	2
MCM5	NTLSNIAMRPGLEGYALPR	1
NDUFB6	WLKDEELSPREPVLPPQK	1
CEP120	KDGPHGSVLEEGLDDYLTHLIEER,DGPHGSVLEEGLDDYLTHLIEER	2
COL6A2	DIASTPHELYRNDYATMLPDSTEINQDTINR,EQGLRDIASTPHELYRNDYATMLPDSTEINQDTINR,DYDSLAQPGFFDRFLR,DIASTPHELYRNDYATMLPDSTEINQDTINRIIK,AAVFHEKDYDSLAQPGFFDRFLR,DYDSLVQPGFFDR,VGVVQYSHEGTFEAIQLDDEHIDSLSSFK,NDYATMLPDSTEINQDTINRIIK,NDYATMLPDSTEINQDTINR	9
MYO9B	KGEPGAEPGHFGVCVDSLTSDK,TQAAVYLQAAWR	2
RINL	AGAGPPGAQGPGPEGQSLAPALR	1
GAA	YEVPLETPR,VHSRAPSPLYSVEFSEEPFGVIVHR,EPAIHSEGQWVTLPAPLDTINIHLR,NHNSLLSLPQEPYSFSKPAQQAMR,RYEVPLETPR,APSPLYSVEFSEEPFGVIVHR	6
PLBD2	DGPVPPASR	1
TCHH	QVGEIQSQEGK	1
MAP1A	DKALEQKNTALEQK,DTALEQKDKTLEPK,YSAQADITDDSLDR	3
MTTP	PTLLHLTHGK,DVNVENVNQHR,AVDSKYTAIPIVGQVFQSQCK,MKDVNVENVNQHR,ENLEALQRPTLLHLTHGK,DVNVENVNQHRGEK,YTAIPIVGQVFQSQCK	7
RGPD1	QTLPVTLR	1
GSTO1	LEVLTNKK,EDYDGLKEEFR,EDYDGLKEEFRK,SQNKEDYDGLK,SQNKEDYDGLKEEFR	5
FAM160B2	SMPVFLDPADIAALEGISWR	1
ESD	AFSEYLGTDQSK,AFSEYLGTDQSKWKAYDATHLVK,KAFSEYLGTDQSKWK,KAFSEYLGTDQSK,AFSEYLGTDQSKWK	5
CPS1	QAFITAQNHGYALDNALPAGWK,VLGTSVESIMASEDR	2
IGLV6-57	PGSSPTTVIYEDNQRPSGVPDR,TVTISCTR	2
CARMIL1	LGNDAVSQDSSSPALSSVER,KLGNDAVSQDSSSPALSSVER	2
SLFN11	EQDAEGQDYCTLTAFTLK	1
SLFN13	EQDAEGQDYCTLTAFTLK	1
POLR1A	FLEENADPSASEIREELEQYTTEIVQNNLLGSQGAHVK,FLEENADPSASEIR	2
IQCE	KAVLDEAVVVLQAAFR	1
TMEM106B	LNNISIIGPLDMK	1
PSG6	GQMTDLYHYITSYVVDGQIIYGPAYSGR	1
RRBP1	AEGAQNQDKKAEGAQNQGR,EHTLHLEAELEKHMAAASAECQNYAK,EKLHSLTQAKEESEK,LTAEFEEAQTSACLLQEELEKLR,LHSLTQAKEESEK,QKLTAEFEEAQTSACLLQEELEK,QKLTAEFEEAQTSACLLQEELEKLR,LTAEFEEAQTSACLLQEELEK,EKLHSLTQAK,EHTLHLEAELEK	10
TAGLN	LVNSLYPDGSKPLKVPENPPSMVFK	1
SLC2A9	ADISQEVEEVLAESR,ELGLVPLTDDTSHARPPGPGR,ADVSQEVEEVLAESHVQR	3
CHGB	GEQGEDSSEEKHLEEPGETQNAFLNER,ERADEPQWSLYPSNSQVSEEVKTR,PQSEESLDEEDKR,MAHGYGEESEEERGLEPGKGHHHR,GEQGEDSSEEKHLEEPGETQNAFLNERK,GYPGVQGPEDLEWER,APRPQSEESLDEEDKR,LLRDPADATEAHESSSRGEAGAPGEEDIQGPTK,ADEPQWSLYPSNSQVSEEVKTR,EDEEEEEGENYQKGEQGEDSSEEK,SSQESGEEAGSQENHPQESK,LLRDPADATEAHESSSR,ADEPQWSLYPSNSQVSEEVK,ERADEPQWSLYPSNSQVSEEVK,ASEEEPEYGEEIKGYPGVQGPEDLEWER,SQREDEEEEEGENYQKGEQGEDSSEEK,DPADATEAHESSSR,EKSSQESGEEAGSQENHPQESK,DHHSTHYRASEEEPEYGEEIKGYPGVQGPEDLEWER,EKSSQESGEEAGSQENHPQESKGQPR,DPADATEAHESSSRGEAGAPGEEDIQGPTK,SSQESGEEAGSQENHPQESKGQPR,DPADATEAHESSSRGEAGAPGEEDIQGPTKADTEK,GYPGVQGPEDLEWERYRGR	24
FGL2	GKCEEAEECPYQVSLPPLTIQLPK	1
SYNC	QQDVAQFADFQEVLTTR,AEQSPSVEENLSIEDLELLEGR	2
FRY	VAEQRPGSILYGTHGPLPPLYSVSLALLSSELAR,STGQLNMNPGTTSSNTATAER	2
IST1	GGSGGFTAPVGGPDGTVPMPMPMPMPSANTPFSYPLPK	1
UGT1A6	GFPCSLEHAFSSSPDPVSYIPR	1
TIMM44	ILDVDNVDLAMGK	1
HEXB	WHHEPAEFQAR,GILVDTSR,APSVSAKPGPALWPLPLSVK,PGPALWPLPLSVK	4
VWA8	AGTAFYIDQCAVHAATEGR,ETQDPTAQSLAASLSTGQLLR,LRETQDPTAQSLAASLSTGQLLR	3
CWH43	EGHNYENNHNFHMNTPK	1
SLCO2A1	FVFSLQTIPR	1
DDX18	STVLSNGEAAMQSSNSESKK,SPQKSTVLSNGEAAMQSSNSESK,STVLSNGEAAMQSSNSESK	3
PIH1D1	AESGPEKPHLNLWLEAPDLLLAEIDLPK,LLGLELSEAEAIGADSAR	2
PALMD	EKWLLDGISSGKQQEEMK	1
IGHV1-58	ASGFTFTSSAMQWVR	1
CWC22	YTSDKDVPSEQNNYSR	1
SUCLG2	LEGANVQEAQK	1
SCAF1	AARPPPAASATPTAQPLPQPPAPR	1
LAMC3	QEGQYLRPGEDER,TYGRHEGQYLRPGEDER,HEGQYLRPGEDER,SVGGSEHPPQWSPNGVLLSPEDEEELTAPGK,SVGGSEHSPQWSPNGVLLSPEDEEELTAPGK,EAFLEQMMGLEGAVK,LAQASHTCGSPPEDFCPHVGAAGAGAQCQR,LTSQMQATLQQASQQVLASEAR	8
DNAJC10	EIYLEVIHNIPDFELLSANTLEDR,AYQYHSYNGWNR,LHPDKNPNNPNAHGNFLK,LHPDKNPNNPNAHGNFLKINR	4
SLC25A22	ILAAQGQVSAQGGAQPSVEAPAAPR	1
SMTN	DPQVGHPAAQMEPEPAEPLAAAVEAANGAEQTR,LEKQGAAGSPGGPR,LEKQGAAGPGGPR,MEPEPAEPLAAAVEVANGAEQTR,VAVTQAAEVAVATMEPVAR,MEPEPAEPLAAAVEAANGAEQTR	6
ALG12	LHQLVPPQTDVLLHVDVAAAQTGVSR	1
IGHG2	WQQGNIFSCSVMHEALHNHYTQK,GFYPSDIAVEWESNGQPENNYKTTPPMLDSDGSFFLYSK,TPEVTCVVVDVSHEDPEVQFNWYVDGMEVHNAK,EPQVYTLTPSREEMTK,DTLMISRTPEVTCVVVDVSHEDPEVQFNWYVDGMEVHNAK	5
IGHG4	VVSVLTILHQDWLNGK,WQQGNIFSCSVMHEALHNHYTQK,EPQVYTLPPSPEEMTK	3
IGHG3	WQQGNIFSCSVMHEALHNHYTQK,NQVSLTCLVKGFYPSDIAMEWESSGQPENNYK,GFYPSDIAVEWESSGQPENNYK,GFYPSDIAMEWESSGQPENNYK,PAQASPSSSSSSSAPELLGGPSVFLFPPKPK,DTLMISRTPEVTCVVVDVSHQDPEVQFK,TPEVTCVVVDVSHQDPEVQFK,GFYPSDIAMEWESSGQPENNYKTTPPVLDSDGSFFLYSK,CPGKPAQASPSSSSSSSAPELLGGPSVFLFPPKPK,TPEVTCVVVDVSHQDPEVQFKWYVDGVEVHNAK,WQEGNIFSCSVMHEALHNR	11
ANXA8	DDVSSFVDPALALQDAQNLYAAGEK,ILVCLLQGSRDDVSSFVDPALALQDAQNLYAAGEK	2
TOR1AIP1	TPQEWAPHTAR,LQQQHSEQPPLQPSPVTTR,SSSQYIESFWQSSQSQNFTAHDKQR,RTTRLQQQHSEQPPLQPSPVTTR,TTRLQQQHSEQPPLQPSPVTTR	5
IGHV3-48	NSLYLQMNSLRDEDTAVYYCAR,NSLYLQINSLR,DNAKNSLYLQINSLR	3
GNAS	VPSLGYGSPAAGAASADTAAR	1
IFI16	TSLSAPPNTSSTENPKTVAK,LKTEPEEVFIEDSAQSDLK,SMKLPQEQSQLPNPSEASTTFPESHLR,LKTEPEEVFIEDSAQSDLKEVMVLNATESFVYEPK,TSLSAPPNTSSTENPK,LPQEQSQLPNPSEASTTFPESHLR	6
MACROD2	GQNDEENIQETSQVK,GQNDEENIQETSQVKK	2
LGALS8	FQVDLQNGSSVKPR,VAVNGVHSLQYK,SGTPQLSLPFAAR	3
RETREG2	LSSPLHFVNTHFNGAGSPQDGVK,DLGEGEEGELAPPEDLLGHPQALSR	2
AHCTF1	DDAQSVETVGKPK	1
ZNF326	SMDSYLNQSYGMNNHSGGGGGSR	1
COL7A1	ELETPLAVPGLR	1
SDR39U1	WNETFQKEVLGSR,AIMLLEGQKVIPR	2
ALDH1L1	EESFGPVMIVSR,PGFFFEPTVFTGVEDHMFIAK,LTFFNSTLNTSGPVPEGDALPIPGAHRPGVVTK,EGATLVCGGNQVPRPGFFFEPTVFTGVEDHMFIAK,LMKYCQHGVK	5
PDIA4	VREVSQPDWMPPPEVTLVLTK,MDATANNVPSDRYK,MDATANNVPSDR,EVSQPDWMPPPEVTLVLTK,MDATANNVPSDRYKVEGFPTIYFAPSGDK	5
GOLGA1	LEQNLSGEEHVQELLK,RLEQNLSGEEHVQELLK,RLEQNLSGEEHVQELLKEK	3
PIGR	YLCGAHSDGQLQEGSPIQAWQLFINEESTIPR,GVAGSSVAVLCPYNRK	2
WDR47	VLPFNAETCNATVSGPDLEFSMHDGTIR	1
EXOC2	GSSFQSGRDNTWR	1
PKP3	GVGGAVPGAVLEPVAPAPSVR	1
CCDC170	ASQDAVTTSQSQYSSFR	1
BIN2	FEQSANNFYQQQAEGHK,DERFEQSANNFYQQQAEGHK	2
AHNAK	VDIDAPDVDVHGTDWHLK,LEGPDVSLKVPGVDLPSVNLSMPK,VKGDVDVSLPKVEGDVK,ISVPDLDLNLKGPK,VDVEYPDVNIEGPEGK,VEGDMQVPDVDIKGPK,GDVDVSLPKVEGDVK,GPKVDIDVPDVGVQGPDWHLK,ADLDVSGPKVDVDIPDVNIEGPDAK,AEDPEVDVNLPK,GPTVGGGLPGTGVQGLEGNLQMPGIK,VEGDLKGPEVDIRGPK,GPKVDIDAPDVDVHGTDWHLK,VKGDMDVSLPKVEGDMQVPDVDIK	14
PRDM2	LTPPAGISATEIAK	1
SLK	KEPEVIVVSQPTEPQPVLIPSININSDSGENKEEIGSLSK,DQQKQQMFENKLIK,SEEEKDQQKQQMFENK,DVISNTSDVIGTYEAADVAQK	4
L1TD1	EADLTEEIEENLR	1
PLIN4	DAVCSGVTGAMNLAR,DTVCSGVTGAAK,NTLGSGVTGAANVAK,DTVCSGVTSAMNVAK,GLATDVATFTQGAAPGREDTGLLTTTHGPEEAPR,SVLTGTKDTVSTGLTGAVNLAK,TTQNIATGTKNTFGSGVTGAANVAK,GAMQTGLNTTQNIATGTKDAVCSGVTGAMNLAR,EDTGLLTTTHGPEEAPR,TVLTGTKDTVCSGVTSAMNVAK,EAVSSGVTGAMDMAK,TVLTGTKDTVCSGVTGAAK,NTLGSGVTGAVNVAK	13
LTBP4	TSAGMFPGSQPQAPASPVLPARPPPPPLPR,FCQLHSSGARPPAPAIPGLTR,SRGPGAPCQNVDECAR	3
HMCN2	ADVWDAGHYTCEALNQAGR,IHPTATHHITNEGVPASLPCVASGVPAPTITWTK,NYHVEVLIPPSISKDDPLGEVGVK,EGHPTSLSCECR,NAAGSTSVAFLVEIHTVPTIR	5
DMD	NQLEIYNQPNQEGPFDVQETEIAVQAK,KQAEVVDTEWEK,DQAANLMANHGDHCRK,QAEVVDTEWEKLNLHSADWQR,DQAANLMANHGDHCR,AEEWLKLLLEYQK	6
IQSEC1	YCICNSGVVR	1
PNPT1	EVGTSDKEILTSR,REVGTSDKEILTSR	2
MICAL3	ERQEDKDLEAAMLSK,QEDKDLEAAMLSK	2
RBM45	VNMFPFVGEQQSEFSSFDKNDSR	1
CFAP77	DSMFQNLLIVK	1
IGKV2D-40	FSDSGSGTDFTLK	1
IGKV2-40	FSDSGSGTDFTLK	1
SLC4A4	LIVPSQFKPTSPNR	1
PSMD5	GISSQPFPEQHCAALK	1
FCRL5	AATMPHSVISDSPR,GSLPILYQFHHEDAALER	2
TRMT13	RFCGEHAGAMEEEDAR,FCGEHAGAMEEEDAR	2
HLA-DQB1	VCRHNYEVAYR,HIYNREEYVRFDSDVGVYR,HNYEVGYR,HNYEVAYR,EEYVRFDSDVGVYR,TEALNHHNLLICSVTDFYPSQIK,HIYNREEYAR,PSAEYWNSQK,HIYNREEYVR,AVTPQGRPVAEYWNSQK	10
PSMD2	EWQELDDTEKVQR	1
ADAR	NTNSVPETAPAAIPETR,RNTNSVPETAPAAIPETR	2
HADHA	MVGVPASLDMMLTGR	1
KRT20	QIEELRNQIK,QIEELRNQIKDAQLQNAR,NQIKDAQLQNAR	3
ITGAE	TCSLSYVAGAPQYK	1
AK1	EVQQGEEFERRIGQPTLLLYVDAGPQTMTQR,IGQPTLLLYVDAGPQTMTQR,RIGQPTLLLYVDAGPQTMTQR	3
C3orf33	ENSALFCYLLVNK	1
CISD3	KQPFCDGSHFFQCTGLSPLK,QPFCDGSHFFQCTGLSPLK	2
PAPLN	ARDEGSYMCSAYQGSQAVSR	1
LAMA2	TRGIFAVQVDENRR,NLHMAEAPANLEQPTSSFHVGTCFANAQRGTYFDGTGFAK,QTGQAYYVILLNR,GIFAVQVDENRR,EGWECVFCGDECTGLLLSDLAR,NLHMAEAPANLEQPTSSFHVGTCFANAQR	6
NIPSNAP3B	EGVYELAVFQMKPGGPGLWGDAFER	1
MGAM	YEVPVPLNIPSMPSSTPQGQLYDVLIKK,GELFWDDGETKDTVANK,NRYEVPVPLNIPSMPSSTPQGQLYDVLIK,GELFWDDGETK	4
HBB	MVHLTPKEKSAVTALWGK,MVHLTPVEKSAVTALWGKVNVDEVGGEALGR	2
TDRP	GGPPPAAAAQAQVQGASFR,GRVLLDEPPEEEDGLRGGPPPAAAAQAQVQGASFR	2
LAMA5	YELYSETQR,CQAGFMSSR,ASQSLDGTYQGGGVCIDCQHHTAGVNCER,LELEEAATPEGHAMR,WLFPTGGSVR,DCQVIPLPPGLPLTHAQDLTPATSPAGPR,CDCTPCGTEACDPR,SPLGPHHETAQQLEVLEQQSTSLGQDAR,DDPSTPCVSCPCPLSVPSNNFAEGCVLR,ALFSQISSAVSLRR,RASQSLDGTYQGGGVCIDCQHHTAGVNCER,SKSTGDPWLDGSYLDGTGFAR,ALFSQISSAVSLR	13
ABR	GGGGDSGDPGRPDPEAESPR,GDPGRPDPQAESPR	2
GBP6	LQEQQQQMEAQVK,QKLQEQQQQMEAQVK,FPTDTLQELLDVHAACER,VKFPTDTLQELLDVHAACER	4
PPL	IEPDRAQVDEVLQLR,AQVDEVLQLREELEALRR,NRPDSGVEQAWK,ENLQLETR,AQVDEVLQLR	5
WDR62	PGIPGGTASLLEPTSGALGLFQGSPAR,PGIPGSTASLLEPTSGALGLFQGSPAR	2
ACOX1	HQSEMKPGEPEPQILDFQTQQYK	1
ELAC2	SSDSELNENEPHLPHGVSQR	1
TUBB8B	LHFFMPGFAPLTSQGSQQYR	1
CD99	NAIAEPAVQR,ENAEQGEVDVESHR,ENEQGEVDVESHR,LCFKENAEQGEVDVESHR,ENEQGEVNMESHR,ENGQLAGSLGPCIR,LCFKENAEQGEVNMESHR,KLCFKENAEQGEVDVESHR,ENAEQGEVNMESHR,KLCFKENAEQGEVNMESHR	10
EIF4G1	EAALPPVSPPK	1
SYNM	STFQSVVSESPQEDSAGDTSGAEMTSGVSR,VELGVIGNSVHMEGLPGSSTSIR,VVNVEIVEEPVSYVSGEKLEEFSVPFK,ELYIPLGESEVAGGASHSSGQR,ENEWNLFSR,EGFSGQIQFTAPLSDKVELGVIGNSVHMEGLPGSSTSIR,ALLEGESNPEIVIWAEHIENMPSEFR,SYHYTDSLLQRENEWNLFSR	8
SCFD2	ALAQVFCEESGSSPLLQK,KALAQVFCEESGSSPLLQK	2
SEC23A	DLSAKQLQEMLGLSKVPVTQATR,QLQEMLGLSKVPVTQATR,VPVTQATRGPQVQQPPPSNR	3
MMUT	EDTVEVLAIDNTSVR,SSRDQALAEHCLAALTECAASGDGNILALAVDASR,EVAQQAVDADVHAVGVSTLAAGHK,DQALAEHCLAALTECAASGDGNILALAVDASR,MVSGAYRQEFGQSKEITSAIK,MVSGAYRQEFGQSK,YQLEKEDTVEVLAIDNTSVR	7
KIF16B	HSTLGTEIEEQR	1
COL1A1	GETGPAGPTGPVGPVGAR,SGDRGETGPAGPTGPVGPVGAR	2
AKAP10	MIVSDVMQQAQYDQPLEK	1
IGLV3-21	SVHWYQQKPGQAPVLVIYYDSDRPSGIPER	1
DST	LNVLESLIK,KLEALIASNDNANK,AAECSDFPVPSTEGTPIQGSK,KPQYEQLTAAGQGILSRPGEDPSLHGIVK	4
EML2	SNGGNLLCAVDESNDHMFSVWDWAK,GRPVPMVIPDELAPTYSLDTR,SHIYFWTLDGGSLSK	3
JCAD	NANSQEDAEELKATTR,NANSQEDAEELK	2
PALM3	KAEESMGIGSEEKPGR,AEESMGIGSEEKPGR	2
WDR36	VGVTALQQAPAVDVVAVGLMSGQVIIHNIK	1
CCDC187	SGMEPQVALPSPWPGEGR,QQIQAGLELAQAHK	2
ATRX	EQSFTSLEVR	1
SPTB	WISAMEDQLQSDDPGK,ETWLNENQR,AAMRETWLNENQR,WISAMEDQLQSDDPGKDLTSVNR,LEGLDTGWDALGR	5
AGT	TGCSLTGASVDSTLAFNTYVHFQGK,ADSQAQLLLSMVVGVFTAPGLHLK	2
MYBBP1A	SEDGTPAEDGTPAATGGSQPPSLGR,KSEDGTPAEDGTPAATGGSQPPSLGR,DPAEPMSPGEATQSGARPADR	3
FLNB	ADIEMPFDPSKVVASGPGLQHGK,VVASGPGLQHGK,GLVEPVNMVDNGDGTHTVTYTPSQEGPYMVSVK,VGEAGLLSVNCSEAGPGALGLEAVSDSGTKAEVSIQNNK,TGLVEPVNMVDNGDGTHTVTYTPSQEGPYMVSVK,VGEAGLLSVNCSEAGPGALGLEAVSDSGTK	6
MDN1	ALRETLLAQPAAGQATIPEWCQGSAPSGLEGELLR,LVASELHTSLYSSMVGADR,FTFAATRPSSVLVEQLAVCVSK	3
LCLAT1	YPVDTLPTSK	1
WASHC1	MQHSLAGQTYAVPLIQPDLRR,ATSQGGDLMSDLFNK,MQHSLAGQTYAVPLIQPDLR	3
WASH6P	ATSQGGDLMSDLFNK	1
ADAMTSL4	EACDVGPCTTAWFHSDWSSK	1
ADH1C	FSLDALITNVLPFEK,KFSLDALITNVLPFEK	2
SYNE2	QATSDVQESTQESATVEK,DKVPSLTTYEGGDLNNTLEDLR,IQILNNWMEAQEER,EKQATSDVQESTQESATVEK,TNVLNHAYENLTR,QEELESTVAR,QEMECCLNNILK,EFVSFSDKPVDQIVVEEK,QLVASVSCAELEGQIAK,LLEHVTQEQNELLK,ENPDSFLNHVLALTAQSPNIEHLNEVSLK,FQQLANISMSGNNLAEILPPALQDIKELQHNVQK,LNAEESDKLYK,LENHVNDLK	14
LAMA3	YVNPGNEAVSGHITIYPSWGAAQSK,VLAVPAENYDYQILHKK,VLAVPAENYDYQILHK	3
IGHV3-15	LSCAASGFTFSNAWMNWVR	1
CR1	SFFSLTEIIR,VCQPPPEILHGER,TPPDPVNGMVHVITDIHVGSR,SFFSLTEIVR	4
PKP2	AVSMLEADHMPPSR,ENYLTVGLTVGQVRPLVPLQPVTQNR	2
NXPE4	HCYPLIGSMTYSVK	1
TNS1	WIQPEEDEGK,WIQPEEDEGKVVVR,KQGSTTDNACHLFAELDPNQPASAIVSFVSK,EATSDPSWTPEEEPLNLEGLVAHR,GLNSWQQQQQQQQQQQPRPPPR,QGAACNVLFINSVDMESLTGPQAISK,QGSTTDNACHLFAELDPNQPASAIVSFVSK,TVGTNTPPSPGFGR,RWIQPEPR	9
GLRX3	HASSGSFLSSANEHLKEDLNLR,HASSGSFLSSANEHLK	2
CALCOCO2	QNPGLAYGNPYSGIQESSSASPLSIKK,GASIPFQFRPENEEDILVVTTQEEVEEIEQHNK	2
TBCC	QNQEVEKENSHFFVATFAR,ENSHFFVATFAR	2
MGA	ISQLEKELIEDLKSLR	1
IGKV1D-39	ASQSISGYLNWYQQRPGKAPK,ASQSISGYLNWYQQRPGK,VTITCRASQSISGYLNWYQQRPGK	3
ECI2	DFENSINQVK,AFAKLPPNVLR,ASQKDFENSINQVK,LKAFAKLPPNVLR	4
ABCB10	LYNPASGTISLDGHDIR	1
CEACAM5	QIVGYAIGTQQATPGPAYSGR,NDVGPYECGIQNK	2
CEACAM3	QIVGYAIGTQQATPGPAYSGR	1
OTC	LLLTNDPLEAAHGGNVLITDTWISMGREEEK,DLLTLRNFTGEEIK	2
ARHGEF28	ELTVCSSSEEQK,SATSLESESDNNSCR	2
R3HCC1	KQEEWGLTSTSVLKR,KQEEWGLTSTSVLK,IQWVDDTHALGIFPCR,IHLDTSSFMEELPGEK	4
DHFR2	ELKEAPQGAHFLAR	1
MPP7	ALFNYNPNEDKAIPCKEAGLSFK,ALFNYNPNEDK,ALFNYNPNEDKAIPCK	3
CUL3	QLTLQHHMGSADLNATFYGPIKK	1
SEPTIN14	MGFTNVGPNNQPVSFQEIFEAKR,MGFTNVGPNNQPVSFQEIFEAK	2
IGHV3-64	MTEFGLSWVFLVAIFKGVQCEVQLVESGGGLVQPGGSLR,MMEFGLSWVFLVAIFKGVQCEVQLVESGGGLVQPGGSLR	2
MRPL12	IQDVGLVPMGGVMPGAVPAAAAQEAVEEDIPIAK	1
GSTM3	MAQWGNKPIC	1
PLIN3	QRAQEALLQLSQALSLMETVK,AQEALLQLSQALSLMETVK,QRVQEALLQLSQALSLMETVK	3
SHMT2	GWTGQESLLDSDPEMWELLQR	1
NIPA1	GTAAAAAAAAAAAAGEGAR	1
IGHV3-38	DNSKNTLYLQMK,NTLYLQMKSLRAEGTAVYYCAR,NTLYLQMK	3
UGT2B4	IHHDQPVKPLER	1
KRT18	STSFRGGMGSGGLATGIAAGLAGMGGIQNEK,GGMGSGGLATGIAAGLAGMGGIQNEK	2
MRPS22	TFKPALQELKPPTYK	1
R3HDM2	HSDLAALYTIVAVFPSPLAAQNASLHLNNSVSR	1
C2CD4B	AESLVGGAPGPR	1
SLC16A1	AAESPDQKDTEGGPKEEESPV,DTEGGPKEEESPV	2
PCSK1	DELEEGAPSEAMLR,RDELEEGAPSEAMLR,SPSSSSVGGRRDELEEGAPSEAMLR,CAGEIAMQADNHK	4
DEPTOR	TVNNLILTGPR,LMEHGIIQHVSSK	2
DCTN1	EQLDMAGAQVR	1
UAP1L1	TLYQLQAQR	1
IL1RL1	FLPAEVADSGIYTCIVR	1
DNAJC13	SSKPSDMSVQVCGYISK	1
PRKDC	KEEENASVTDSAELQAYPALVVEK,LLEEALLCLLPAELPAKR,LLEEALLCLLPAELPAK	3
SLC30A9	VPSFETAEGIGAELKAPLKQEPLQVR,VPSFETAEGIGAELKAPLK,VEKVPSFETAEGIGAELKAPLK,VPSFETAEGIGAELK,VEKVPSFETAEGIGAELK	5
NQO2	VLIVYAHQEPR,ATDKDITDTLSNPEVFNYGVETHEAYK	2
ANXA11	GFGTDEQAIIDCLGSCSNK	1
PLEKHM2	KLQSYFAACEDETPAIR,LQSYFAACEDETPAIR	2
ANXA2	SALSGHLETLILGLLK,SALSGHLETLILGLLKTPAQYDASELKASMK	2
TRIM65	TLTLCHQPGAVFPPGPQEEVLS	1
C8A	RQCDNPAPQNGGASCPGR,QCDNPAPQNGGASCPGR,SLKYNPVVINFEMQPIHEVLR,YNPVVINFEMQPIHEVLR,ECDNPAPQNGGASCLGR,QCDNPAPQNGGASCPGRK,RRECDNPAPQNGGASCLGR,RECDNPAPQNGGASCLGR	8
DHRSX	LLAAEGSHVTANVVDPGVVNTDLYK,TPDEGAWTSIYAAVTPELEGVGGR	2
ZPBP2	ILDILISDLSCHVIEPSYK	1
PGM1	IAAANGIGRLVVGQNGILSTPAVSCIIR,ICIDAMHGVVGPYVK,LVVGQNGILSTPAVSCIIR,LKICIDAMHGVVGPYVK,LVVGQNGILSTPAVSCIIRK	5
ADAP1	FHYLQVAFPGASDADLVPK	1
MFN1	LATEDDLVEMQGYK	1
SPG7	VLQDNLDKLQALADALLEK	1
MAP7	ALREWEEAER,ALREWEEAERAQR	2
C1R	QGYQLLEGNQVLHSFTAVCQDDGTWHR	1
SGCD	EIQSQPGNALYFK	1
ABCB1	NVHFNYPSRK,NVHFNYPSR	2
THEM5	NLIPVGSLVVMDVEVDKIEDQK	1
NIBAN1	ASAILPGVLGSETLSNEVFQESEEEKQPEVPSLLAK,RASAILPGVPGSETLSNEVFQESEEEKQPEVPSSLAK	2
IQGAP2	KYDYYYNTDSKESSWVTPESCFYK,VLWLDEIQQAVDDANVDEDR,VLWLDEIQQAVDEANVDEDR,VLWLDEIQQAVDEANVDEDRAK,QTFIDNTDSVVK,RQTFIDNTDSVVK,ESSWVTPESCFYK	7
SFT2D3	AEEPGDGPAEEWLGR	1
CRISP3	TPNSVVGHYTQVVWYSSYLVGCGNAYCPNQK	1
ZXDC	VNLASRPEQGPSGPAAAPGPGVAPAGAVTISSQDLLVR	1
STYXL2	SRNWEDVEESSK	1
TG	LLALSGPFHYWGPVIDGHFLR,QFEESQGR,QFEESQGRTSSK,MCSADYAGLLQTFQVFILDELTAR,AVLMGGSALSPATVISHER,PMSLGSWQSLALSSVVVDPSIR,WCDADPCCTGFGFLNVSQLK,CPTPCQLQAEQAFLR,AVKQFEESQGR,SGPYVPQCDAFGSWEPVQCHAGTGHCWCVDEK,KCPTPCQLQAEQAFLR	11
GPX8	FWRPEEPIEVIRPDIAALVR	1
ITGA9	SEDCAADLQLR	1
TTC9	AASPAGALKPGR	1
ASMTL	FSSACDMGGCTGALAR,HDPIPAADTFEDLSDVEGGGSEPTQR,SVKHDPIPAADTFEDLSDVEGGGSEPTQR	3
F2	NPDSSTMGPWCYTTDPTVR	1
BPIFB1	ALGFEAAESSLSK	1
TP53BP1	VPETVSAATQTVK,SLVQESLSTNSSDLVAPSPDAFR	2
BSN	PLLQAQGLTPSER,PRPESSQEPAALPK,GPHDGPSQPTGPR	3
BOD1L1	DGIAVDHVVGLNAEK	1
CYP20A1	TLDPFETMLK,LTPVSAQFQDIEGK	2
NEIL2	EAFGTEDGLQR	1
OGFR	TPSETPGPSPAGPTR,EGTPGSPSETPGPR	2
SYTL4	TSIKRDTVNPLYDETLR,DTVNPLYDETLRYEIPESLLAQR,RDTVNPLYDETLRYEIPESLLAQR,DTVNPLYDETLR	4
ALDH1B1	LLNLLADLVER,LLNLLADLVERDR,EAGFPPGVVNIITGYGPTAGAAIAQHMDVDK	3
CBWD2	IPVTVITGYLGAGK	1
WDR45B	GLCVLCPNSNNSLLAFPGTHTGR	1
AGXT2	GAYHGCSPYTLGLTNVGIYK,IAPSMCITKPEVDFALEVFR	2
KRT13	RDAEEWFHAK,DAEEWFHAK	2
ARHGEF18	RLGSANGQAEDGGSSTGPPR,SAMSEIEGIQSLICRR	2
FRA10AC1	MHGHGGYDSDFSDDEHCGESSK	1
SGSM2	HSSGSASEDKLAACAR	1
CRYBG3	GFTGNTEGSMLK,SSPSSVTNSSYDGESDSQHHLSCEPVFQTNR	2
EFHB	GMDTINTTFGTAVIK,ISILANTLINPQPITTFQQK	2
EIF5B	VEGNTVHIEVK	1
SGCG	LYLSVAGVSTTCQEHSHICL	1
FUT8	YATGGWETVFRPVSETCK	1
CAMKK1	NEPVVFPEGPEISEELKDLILK,NEPVVFPEGPEISEELK,IKNEPVVFPEGPEISEELK,IKNEPVVFPEGPEISEELKDLILK	4
BLVRA	MNTEPERK	1
KANK4	NGNTALHYSVSHSNFSIAK,ALSQHLPETGTATDQLLR,LLLAHPACNSSLTDK	3
HSPG2	ASYAQQPTESR,TYGLMDSHTVLQISSAKPSDAGTYVCLAQNALGTAQK,GSIYIGGAPDVATLTGGR,YELARGMLEPVQRPDVVLVGAGYR,TYGLMDSHTVLQISSAK,LRSPLPWQYR,LENNMLMLPSVRPQDAGTYICTATNR,LENNMLMLPSVQPQDAGTYVCTATNR,GMLEPVQRPDVVLVGAGYR,SPLPWQYR,CSATGSPVPTIHWSK	11
MMP9	LDSVFEEPLSK,MFPGVPLDTHDVFQYQEK,KLDSVFEEPLSKK,KLDSVFEEPLSK	4
RTN4	KPAAGLSAAPVPTTPAAGAPLMDFGNDFVPPAPR	1
GMPR	AFGAGADFVMLGGMFSGHTECAGEVIER	1
GLOD4	LLDDAMSADKSDEWFAK,LLDDAMADDKSDEWFAK	2
MYH11	DVASLSSQIQDTQELLQEETRQKLNVSTK,DVASLSSQIQDTQELLQEETR,ENTDLAGELR,QTLEKENTDLAGELR,LQNEAESVTGMLNEAEGK,LAKDVASLSSQIQDTQELLQEETR,NKQTLEKENTDLAGELR	7
GCKR	TNHIQALAHSTVGQTLPIPLK	1
FNDC3A	TLSTDSIQYHLQMQDKNGR,TLSTDSIQYHLQMQDK	2
DPP3	LEGSDVQLLEYK,KLIVQPNTHLEGSDVQLLEYEASAAGLIR	2
EEPD1	AVVAEKPSNQLQK,VGSHDLTLVNLHLAALTLLGSENSSK	2
HLA-DQA1	FDPQFALTNIAVTK,QFRFDPQFALTNIAVTK	2
ABCA7	KEEWQPGQQSR	1
OBSCN	LHVSLMENYPGTLEALGEPIR,EQGTATMEVQLSHADVEGSWTR,RLVVQQAGQADAGEYSCK,DAVASAWLTVLGLPDPPEDAEVVAR,LHVSLMENCPGTLQALGEPIR,RLVVQQAGQADAGEYSCEAGSQR,LVVQQAGQADAGEYSCEAGSQR,HHHIDQLGDGTCSLLITGLGR,GLVVHDVSPEDAGLYTCHMGSEETR,LVVQQAGQADAGEYSCK	10
SORBS3	SPADPTDLGGQTSPR,HPSSPSALRSPADPTDLGGQTSPR,TGFSFPAQEPR,SPADPTDLGGQTSPRR	4
CEP135	VAQIQTDYDALKR	1
GPCPD1	SAGILILPIMSR	1
FAM120B	QEVPMCTDSEPR,QEVPMCTGPEPR,EVPVYTYSEPR,QEVPTCSDPEPR	4
HLA-C	YFYTAVSRPSR,SWTAADTAAQISQR,GHDQLAYDGKDYIALNEDLR,GYDQFAYDGKDYIALNEDLR,YFSTSVSWPGRGEPR,GYDQFAYDGK,MFGCDLGPDGR,YFSTSVSWPGR,EPWVEQEGPEYWDR	9
EPS8	GFNPVTVNSLGVLNGAQLFSLNKEELR	1
ISG15	CDEPLNILVR,VPLASQGLGPGSTVLLVVDKCDEPLNILVR	2
SP100	TSLNEQTYTR	1
PRUNE2	ADGENPDILTHCEHDSNSQASDSPDICHDSEAKEETEK,AGPDAVTHDNEWEMLSPQPVQK,SLDFGDVPIDSDVHVSSTR,EDHDEALKNTWDLHPTSSK,AGPDAVTHDSEWEMLSPQPVQK,QEEIISILEEK,EIPELEEEK,EIPELEEEKTIPTKEPEQIK,ISEKQEEIISILEEK	9
ACOT9	SLEICHPQQR	1
LMBRD1	CDAEAPEDQCTVTR,RCDAEAPEDQCTVTR	2
NOP56	LAALALASSENSSSTPEECEETSEKPK,IGAAIQEELGYNCQTGGVIAEVLR,FSKEEPVSSGPEEAAGK,KFSKEEPVSSGPEEAAGK,EEPVSSGPEEAAGK	5
IGKV2D-28	SSQSLLHSNGYNYLNWYLQK	1
DMGDH	VGVTDLSPFGK,MIGLEHPLIPVQHQYVVTSTIPEVK	2
C1RL	WILTAAHTVYPK,VQNHCQEPYYQATAAGALTCATPGTWK	2
ALDH4A1	GRMEAIPCVVGDEEVWTSDVQYQMSPFNHGHK,MEAIPCVVGDEEVWTSDVQYQMSPFNHGHK,ETLQLIDSTTSYGLTGAVFSQDKDVVQEATK,YKETLQLIDSTTSYGLTGAVFSQDKDVVQEATK	4
HORMAD1	DKDVEDEQEHYISDDLDIETK	1
ASAH1	LTIYTTLIDVTK,KDAMWIGFLTR,WHELMLDKAPMLK,VMQVVDEK	4
NDUFA6	QVTSTASTFVKPIFSR,AGSGVRQVTSTASTFVKPIFSR	2
TSTD2	HVATQHADEIYHQTDSILK	1
FAM241A	EAAGTEWDPGASPR	1
PGP	TILTLTGVSTLGNVKNNQESDCVSK	1
ERVW-1	EVISQLTQVHGTSSPYK	1
TMEM231	ALYEVFSHPVER	1
CAPG	MQYAPNTQVEILPQGR	1
PLXND1	EDLGHLCVWSDGCR,YTLNEEWLLR,GPLQPMAGTCPAPEIR	3
ADH1B	MVAVGICR,SIHTVLTF,IKMVAVGICR	3
CORO7	DKQLQIFDPR,QLQIFDPR,KPGRLPDTALPTLQNGAAVTDLAWDPFNPHR,LPDTALPTLQNGAAVTDLAWDPFNPHR	4
ALDH5A1	VYGDIIYTPAKDR,RVYGDIIYTPAKDR,RVYGDIIYTPAK,VYGDIIYTPAK	4
apol1	SKLEDNIRR	1
APOL1	SKLEDNIRR	1
CTSC	GTDECAIESVAVAATPIPKL,KVGTASENVYVNTAHLK,GTDECAIESVAVAATPIPK,VGTASENVYVNTAHLK	4
PIBF1	DFELTEEQYVK	1
AGMAT	IREESVMLR,QIQEAYEK	2
COL6A5	LINLGGENIR	1
ADAMTS5	VTDGTECRPYSNSVCVR	1
RBFA	GLGGLVWQGQVAELTTQMQK	1
KCNJ11	LAEDPAEPR	1
ATP7B	DAAPQTFSVLIGNR	1
AMPD2	ASLQASTTAPEAR	1
COL14A1	TLTYFNYDQSGDFQTLTFEGPEIRK,TLTYFNYDQSGDFQTLTFEGPEIR	2
MRC1	GYEAMYTLLGNANGAICAFPFKFENK,GYEAMYTLLGNANGAICAFPFK	2
FLG	QGSSVSQDSDSQGHSEDSERR,RPGSSVSQDSDSEGHSEDSER,RQGSSVSQDSDSQGHSEDSER,NSSRHSASQEGQDTIR,PRGSSVSQDSDSQGHSEDSER,HSAYQDGQDTIRGHPGSSR,HSASQEGQDTIRAHPGSSR,HSAYQDGQDTIR,GSSGSQASDSEGHSEDSDTQSVSAHGQAGPHQQSHQQSTR,HTQTSSGGQAASSHEQARSSAGDR,HSVSQEGQDTIRGHPGSSR,TSRPRGSSVSQDSDSQGHSEDSER,GSSGTQASDSEGHSEDSDTQSVSAHGQAGPHQQSHQQSTR,QGSHYEQSVDRSGHSGSHHSHTTSQGRSDASHGQSGSR	14
SYNE1	GAVALSGDHSALESQIR,VPTNLAVEEALSLQDGCR,TYLDLLCSMCDLSNASVKTTAKDIQQTEQTIEQR,DSLFVLHELGEQLK,GAVALSGDHSALESQIRQLGK,STKGGSDSSLSEPGPGQSGR,GAVALSDVMIPESPEAYVK,TGQTILPSLNEVNHSYLSEK,TTAKDIQQTEQTIEQR,DIQQTEQTIEQR,QADIVTFPEINLMNESTELHTQLAK,CTAQWHNYQK	12
USH1C	IVTDYTLAEADAALQK	1
PEX2	LLGIHSVFCKPQNIR	1
STAU1	VTFFEPGSGNENGTSNKEDEFR	1
BAIAP2	SMSRNPFAHVR	1
TXNRD2	VSVVDYVEPSPQGTR,RLPDGQLQVTWEDR,QILLSADHIIIATGGR,KVSVVDYVEPSPQGTRWGLGGTCVNVGCIPK,EATSVPHIYAIGDVVEGRPELTPTAIMAGR,KVSVVDYVEPSPQGTR	6
GPAM	HTSEEWGECGFRPTVFR	1
WNT6	GRAPPRPSGLPGTPGPR	1
LPO	ILGAFMQIITFR,KILGAFMQIITFR	2
NUMA1	EVACLETLVR	1
STING1	FLDKLPQQTADR,LFCQTLEDILADAPESQNNCR,FLDKLPQQTGDR	3
TYW3	QLQDAQILHSVAIDSGFR	1
VILL	EVVDGSPAAASTISEITAEVNNFR	1
LGALS2	ITGSIANGTDGFVINLGQGTDKLNLHFNPR,ITGSIANGTDGFVINLGQGTDK	2
DROSHA	SYGLLVVPEPAGCTPELPGEIIK	1
PTPN18	GAPAGAGSGTQTGTGTGAR,RGAPAGAGSGTQTGTGTGAR	2
FTCD	RTVALQEGLRR,TVALQEGLRR,TVALQEGLR,VQGIGWYLDEKK,GVSMDECVLCAQAFGQR	5
SERINC2	LPWVCEEGAGIPTVLQGHINCGSLLGYR	1
PAICS	DDANNDPQWCEEQLIAAK,VELFFKDDANNDPQWCEEQLIAAK	2
TOPORS	EEGEAPSPAPASEGR	1
CENPV	SGASGASAAPAASAAAALAPSATR,SGASGASAAPAASAAAALAPSATRTR,RSGASGASAAPAASAAAALAPSATR	3
R3HDM1	DNSSFDKDDNQVR	1
RTN3	AEPSEATQSHSISSSSFGAEPSAPGGGGSPGACPALGTK	1
MCEE	MELLHPLGLDSPIAGFLQK,NILGAQVSEVVPLPEHGVSVVFVNLGNTK	2
CES1	KGDVKPLAEQISITAGCK,FTPPQPAEPWNFVK	2
LAMC1	CQPGFHSLTEAGCRPCSCDPSGSIDECNVETGR,LQNIQNTIEETGNLAEQAR,ACNCNPYGTMK,PCSCDPSGSIDECNVETGR	4
RASAL1	GLAGHFLDYLTR	1
SACM1L	LEEQDEFEKIFK,LGVLHVGQKLEEQDEFEKIFK	2
ATG7	RDVEQLEQLIESHDVAFLLMDTR,DVEQLEQLIESHDVAFLLMDTR	2
ERF	SGGSAGGLAEGAGVLAPPPPPPQIK	1
ELAPOR1	RTPDGFDSVPLKTSSGGPDMDL,VAVPHTPGLCTSLPDPVK,TPDGFDSVPLKTSSGGPDMDL,DSGTCHSCPPNTILK	4
MRPS31	IQFDEGYDNYPGQEKMDDLKK,EAPETDTSPSLWNVEFAK	2
EIF3A	GMDDDWGPR	1
MRTFA	GVAPPTLITNSTGTHLVLTVTNK	1
SARDH	AADWLFSADVSRPPGSTVYTCMLNHHGGTESDLTVSR	1
ODAD2	TSHENMLIPVVGTLQECASEENYQAAIK	1
C17orf58	AAEVAPAVR,EGQIQGAVHTQCI	2
PRG4	VTTPDMSTTQHNK,RPALNYPVYGEMTQVR	2
ASCC3	TSIECLPELIHACGGK,IISHFSQDDFTALVQMTEK	2
NCAN	QDLSILVAK	1
TUSC1	LPGEGGDGTPAEAR	1
XDH	ITYEELPAIITIEDAVKNNSFYGPELK	1
TNKS1BP1	SSQFGIIGNDR,YESQEPLAGQESPLSLATR,VPSSDEEVAEEPQSR,APVIRPGGTLGLSEAADSDAR	4
IGHV2-70	IDWDDEKYYSTSLK,ALEWLARIDWDDDKYSTSLK,NQVVLTMTNMDPVDTGTYYCAR	3
HRC	EEEEDDDDDDDDVSTEYGHQAHR	1
AKAP12	VSVAIEEDLEPENGILELETK,TEETATEMLTSELQTQAHMIK,EGEDPQASAQDETPITSAK,EGEDPQASAQDETPITSAKEESESTAVGQAHSDISK,KDEGEGAAGAGDHQDPSLGAGEAASK,ADSQDAGQETEKEGEDPQASAQDETPITSAK,DEGEGAAGAGDHQDPSLGAGEAASK	7
MAP4	TSDMAPSKETEMALAKDMALATK,VALSSQTEVALAR,GISEDSHLESLQDVGQSAAPTFMISPETITGTGKK,GISEDSHLESLQDVGQSAAPTFMISPETITGTGK	4
CCN3	VTNRNHQCEMLKQTR	1
GBP1	VQLPTESLQELLDLHR,VQLPTESLQELLDLHRDSEREAIEVFIR,CSGLLQVIFSPLEEEVKAGIYSKPGGYR,VQLPTESLQELLDLHRDSER,CSGLLQVIFSPLEEEVK,LQDEELDPEFVQK	6
IFIT2	KAEALIQQEHADQAEIR,VCSILASLHALADQYEEAEYYFQK	2
VIL1	QVVVEGQEPAKFWMALGGK,ANFLNSNDVFVIK	2
SEMA4B	GYQSLSDSPPGAR	1
EFNA1	ITHSPQAHVNPQEK	1
POMT1	ITQGQPLEVAFGSQITLR	1
COQ7	KFNELMVMFR,FNELMVMFR	2
CARD19	YLLAFLADDLGR	1
KLKB1	ITQQMVCAGYK	1
SERPINB10	TYFGAEPQSVNFVEASDQIR,TYFGAEPQSVNFVEASDQIRK	2
IGKV1-27	ASQGISNFLAWYQQKPGK,LLISAASTLQSGVPSR,LLIYAASALQSGVPSR	3
A2M	EQVPHCICANGR,DLTGFPGPLNDQDDEDCINR	2
MTMR6	TIEGSSPADNRYSEYTEEFSK,YSEYTEEFSK,AVMDAAVFLAK	3
PRAM1	KFSQPELSEHPQK,APLPEFGAVSLKPPQPQFTDLPK,FSQPELSEHPQK	3
IGLV1-51	LLIYENNKRPSGIPDR,LLIYENNKR	2
EEF1A2	GPFKYAWVLDK,VETGILRPGMGVTFAPVNITTEVK,ATQAALSLLEALDTILPPTRPTDKPLR	3
WDR37	EFENLYIENIELR,EFENLYIENIELRR	2
PPP2R3A	IETAFMDIEEQKANIYEMGK,SVDLDLLCGHYNNDGNSPSFGLLR	2
DENND2B	TFEYEAEKNPK,RTFEYEAEK,RTFEYEAEKNPK	3
KRT7	NKYEDEINR,NKYEDEINRR,SMQDVVEDFKNKYEDEINR	3
SLC44A2	GVAEVLRDGDCPAVLIPSKPLAR,NNKGVAEVLR,QFCVPGFKNNKGVAEVLR	3
STEAP4	INQYPESNAEYLTHLVPGAHVVK,KSDIIIIAIHR,SDIIIIAIHR	3
LRP4	NTIAVGVDPQEGK,VVLINNNLGWPNGLTVDK	2
NAT2	TLTEEEVEEVLKNIFK	1
SPTLC3	DNWNRPICSAPGPLFDVMER	1
GPATCH1	EEERAPESSANQTVNK	1
AKAP13	GNTDSSLQSMGK,ELKEQLQQK,GGEKEEGNDGQDLR	3
ECM1	DILTIDISR,APYPNYDRDILTIDISR,RAPYPNYDRDILTIDISR	3
ITGAX	VDSAGFGDSVVQYANSR	1
HCLS1	SPEAPQPVLAMEEPAVPAPLPK,RSPEAPQPVLAMEEPAVPAPLPK,TTPIEAASSGAR,TLEGLQVEEEPVYK	4
DPP6	LPTVTAKEDEEED,IQDKLPTVTAKEDEEED	2
ENOSF1	TLVSCIDFR	1
MIDEAS	EAAAAAAATHQQALR	1
CASP7	ELEIMQILTR	1
GSDMB	ELHMEDSDKPLLSSLFNAAGVLVEAR	1
MYOM3	VSCTYKEDEGLYTVR,DAGFHSEIFKR,DAGFHSEIFK,GLVEVTIQNLSEEDKGSYTAQLQDGK,EDEGLYTVR,KQGPYFEQPLQWK,TYLGKDAGFHSEIFKR,QGPYFEQPLQWK	8
ARL15	SVQELKKYFELEPLAR	1
MSLN	QLLGFPCVEVSGLSTER	1
FRAS1	HQHVCSNLVTTDDLR,VENLLFHVVSTPTNGQLVLSR,KPEEGLQVEQLSGVGIPSGECLAQCR,GQFVMEHHTLPDVK,TSNGQHFHLTSTFTMEDIYQNR,DSKPNVVSNNVFHIQWSLISFK,FRGQFVMEHHTLPDVK	7
FABP1	TVVQLEGDNKLVTAFK,TVVQLEGDNKLVTAFKNIK,VKTVVQLEGDNKLVTAFK	3
ZFYVE16	EQQNDTSSELQNR	1
KRT79	QCQQLQTAIAEVEQR,KQCQQLQTAIAEVEQR	2
MUC2	CGCYVEDTHYPPGASVPTEEICK,HLAVLNGAMVSTPHYSPGLLIEK,ALSCQTLAAGYYHTECVSGCVCPNGLMDDGR,LHGHLYTPGQEITNDCK	4
LPCAT1	QALPAEAAILTLAPHSSYFDAIPVTMTMSSIVMK	1
TNS3	NQDPNPPPQPEELTSSLHTFK,DKPLWPVILSPTMEEGHGLDLTYITER,QQQMVVAHHYSFAPDGEAR	3
DDX31	SEYSSGMEADVAK	1
PWP2	GNLNFTCNGNSVISPVGNR	1
Pwp2	GNLNFTCNGNSVISPVGNR	1
CNNM1	APTTQGTPQTPKDDPAITLLNNR	1
MDM1	QAFMGEQEKLDVHEK,SQEAEQKDVIQER	2
STX17	TVIPTDLER	1
UTP20	QAELVPATVNDYK	1
F13A1	GTQVVGSDMTVTVQFTNPLKETLR,VRGTQVVGSDMTVTVQFTNPLK,AVPPNNSNAAEDDLPTVELQGLVPR,RAVPPNNSNAAEDDLPTVELQGLVPR,GTQVVGSDMTVTVQFTNPLK,VRGTQVVGSDMTVTVQFTNPLKETLR	6
GTF3C3	SQDKDVSEGETSDGVR	1
IGKV1D-37	VSQGISSYLNWYQQKPGK,VSQGISSYLNWYQQK,VTITCRVSQGISSYLNWYQQKPGK,LLIYSASSLQSGVPSR	4
SPARCL1	AEDEENEKETAVSTEDDSHHKAEK,AEDEENEKETAVSTEDDSHHK,KAENSSNEEEASSEGNMR	3
GYS1	KLYESLLVGSLPDVNK	1
TFRC	LDSTDFTSTIK,LSEKLDSTDFTSTIK	2
FUT6	DLAGYLQELDKDHAR	1
INMT	DYLATYYSFNGSPSPEAEMLK	1
IGKV1-37	LLIYSASSLQSGVPSR	1
SALL2	RGEESPGHFLVAATGTAAGGGGGLILASPK	1
COL15A1	SSQALAFESSAGIFVGNAGATGLER,DLMTDPSWPQK,VIWHGSSPHGIR	3
SLC38A10	SLEHSEGPVGRDPAGPPDGGPDTEPRAAQGK,DGVIGLNPLPDVQVNDLRGALDAQLR,DGVIGLNPLPDVQVNDLR,DGVIGLNPLPDVQVNDLRGALDAQLRQAAGGALQVVHSR	4
ECD	EQNYDLTQVSESMK,ESESVSKEEKEQNYDLTQVSESMK	2
SPATA20	TLLNTGLEK	1
MAN2B2	DMYATHLASGMLGVR,VTQEFLEYHVNR	2
KRT82	ELDVDSIIAEIK	1
PTPN3	EYFGLQHDDNSVDSPR	1
BDH2	KKQIDQFASEVER,QIDQFASEVER,KQIDQFASEVER	3
CGAS	ENHLSQFLEGEILSASK,GAPMDPNESPAAPEAALPK	2
SORL1	WESPYDSPDQDLLYAIAVK,TSVVIKWESPYDSPDQDLLYAIAVK	2
PAWR	KREDAITQQNTMQNEAVNLLDPGSSYLLQEPPR	1
SERPINB2	SLSSAINASTGDYLLESVNKLFGEK	1
PDPR	DSILLLEDVTWK,LYHQLEQETGIQTGYTR,AVDVLSELSFAPMTPDHFPSLFCK	3
MMAB	YAAMKEGNQEKIYK	1
LNPK	ECEPPSAGAAVSAR	1
PLBD1	TLHQGMAEVYNFDFITMKPILK,HWDFNIIDK,HWDFNIIDKDTSSSR	3
CAPN5	QPSNLPGTVAVHIISSTSLMAV	1
ANXA13	GLGTDESILIEVLCTR,TALALLDHPSEYAAR	2
TTC38	DGLEFMQHSETLWK,AEIKDGLEFMQHSETLWK	2
THRAP3	DSRPSQAAGDNQGDEVKEQTFSGGTSQDTK,PSQAAGDNQGDEVKEQTFSGGTSQDTK,SSSKDSRPSQAAGDNQGDEVK,DSRPSQAAGDNQGDEVK	4
STK10	FFDMELENLER	1
POLR2E	AQFGDKPSEGRPR	1
CYP1B1	QLGSAPPGPFAWPLIGNAAAVGQAAHLSFAR,FLDKDGLISK	2
GH1	AHRLHQLAYDTYQEFEEAYIPKEQK,AHRLHQLAYDTYQEFEEAYIPK,LHQLAYDTYQEFEEAYIPK,LHQLAYDTYQEFEEAYIPKEQK	4
ADO	GASDRDAASGAEAPMQPGFPENLSK,DAASGAEAPMQPGFPENLSK	2
HLA-DPB1	YIYNRQEYAR,ATPENYVHQLR,EEYARFDSDVGEFR	3
C4A	RGHVFLQTDQPIYNPGQR,GHVFLQTDQPIYNPGQR,TLDIPGNSDPNMIPDGDFNSYVR	3
C4B	GHVFLQTDQPIYNPGQR,RGHVFLQTDQPIYNPGQR	2
BHMT	LMKEGLEAAQLK,EGLEAAQLK	2
PGM2L1	DITTGYDSSQPNK,DITTGYDSSQPNKK	2
B3GNTL1	LDLTGGTFEDNLR	1
ATXN1	AEQQQQQQQQQQQQHQHQQQQQQQQQQQQQQQHLSR,AEQQQQQQQQQQQQQHQHQQQQQQQQQQQQQHLSR,AEQQQQQQQQQQQQQQHQHQQQQQQQQQQQQQQQHLSR	3
MAP1S	TLACVCALLVWHPAGPGEK,VLFPGCTPPAYLLDGLVR	2
AHNAK2	VDIKGPQVDIK,AGTGLKGEEVEGAGWMPGREPTTHAEAQGNEGDGEEGLQR,AKLDGAQLQGDLSLADK,GEEVEGAGWMPGREPTTHAEAQGNEGDGEEGLQR,LDSAQLEGDLSLANK,MLSFGVSAPGK,TTDLSIQLPSADLEVQAGQVDVK,LEGDLSLANKDVTAKDSK,SIQASVDVSALK,VDHKGPQIDIK,SIEASVDVSPPKVEADVSLPSMQGDLK,LPEGHLPEVAGLK,LDSAQLEGDLSLANKDVTAK,VEANVSLPSMQGDLK,MSLSSVEVDVQAPR,VDLKGPQLDVK,TSAFPIVESVVHEGDLHDPSR,AKLDSAQLEGDLSLANKDVTAK,VDIKGPQVDVK,AKLDSAQLEGDLSLANK,LSEGPVPEGAGLK,AEVTAHEVAVSLPSVEVDIQAPGAK,AKLDGAQLQGDLSLADKAVTAK,TTHLSIQSPSADLEVQAGQVNVK,LDGAQLQGDLSLADK,AKLDSAHLQGDLTLANKDVTTK,TTDLSIPLPSADLVVQAGQVDMK,FSFAAPSSEDDVFIPTVR,AEVTAPDVEVSLPSVEVDIEAPGAK,EPTTHAEAQGNEGDGEEGLQR	30
EEF1D	AFVEWSQALLLAPEGSRR,SGLGPVDLALLGLSAER,RANGEAPSALPYCYFLQK,AFVEWSQALLLAPEGSR	4
VNN2	EYWQVCTMLK	1
RIN3	APGFPLVSSLRPTAR,RDFHFVYRPLDGGGGGGGSPPCLVVR	2
PRRC2C	LNGQQTALASQYR,SVEDVRPHHTDANNQSACFEAPDQKTLSTPQEER,VDSDSSKPPETLTNPPGVCQEK	3
GLCE	WDYHTTHINQLQLLSTIDESPIFK	1
UQCC3	NWMVGGEGGASGR,KNWMVGGEGGASGR	2
GLRX5	KLGIHSTLLDEK,LGIHSTLLDEKKDQDSK,LGIHSTLLDEK,LGIHSTLLDEKK	4
PPP1R9A	ELAGGNFTSPDASASSCGK	1
OBP2A	GLSEEDIFTPLQTGSCVLEH	1
ICAM1	VLEVDTQGTVVCSLDR,VTLNGVPAQPLGLR,EVTVNVLSPR	3
SPTBN2	EANALAAGHPAQAAAINAR	1
CASP1	DSVGVSGNLSLPTTEEFEDDAIR	1
NFXL1	VEDPPLDLWLVPHSCGQVCER	1
CPPED1	KLADKFIHAGVR,TLDAFPAEKESEWK,TLDAFPAEK	3
CDC42BPG	SNNIFQVGECR	1
ARHGEF37	VQPPPTTQLLLPGSER	1
DSP	RGQSEADSDKNATILELR,QVMQQRSEDNAQHK	2
WDR1	LATGSDDNCAAFFEGPPFKFKFTVGDHSR,FTVGDHSR,FKFTVGDHSR	3
RIMBP2	VYGNKDADGFYR	1
HMGN4	DASTLQSQKAEGTGNAK	1
IGHA2	SAVQGPPDR,EKYLTWASQQEPSQGTTTYAVTSILR,DLCGCYSVSSVLPGCAQSWNHGETFTCTAAHPELK,SAVQGPPDRDLCGCYSVSSVLPGCAEPWNHGK,SAVQGPPDRDLCGCYSVSSVLSGCAEPWNHGK	5
NOX4	SNKPVTIISVISHPSDVMEIR	1
PBXIP1	GPDGVCLSGDRGPQGDK	1
SERPINA1	PFVFLMIDQNTK,FNKPFVFLMIDQNTK,FNKPFVFLMIDQNTKSPLFMGK,AVLTINEKGTEAAGAMFLEAIPMSIPPEVK	4
FBXO47	KIQMAVCSKPGSAR	1
CLU	LRRELNESLQVAER,EILSVDCSTNHPSQAK,ELNESLQVAERLTR	3
LOXL1	HPFGFGQVPDNWREVAVGDSTGMALAR,EVAVGDSTGMALAR	2
MATN2	DVCQAIDHGCEHICVNSDNSYTCECLEGFR	1
HLA-B	AQTDREDLRTLLR,GHNQLAYDGK,GHNQFAYDGKDYIALNEDLSSWTAADTAAQITQR,FDSDAASPRTEPRAPWIEQEGPEYWDGETR,YFHTAMSRPGR,MSGCDVGPDGR,GYHQDAYDGK,GYNQFAYDGKDYIALNEDLSSWTAADTAAQITQR,ADPPKTHVTHHPVSDHEATLR,GHNQLAYDGKDYIALNEDLSSWTAADTAAQITQR,GHNQFAYDGK,FLRGHNQYAYDGKDYIALNEDLSSWTAADTAAQITQR	12
AEBP1	TQWLEVDTR,VWPETPEEKAPAPAPEER,VWPETPEEK	3
DOCK5	SQVIAEKEPEPDLMSPTR	1
CEP57	VLDEHIQER	1
IGHV3-64D	AEDMALYYCAK,GLEWVSGISWNSGSIGYADSVK	2
CASP4	YYNAKTEDKVR	1
IGHV3-30	LSCAASGFTFSNYAMHWVR,NTLYLQMHSLRTEDTAVYYCAR,AEDTAMYYCAK,NTLYLQMHSLR	4
PPP1R13L	LQNAFWEHGANR	1
C7	LLEPHCFPLSLVPTEFCPSPPALKDGFVQDEGPMFPVGK,DGFVQDEGPMFPVGK,GGGAGFISGLTYLELDNPAGNKR,NVVYSCNEGYSLIGNPVAR	4
ARPC1B	DRTQIAICPNNHEVHIYENSGAK,TQIAICPNNHEVHIYENSGAK	2
ITPKB	QDSDALPSPELLPQDQDKPFLR	1
ISM2	TCDLPSCPGTEDKDTLGLPSEEWELLAR	1
RBM19	AETEKPANQKEPTTCHTTVK,NLPAGTLAAELQETFGR,NLPAGTLAAELQETFGHFGSLGR	3
TKFC	VAGALAEAGVGLEEIAKQVNVVTK,LIDAETTAGAWPNVAAVSITGR	2
UBR4	VALEELENKPR,RVALEELENKPR	2
TMEM143	LQALYDPINPDRETLDQPSLTNPQR	1
C17orf80	DSVTGKESQGERPHLSLLIPR,KAEAQNHNCVPDVK,ESQGERPHLSLLIPR	3
CLC	GRPLVCFLNEPYLQVDFHTEMK	1
FGA	VELQDWAGNEAYAEYHFR	1
ZNF773	AEEAPEQSASVEVPSSNVQQHQK	1
SPATA18	QNADQQDTEAMPDYKK,EQWNSLKQNADQQDTEAMPDYKK	2
PLEKHA1	HAFRPTNAAAATSHSTASR	1
FCGR2A	LEPPWINVLQEDSVTLTCWGAR	1
AKAP9	DKPELEVVLTEDALKSLENQTYFR,ISSSSQTPQILVK,AVHNEGMQVLSLTESPYSDGEDHSIQQVSESWLEER,QHMAQMEEIK	4
DIS3	ELKNGNLEVGVHIADVSHFIRPGNALDQESAR	1
GPC4	YLFAVTGNGLVNQGNNPEVQVDTSKPDILILR	1
ERCC2	QMAQPFHREDQLGLSLLSLEQLESEETLQR,ETDAHLANPVLPNEVLQEAVPGSIR	2
FGB	HGTDDGVVWMNWKGSWYSMKK,GSWYSMKK,HGTDDGVVWMNWKGSWYSMK	3
NRAP	KVYGLQSELQYK,MKGTAHYHSLPAQDNLVLKR,GLQIGYCSVDDDPR,MKGTAHYHSLPAQDNLVLK,GTAHYHSLPAQDNLVLKR,VYGLQSELQYK,FSTVADTPELLR	7
MVK	LQPHSNGKVDLNLPNIGIK,VDLNLPNIGIK	2
POF1B	EELGHLQNDLTSLENDK,LVLSTFSNIREELGHLQNDLTSLENDKMR,LVLSTFSNIREELGHLQNDLTSLENDK,EELGHLQNDLTSLENDKMR	4
AKR1A1	HIDCAAIYGSEPEIGEALK,HIDCAAIYGSEPEIGEALKEDVGPGKAVPR,HIDCAAIYGSEPEIGEALKEDVGPGK	3
CFI	HPTIQGFASVAQEETEILTADMDAER	1
P2RX7	LPLALHDTPPIPGQPEEIR	1
PPIC	VIDGMTVVHSIELQATDGHDRPLTSCSIINSGK	1
SPOUT1	TEEAILISLAALQPGLTQAGAR	1
SCFD1	VLIYDRFGQDIISPLLSVR,FGQDIISPLLSVR	2
MTG1	VLTGTGNVNVIQPNYPAAAR	1
ACADL	TVAHLQTVQHQLAELK	1
MAP6	AGPAWMVR	1
SBF2	VLGFPLCVSLNISPGFR	1
QPRT	QAADFALK,YGLLVGGAVSHR	2
IRF2BP2	SPPGAAAPAAAKPPPLSAK,DILLQQQQQQLGHGGPEAAPR	2
WDFY4	STEGMDIVMDNLK,MSVPGRPAGEEPLAQPPSPR,IPTIIGILACQLR	3
ADAM12	ADEVVSASVR	1
SVIL	TCAGESKDYALHAGDGSSDPEVLLNIENQR,DSPVLHICESK,DYALHAGDGSSDPEVLLNIENQR,DRLPFEEKLEVENVMK	4
PKHD1L1	IAYHSANANSHFSSPTQR	1
ADH4	GLTVFPEELIIGR	1
PNLIPRP2	LLPWSPEHIDTR	1
FYCO1	ELQTCLQALELGAAEK,ELQTCLQALELGAAEKEEDYHTALR,HLGDQMEVSLLAVR	3
RNF113B	YCLCEDENHEVGSEEEEIPFR	1
NDUFB9	QLQEETPSGGPLTEALPPARK,QLQEETPSGGPLTEALPPAR	2
GBE1	LFAYSSWEVLR	1
MUC1	CHLGPGHQAGPGLHRPPSPR,PAPGSTAPAAHGVTSAPESR,PAPGSTAPPAHGVTSAPESR,CHLGPGEQAGPGLHR	4
PLK3	AAAAPAPPAGPR	1
MIA3	RGLVQDETELEDENQEGMTVHSSVHSNNLNSMPAAEK,GLVQDETELEDENQEGMTVHSSVHSNNLNSMPAAEK,DSVEGDALVNGAR,TSGLAGEPEGELSKEDHGNTEK	4
PUS3	DCNDTLEEDNTNLETPTKR,DCNDTLEEDNTNLETPTK	2
DNAH2	LQPNLTDEEVLLLSMR,AYPSQKPLAAWTQDLAMR	2
ANK2	TEGDSSATAIFPQTHK,TQTDSEAQESTATSDETK	2
ADH1A	VCLVGCGFSTGYGSAVNVAK	1
CRAT	SPMVPLPMPK	1
TRMT1L	EKSNDILEEGEKNLGNIK,EKSNDILEEGEK	2
SENP8	DLIATLAK,RGEWKDLIATLAK	2
GSTP1	YVSLIYTNYEAGKDDYVK,CKYVSLIYTNYEAGKDDYVK,CKYVSLIYTNYEVGKDDYVK,YVSLIYTNYEVGKDDYVK,EVGKDDYVK,CKYVSLIYTNYEAGK	6
ADAD2	PWRPLPAQAQSAWEPAPAPATYR	1
VWF	VALLLMASQEPQR,HGAGVAMDGQDIQLPLLK,IALLLMASQEPQR	3
TMEM128	FLILPDAEAQLDR,FLILPDAEAQLDREGDAGPETSTAVEKK,FLILPDAEAQLDREGDAGPETSTAVEK	3
RPLP0	AFLADPSAFVAAATTAAPAAAAAPAKVEAK	1
PBLD	AFCGNPAAVCLLENELDEDMHQK,EMHAFQCSR	2
TRAP1	AMVGHLNELLVK,DVGEWQHEEFYR	2
PANK4	SLDVLGWEER,SLDVLGWEERQLALVK,IAGMDPVVHSALR	3
COQ6	DLGSMSHLTGYETER	1
CD27	GESPVEPAEPCR,SNKGESPVEPAEPCR	2
IGLV10-54	QTATLTCTGNSNNVGNQGAAWLQQHQGHPPK	1
PES1	AGEGSYALDSESCMEK	1
RBFOX2	MAEGAQPQQPPQLGPGAAAR,AEGAQPQQPPQLGPGAAAR	2
TTN	LEADVHGKPLPTTEWLRGDK,MAVDISESEAVESGFDLR,MSGYPIPK,LLQGKDYIFR,TSFRVPNLEEGKSYFFR,FCAMISGRPQPK,LEADVHGKPLPTTEWLR,EAPPAKVPEVQKR,PLPTTEWLR,TSFRVPNLEEGK	10
WASHC2A	TNTFPLLEDEDDLFTDQKVK,VSLLFEDDVDSR	2
HDGF	NSTLSEPGSGRGPPQEEEEEEDEEEEATKEDAEAPGIR,NSTLSEPGSGR,EAATLEVERPLPMEVEKNSTLSEPGSGR	3
ZSCAN2	LQGHTPGEDHGEVVSQDR	1
ELP2	TSDPALCPLIVSAAADSAVR,DGVLQQPMR,RTSDPALCPLIVSAAADSAVR	3
PCMT1	ELVDDSINNVRK,ELVDDSINNVR,VIGIDHIKELVDDSINNVR,VIGIDHIKELVDDSINNVRK	4
FMO3	GVFPPLLQK,KSFPGLNHFK,ESAVFDAVMVCSGHHVYPNLPKK,NNLPTAISDWLYMK	4
DENND5B	SQGAANTTSGENFDQSPLKR	1
MPRIP	VAVTSSSSSSSSSSIPSAEKVPTTK,VAVTSSSSSSSSSSIPSAEK,AEHMETNAVGPSQSSDTR,SQVIEKFEALDIEKAEHMETNAVGPSQSSDTR	4
TACC2	IFEKPVLGALTTPGEK,AQQEQAAHQATLR,QGTSGGVNTSSEQIATLTGFPDFR,IGTTEVEKPAGLLFQQPDLDSALQIAR,IGTAEVEKPAGLLFQQPNLDSALQIAR	5
KLF16	GRPGPEGAGPTAGLDVR	1
TAPBPL	AVDVVLDCFLVK,NEVLWHPTLNLPLSPQGTVR,VAKNEVLWHPTLNLPLSPQGTVR	3
VPS33B	DMAYVFSGAYVPLSCR	1
ABCC2	IIEYGSPEELLQIPGPFYFMAK	1
SULT1A1	SLPEETVDFMVQHTSFK,ILEFVGHSLPEETVDFMVQHTSFK,KTPMTNYTTVR	3
SULT1A2	KTPMTNYTTVR	1
SLC18A1	NNCLQGTGFLEEETTR	1
OTUD7A	DAATAAAAAAAAAATAK	1
TUT7	ISLKEENVCEENSPVDQSDFFYEFSK	1
DCP1B	CDPSTPVPASSAALNR	1
CPT2	DGSTAIHFEHSWGDGVAVLR,ALEDVFDALEGKSIKS	2
MTA1	SYEQHNGVDGLANHGQTR,GTYLGLANHGQTR	2
IL7R	IDLTTIVKPEAPFDLSVIYR,KIDLTTIVKPEAPFDLSVIYR	2
MXRA5	LIVQLTVLEPMEKPIFHDPISEK,VWQTVSPVESR	2
PPP6R2	IQPFDDEEDEDIWEDSDTR	1
FRZB	NNYNYVIWAK	1
PDCD6	PGPGPAAGAALPDQSFLWNVFQR	1
VPS11	DLHDQFQHQLR	1
ANKLE2	FGNANVVNVLSSHHLIVK,LSSFYYHEAGVTALSQDPQR	2
CCZ1	ISGSEKEPQFK	1
HLA-DRB5	YFYNQEEYVR,FLDRYFYNQEEYVR,CIYNQEESVR,CIYNQEESVRFDSDVGEYR,PSAEYWNSQK,AVTELGRPDAEYWNSQKDILEDER,GIYNQEENVR,HNYGAVESFTVQR,GIYNQEENVRFDSDVGEYR	9
MYOM1	YGMHTLEINACDFEDTAQYR,NLLASEEGITTPK	2
ZC3H13	MDKDLGSVQGFEDTNKSER	1
DOCK10	VSTFVVSTVNTQNPHVNAFFQECQK	1
ECM2	QLGIPQTTVFTPVAR	1
MYH14	KAPPRPGPVPEAAQPFLFTTR,IHEEAVQELR	2
KDM3B	SEEPLKTDSSASNNNSELK,LIHVMLMDNSTPQSEGGTLK	2
PLA2G4C	SENYSLTDFWAYMVVSK,IEPDEAPVVAVLGSGGGLR,WEWGTPHNFLYK	3
F12	LCHCPVGYTGPFCDVDTK	1
PLXNB2	ITVLGSNLGVQAGDIQR,LHVTLYDCSFGR	2
PLS1	HLMPMNPNDDSLFK	1
H3C14	YRPGTVALEIR	1
ZFP36L2	EPSGGGSTALLNK	1
HLA-DRB1	HFHNQEELLR,YFYNQEEYVR,FLDRYFYNQEEYVR,CIYNQEESVR,AVTELGRPDEEYWNSQKDFLEDR,HFHNQEELLRFDSDVGEFR,CIYNQEESVRFDSDVGEYR,PSAEYWNSQK,HNYGAVESFTVQR	9
LPA	DKYILQGVTSWGLGCACPNKPGVYAR,YILQGVTSWGLGCACPNKPGVYAR	2
NID2	GEADDLKSEGSYFSLTSTEQSVK,FAVTNQIGPVKEDSDPTPVNPCYDGSHMCDTTAR,SYPASDHTTPLSR,FAVTNQIGPVKEDSDPTLVNPCYDGSHMCDTTAR,EDSDPTPVNPCYDGSHMCDTTAR,HLEESSTLDPHTK,CECQSGYEFADDR	7
KRT15	SLLEGQDAR	1
ITIH4	NPPVWVHASPEHVVVTR,LLGLPGPPDVPDHAAYHPFRR,LLGLPGPPDVPDHAAYHPFR	3
DLC1	STCNVVHDEFLDIPCTNR	1
CRYZ	VLGTAGTEEGQK	1
LMTK3	SAPATSRPGSAPTPGAPGEADLR	1
TRAF1	ALCCAGCLSENLR	1
CNDP1	AIHLNLEEYR	1
FOXRED2	RLEDSSQQLGDQEPLGSPLAPGPLAQSVNSNKEEL	1
TTI2	DLGDLIEATGFDR	1
ECH1	LTGSSAQEAASGVALGEAPDHSYESLR,LTGSSAQEAASGVALGEAPDHSYESLRVTSAQK	2
ALDH16A1	GATACDLVQR	1
HSPA4L	NVVFIDMGHSAYQVSVCAFNK,NVVFIDMGHSAYQVSVCAFNKGK,QLGQDLLNSYTENEGK	3
PTPRG	HQSPIDILDQHAR	1
ADA2	IKFPTVVAGFDLVGHEDTGHSLR	1
FIZ1	VSHGEGGGEEAAAAAR	1
SPINK5	ENNPIQGPDGK,NAAGHGSSGGGGGNTQDECAEYQEQMK,ATSYAELCNEYR	3
SERPINA7	GWVDFFVPK	1
THNSL1	SWYSTHSIVGDK,HVWPEDCEQKVSEK	2
CNPY1	ALMDEIEHDITK	1
SOD3	DDDGTLHAACQVQPSATLDAAQPR,RDDDGTLHAACQVQPSATLDAAQPR	2
OLFML1	EADECIVSEDKTLAEMLLQEAEEEK,EADECIVSEDK,EADECIVSEDKTLAEMLLQEAEEEKK	3
C10orf71	CMANKVMEDPGQGSSMAR	1
LAMB1	MEMPSTPQQLQNLTEDTR,NCEQCKSFYYQHPER	2
PLOD1	TLEKHADKEDLVILFTDSYDVLFASGPR	1
FAM160B1	FFTGVMEPQLMQTSEMGILTSTALLHR	1
ADD1	WLNSGRGDEASEEWQNGSSPK,QKGCEENLDEAR,GDEASEEWQNGSSPK	3
HLA-A	YFSTSVSR,TDPPRTHMTHHAVSDHEATLR,AHSQIDRVDLGTLR	3
SDHAF1	APTGEPGGVGSQPDDGDSPRNPHDSTGAPETRPDGR,APTGEPGGVGSQPDDGDSPR	2
CELA3B	LQQALLPVVDYEHCSR,LYTNGPLPDKLQQALLPVVDYEHCSR	2
ATL2	AEGDEAARGQQPHQGLR	1
KRT77	YQELQIMAGR	1
HPX	EWFWDLATATMK	1
EML4	ADSGVHLCVIDDSNEHMLTVWDWQR,ADSGVHLCVIDDSNEHMLTVWDWQK	2
DDRGK1	VSIAELAQASNSLITWGR,GRVSIAELAQASNSLITWGR	2
FCGBP	KFDFQGTCNYVLATTGCLGVSTQGLTPFTVTTK,ALASYVAACQAAGVVIK,KFDFQGTCNYVLATTGCLGVSTQGLTPFTVTTKNENR,GCVLDVCMGGGDHDILCK,EEFCGLLSSPTRPLSSCHK,VTYDLVYYVR,ALASYVAACQAAGVVIKDWR	7
EEF2K	YSSSGSAANSFHFK	1
CYFIP1	SGNGEGTPVEHVR	1
PIP5K1C	AAPTQVLSMTAQPGPGHGK	1
PITRM1	EAYFSVGLQGIVEK,LSVFSTIDAPVAPSDK,STHSLAILGPENPK,EAYFSVGLQGIVEKDIETVR,AFSSLNTLPEELRPYVPLFCSILTK,STHGLAILGPENPKIAKDPSWIIR,IAKDPSWIIR	7
NAPRT	MKLTENPEKQTLPGSK,MKLTENPEK,LTENPEKQTLPGSK	3
PLCG2	DSSVFILGNTDRPDASAVYLR,FLIHEQQELWAQDLNK	2
SIRPG	FYPQSLQLTWLENGNVCQR	1
GC	LPDATPKELAK,AKLPEATPTELAK,LKAKLPDATPK,LKAKLPEATPTELAK,AKLPDATPK,AKLPDATPKELAK,LPEATPTELAK	7
AP5B1	VGAGLGGLFTDK,ELESCKPGLLGGSLVLLR	2
CENPF	SEKEDLTNELQK	1
COQ5	AQQNLSWEEITKEYQNEEDSLGGSR,AQQNLSWEEITK	2
SNCG	KEDLRPSAPQQEGVASK,EDLRPSAPQQEGVASK	2
ARSB	TISEGNPSPR,ELIHISDWLPTLMK	2
ALG8	SYCFTASKPDGSIR	1
HIVEP1	SNGPSAALVTASTPSALPTGEK,LIDSISNSHPLLPPELRPLGSQVQK	2
NUBP1	LCASGAGATADTAIEEIKEK,LCASGAGATADTAIEEIK	2
WNK1	TLSPEIITVTSAVGPVSMAAPTAITEAGTQPQKGVSQVK	1
PML	AQTLGAVVPPGDSVR,VVIQPEALFSIYSK	2
IGHV3OR15-7	NTMYLQMSNLK	1
DIDO1	LAAETGEGEGEPLSR,RLAAETGEGEGEPLSR	2
DPCD	HQLPLDDASLSFAHANCTLIISYQKPK	1
HKDC1	MCINTEWGGFGDNGCIDDIR	1
MAVS	GCELVDLADEVASVYESYQPR	1
NUDCD3	VAMLEENGECVLMEGK	1
IGLV2-14	LMIYDVSNR,LMIYDVSNRPSGVSNR	2
IGLV2-18	LMIYDVSNR	1
CLEC3B	GGTLSTPQTGSENDALYEYLR	1
ARHGAP45	ECVLHDDLLEAR,LKECVLHDDLLEAR	2
DPP7	FFQQRLDHFNFQR,APDPGFQERFFQQRLDHFNFQR	2
SRP68	YANEVDSDAGAFK	1
PCK1	LAKEEGWLAEHMLVLGITNPEGEKK,EEGWLAEHMLVLGITNPEGEKK,EEGWLAEHMLVLGITNPEGEK,MGTPVLEALGDGEFVK	4
ZFP62	IHTGKKPYQCNECGK	1
SUCLA2	SFQGPVLIGSSHGGVNIEDVAAETPEAIIKEPIDIEEGIK,SFQGPVLIGSSHGGVNIEDVAAETPEAIIK	2
BBS9	DKTPAPLQHLNTLLDGTYK,TPAPLQHLNTLLDGTYK	2
POTEF	CPKALFQPCFLGMESCGIHETTFNSIMK,CPEALFQPCFLGMESCGIHDTTFNSIMK,FRCPEALFQPCFLGMESCGIHDTTFNSIMK	3
POTEE	CPEALFQPCFLGMESCGIHDTTFNSIMK,FRCPEALFQPCFLGMESCGIQETTFNSIMK,LCFVALDFEQEMATVASSSSLEK,CPQALFQPCFLGMESCGIHETTFNSIMK,FRCPEALFQPCFLGMESCGIHDTTFNSIMK,CPEALFQPCFLGMESCGIQETTFNSIMK	6
UMPS	GSDVIIVGR,GGLSSPIYIDLR,FIQENVFVAANHNASPLSIK	3
PSMB4	SYNRFQTATVTEK	1
TINAG	CSQHVCLVRPELIEQVNK,EKFWLAANSWGK,EIMQNGPVQAIMQVHEDFFHYK	3
IGHV3-53	NTLYLQINSLR,DNSKNTLYLQINSLR	2
IPO4	AVGEPMRPLAEECCQLGLGLCDQVDDADLRR	1
SCRN2	SVFKPFIFGVGVAQAPQVLSPTFGAQDPVR,DKQSGICMDSGGFR,SVFKPFIFGVGVAQAPQVLSPTFGAQDPVRTLPR	3
CDKN2AIP	ASEAEAPDKHGSSFVSLLK	1
ABCC6	VLEACALQPDVDSFPEGVHTSIGEQGMNLSGGQK,TTSQAQTEVPLDDPDR,TTSQAQTEVPLDDPDRAGWPAGK	3
CALU	LGMIVDKIDVDKDGFVTEGELK,IDVDKDGFVTEGELK	2
MOCS2	SKDVINFAAEK	1
ACTN2	HEAFESDLAAHQDRVEQIAAIAQELNELDYHNAVNVNDR,KHEAFESDLAAHQDRVEQIAAIAQELNELDYHNAVNVNDR,VEQIAAIAQELNELDYHNAVNVNDR	3
ATXN3	YIQQQKQQQQQQQQQQQQQQQQQR,EAYFEKQQQKQQQQQQQQQQQQQQQQQQQQQQQR	2
CASKIN2	LSSVSGPSPEPPPLDGSPGPK	1
C8B	EVEDCVTNRPCR	1
CELA2B	LQTNGALPDDLKQGR,IVVHKDWNSNQVSK	2
IGHM	ESDWLSQSMFTCR,EVMQGTDEHVVCK,YAATSQVLLPSKEVMQGTDEHVVCK	3
IGHG1	WQQGNVFSCSVMHEGLHNHYTQK,WQQNVFSCSVMHEALHNHYTQK	2
MPC1	DYLMSTHFWGPVANWGIPIAAINDMKK,DYLMSTHFWGPVANWGIPIAAINDMK	2
CD226	SPISTGQPTNQSMDDTREDIYVNYPTFSR	1
SLAIN1	MSLPLGIYR	1
AIP	EQPGSPEWIQLDK	1
CCDC124	VLQEGSVEAR	1
NCEH1	VVSPFPLCQPAGEPSR	1
XIAP	DSMPDESSQTSLQK,SLEVLVADLVNAQKDSMPDESSQTSLQK	2
PIGQ	AFFPTCCVSADSGLLVGR	1
EXOSC7	VLHASLQSVLHK,VLHASLQSVLHKEESLGPK	2
NARS2	CPEDVELCHR,ELTFGSSVEVQGQLIK	2
RUNDC1	GCPHVLGYEGPGDPASDEGDGLPGDRPR	1
MTAP	NVDCILLAR	1
PEAR1	SYSYSYSNGPGPFYDK	1
ERICH3	FRPTTAANGLEPLLTK,EKQQHMVQGESETADVSPNNMQV,QQHMVQGESETADVSPNNMQV	3
FASTKD1	WIQHDHVYLDNMTAK,ITQQLTFLHFQR	2
CYBRD1	SDSELNNEVAAR,GSMPAYSGNNMDKSDSELNNEVAAR	2
KIF13B	TAMVATVSPAANNYDETLSTLR,IIWDLREEVEK	2
HSPA4	SVMDTTQIAGLNCLR	1
NUP205	LLHLLVDDMPVKPYSDGEGGIEDENR	1
WDR41	TAHDSNVLHIAR	1
ACACB	HNQVESIFLSAIDMYGHEFCPENLK,TAQAIKDFNR	2
SLC6A17	AVEEELDTEDRPAWNSK	1
MAN2B1	NLCWDVLCVDQPVVEDPR,NLDKLIQLVNAQQAK,QLAAGWGPCEVLLSNALSR,LIQLVNAQQAK	4
TRIP11	REEMEQLFHDDQGSVTR,DKEFHSNQELER	2
ADCK2	AQVPGHQPEATNLIPVAVK	1
CBR4	EHDVQNTFEEMEKHLGR,AAAGDLGGDHLAFSCDVAKEHDVQNTFEEMEK,EHDVQNTFEEMEK	3
MICA	AQTLAMNVRNFLKEDAVK	1
MTREX	MYSHPLHNDPDLETVYTLCEK	1
ABO	DHVGVEILTPLFGTLHPSFYGSSR	1
PDE6D	FFDNDLLVSTSR	1
CC2D1A	IREPLTAQQLEMTTER	1
KYNU	GCQLTITFSVPNEDVFQELEKR	1
DDX51	NVIEDLVPIEDIPDVHPDLQK	1
RRP7A	LLSTCGLVQSIELQEKPDLAESPK,LLSTCGLIQSVELQEKPDLAESPK	2
SYN2	RPPPASAPAPQPAPQPAPTPSVGSSFFSSLSQAVK,QTAASAGLVDAPAAAPAAAR	2
NEK7	ALRPDMGYNTLANFGIEK	1
ZNF24	QELPSALESHEVPGTLSMGVPQIFK	1
CYS1	RSPESLPAGPGAAALEGGTLR	1
PRAG1	DSAASHQTEPEAYER,KFDEFQTGILLYELLHQPNPFEVR	2
IFI35	VQVQPLELPMVTTIQVSSQLSGR	1
F13B	IQENMHYGCASGYK	1
PALLD	FGHGQTPAAFLSALLPSQPPPAAVNALGLPK	1
CA3	GENQSPIELHTK	1
NCOA7	EPSDTSAAFESTAK,KEDFIVQDLEVWAFE	2
AKR1C3	RGDIFYTSK,QQCVKLNDGHFMPVLGFGTYAPPEVPR,MDSKQQCVK	3
PRPH	AQYESIATK	1
MRPL45	TVMIPGPQLKPEEEYEEAQVEAQKPQLA	1
CCDC69	NEEALQVPR	1
LRRC47	ADLATAPPHVTIVR,VVYPSKADLATAPPHVTIVR	2
SIGLEC9	DEAEFTCR	1
SPAG7	RGEEWNPQKAEEK	1
PCNT	TEASTELAGTVAHELQGVHQGEFGSEKK,AALQELESEHGK,SHTLELSEALR,NLYEKLQHETR,TQEACVHQDTQAHHALLRK,TEASTELAGTVAHELQGVHQGEFGSEK	6
SEC16B	NASPSGDEDSSDSPDSEETPR,FYIPHVPVSFGPGGQLVR	2
COQ3	DNLLETIPNHQPGKPLLGMK	1
TJP2	EESYDFFK,TQNKEESYDFFK,AEQIASVQNAQR,TQNKEESYDFFKSYEYK,YQEEPPAPQPK	5
ANXA4	ISQTYQQQYGRR	1
LLGL2	TVEHGFPHQPSALGYSPSLHILAIGTR,VFLTDTDPNENLSAQGEDEWPPLRK	2
MAST4	ASEGAMSDGPVPAEHR	1
UNC13A	KGEVPPEEQGPSIK	1
SETX	AGSHTAQNSDVFVPESDRSDYNCTGGTEVLANSNRK,AGSHTAQNSDVFVPESDRSDYNCTGGTEVLANSNR	2
UHRF1BP1	SDASSDQGPASPQK	1
PUDP	EVFPMAALMPGAEK,LKEVFPMAALMPGAEK	2
NOL9	LLQAQAAGVDWREGAR,LLQAQAAGVDWR	2
ENO3	KLSVADQEK,LSVADQEKVDK,KLSVADQEKVDK,AVENINSTLGPALLQKK,AVENINSTLGPALLQK,LSVADQEKVDKFMIELDGTENK	6
IGKV3D-11	ASQGVSSYLAWYQQKPGQAPR	1
HADH	FAENPKAGDEFVEK,KFAENPKAGDEFVEK	2
ECHDC3	NHPVPVIAMVNGLATAAGCQLVASCDIAVASDK,KRNTLSLAMLK,NHPVPVIAMVNGLATAAGCQLVASCNIAVASDK,NTLSLAMLK	4
KLHL15	LDTFLLDNFVPLMSRPDFLSYLSFEKLMSYLDNDYLSR	1
APEX1	EAAGEGPALYEDPPDHK	1
APIP	IQPEDMFVYDINEK,IQPEDMFVYDINEKDISGPSPSK,ERIQPEDMFVYDINEK,IQPEDMFVYDINEKDISGPSPSKK	4
MUC13	DSQMQNPYSSHSSMPRPDY	1
ADGRG6	SGYFLSISDSQCLLNNALPVK	1
NUP133	SSFYSLTSSNVSK	1
AARS1	VDDSSEDKTEFIVK	1
HEXA	EDIPVDYMK,DFYVVEPLAFEGTPEQK,ISYGPDWKDFYVVEPLAFEGTPEQK	3
DDX58	AAGFEEIEQDLTQRFEEK	1
ACAA1	GCFQAEIVPVTTTVQDDKGTKR,GCFQAEIVPVTTTVQDDKGTK,GCFQAEIVPVTTTVQDDK	3
CFHR1	STDTSCVNPPTVQNAYIVSR	1
NCOR2	SILTSTTTVEHAPIWRPGTEQSSGSSGSSGGGGGSSSR,RGKSQQQQQQQQQQQQQQQQQQPMPR,SQQQQQQQQQQQQQQQQQQPMPR	3
ENPEP	SIAATDHEPTDAR,SIAATDHEPTDARK	2
SYTL2	TDFGDTEEEVKGPEK,VHPSQMEISETVEK	2
SEPTIN9	RAEVLGHKTPELAPR,LNEGSSAMANGVEEK,AEVLGHKTPELAPR,LNEGSSAMANGVEEKEPEAPEM,RLNEGSSAMANGVEEKEPEAPEM	5
KRT78	FGEWSGGPGLSLCPPGGIQEVTINQNPLTPLK	1
POTEJ	CPQALFQPCFLGMESCGIHETTFNSIMK,LCFVALDFEQEMATVASSSSLEK	2
POTEI	CPQALFQPCFLGMESCGIHETTFNSIMK,CPETLFQPCFLGMESCGIHETTFNSIMK,LCFVALDFEQEMATVASSSSLEK	3
MUC12	SPDATLSPATTTSSGVSK	1
NRXN1	YVCDCSGTGYIGR	1
TEP1	SDFVSESEEAACR,TLISITQAKPESESSFLCASSDGMLWNLAK,AAGQPGSELLVVTIGLDGATR	3
FRK	SLQAEPWFFGAIR	1
SUN1	TISAVGEQLLPTVK,QVTSSGVSYGGTVSLQDAVTR	2
EPHX1	IEGLDIHFIHVKPPQLPAGR,TKIEGLDIHFIHVKPPQLPAGR,QVEILNRHPHFK,KQVEILNRHPHFK	4
CMPK1	NPDSHYGELIEK,KMDQTMAANAQKNK,KNPDSHYGELIEK,KMDQTMAANAQK	4
C3	VLLDGVQNLRAEDLVGK,KVLLDGVQNLRAEDLVGK,VLLDGVQNLR,KVLLDGVQNLR	4
CUL9	LDNLFLEQEDEEEK	1
CCDC91	EAMKDAVLKVVEEER,LLEVLDTEK	2
SKIV2L	RPPGPASQSLWGNPTR,VFTTLVLCDKPLSQDPQNR	2
FLNA	ALGALDSCAPGLCPDWDSWDASKPVTNAR	1
HPR	WKAPKSPVGVQPILNEHTFCAGMSK	1
CCDC157	QAGKLEQALR	1
MYH6	LEQQVDDLEGSLEQQK,VKLEQQVDDLEGSLEQQKK,LEQQVDDLEGSLEQQKK,LEDEEEMNSELTAK,VKLEQQVDDLEGSLEQQK	5
KTI12	ELEREESGAAESPALVTPESEK	1
CTSB	PSFHPVSDELVNYVNK,PSFHPVSDELVNYVNKR,SRPSFHPVSDELVNCVNKR,SRPSFHPVSDELVNYVNK,ASHQWMNTQGGHLALGVYQHVTGEMMGGHAIR,SRPSFHPVSDELVNYVNKR	6
SCLY	VSGQTEVDDILAAVRPTTR	1
HLA-DMB	MAPCEFGVLNNLANVLSQHLNQK,VLLTCWDPEENKMAPCEFGVLNNLANVLSQHLNQK	2
RAVER1	GSGLRGPLSRFYSGSPTSYFTSGLQAGLK	1
MYH9	DLEAHVDSANKNRDEAIK,KLEMDLKDLEAHVDSANK,DLEAHVDSANKNR,DLEAHVDSANK,LEMDLKDLEAHVDSANK	5
SURF6	KAEEAMEAQEVVEATPEGACTEPR	1
SAMM50	FYLGGPTSVR	1
LAMA4	NGYLHVFYDFGFSSGPVHLEDTLK,LSDLQEALDQALNHVR,NGYLHVFYDFGFSSGPVHLEDTLKK,KNGAVWCICNENYAGPNCER	4
PTPRS	VILQPIEGIMGSDYINANYVDGYRR	1
PAPSS1	DPAGMPHPQTGK	1
CLTCL1	ILQNLLILTAIK	1
TBC1D17	DNDVLLHWAPVEEAGDSTQIIFSK,VVEKDNDVLLHWAPVEEAGDSTQIIFSKK,VVEKDNDVLLHWAPVEEAGDSTQIIFSK	3
LRPPRC	NNNIDAAIEDIENMLTSENK	1
IGHV1-69	QAPGQGLEWMGR,ASGGTFSSYTISWVR	2
IGHV1-2	QAPGQGLEWMGR	1
IGHV1-69D	QAPGQGLEWMGR,VSCKASGGTFSSYVISWVR,ASGGTFSSYTISWVR	3
MT1E	CTSCKKSCCSCCPVDCAK,SCCSCCPVDCAK,KSCCSCCPVDCAK	3
GOLGA4	DLHQEAETYR,EKIESLTEVHR,LIKLEHAEAKQHEDQSK,QHEDQSMTGHLQEELEEK	4
SYNPO2	TEVPLAENQSGPDCAGSLK,TEVPLAENQSGPDCAASLK,TEVPLAENQSGPDCAGSLKEETGPSYQR,SYIEVSHGLGHVPQQNGFSGASETANIQR,TQCTEFFLAPVKTEVPLAENQSGPDCAASLK,TQCTEFFLAPVKTEVPLAENQSGPDCAGSLKEETGPSYQR,TEVPLAENQSGPDCAASLKEETGPSYQR,TQCTEFFLAPVKTEVPLAENQSGPDCAASLKEETGPSYQR	8
CEACAM6	SDPVTLNVLYGPDGPTISPSK	1
PELO	EQFCDYMFQQAVK	1
CTSS	SNPNWILPDSVDWR	1
MUC5B	TTESPPSPGTTTLGHTR	1
SDCBP2	GSSAACNGLLTNHYVCEVDGQNVIGLK,NGLLTNHYVCEVDGQNVIR	2
COBLL1	ELTDKEAER,SMSMDETDKSPCEAGR	2
GLTPD2	VATGALGGPEAGVQCSDAYR	1
TMA16	LQWFQNHLDPPK	1
CAND2	VLAFLSLAEVGQVAGPGPQR,VLAFLSLAEVGQVAGPGPQRELK,SPHSSTGVKVLAFLSLAEVGQVAGPGPQR	3
GSPT1	CPAAPPPPAGGAANNHGAGSGAGGR,GPAAPPPPAGGAANNHGAGSGAGGR	2
COL4A2	IAIQPGTVGPQGR	1
PRH2	PQGPPQQGGHPCPPR,PQGPPQQGGHPPPPQGRPQGPPQQGGHPCPPR	2
SPAG1	MVIQEIENSEDEEGKDSGR	1
EHHADH	KNPDIPQLEPSDYLK	1
C11orf16	ELPELEATAQLLPLEGPKEEK,ELPELEATAQLLPLEGPK,VPLGGLQSVSLTIWK	3
ATG16L1	RSVSSFPVPQDNVDAHPGSGK,SVSSFPVPQDNVDAHPGSGK	2
GOLGA5	SRIMQDQSEGNSLQNQALQTLQER,IMQDQSEGNSLQNQALQTLQER	2
COL6A1	CPDYTCPITFSSPADITILLDGSASVGSHNFDTTKHFAK,KCPDYTCPITFSSPADITILLDGSASVGSHNFDTTKHFAK,CPDYTCPITFSSPADITILLDGSASVGSHNFDTTKHFAKR	3
NSFL1C	ASSSILINESEPTTNIQIR	1
PTPN21	FQDVLPYDDAR	1
B3GLCT	LQHLLSCYDSGKPVFLGER	1
HLA-DPA1	ETVWHLEEFGR,EPVELGQPNTLICHIDR,FHYLTFVPSAEDVYDCR	3
VAV2	MVAVQNYHGNPAPPGKPVLTFQTGDVLELLR	1
COG1	ELLVSALQELQSSTSNSPSNK	1
DYNC2H1	SEGLPSDDLSIENALVIIQSR	1
SCRN3	DEIQIYQSK,IVNLFPQCTKDEIQIYQSK	2
HYPK	EDLELIMTEMEIPR,KEDLELIMTEMEIPR	2
KCP	GHVECYLEECQALSCPHGWAK	1
JHY	EESLPEISLLELLQNR	1
HNRNPH3	YIELFLNSTPGGGSGMGGSGMGAYGR	1
SORD	KVEGLLGCKPEVTIECTGAEASIQAGIYATR,SGGTLVLVGLGSEMTTVPLLHAAIR,VEGLLGCKPEVTIECTGAEASIQAGIYATR	3
MACF1	TLLPEDTQKLDNFLGEVR,LETMNQCWESVLQK,ATDETDRDIIREPLTELR,SRLETMNQCWESVLQK,GLNLEEITVSRPDSK	5
IQSEC3	ELTAIVQNQQSLIHSQR	1
SERPINB3	DLSMIVLLPNEINGLQK,GKDLSMIVLLPNEINGLQK,DLSMIVLLPNEINGLQKLEEK,GKNLSMIVLLPNEIDGLQK,GKDLSMIVLLPNEINGLQKLEEK,DLSMIVLLPNEINGLQKLEEKLTAEK	6
ZC3HC1	SWDSSSPVDHPEPEAASPTTR,TRSWDSSSPVDHPEPEAASPTTR	2
TYSND1	AGSEVLAAAGAVFLPGDSCR	1
MAN2A1	FSPTLELQGEFSPLQSSLPCDIHLVNLR	1
PNPLA6	ETPGRPPDPTGAPLPGPTGDPVKPTSLETPSPPLLSR	1
GOLIM4	QQQQQQQQVAR,LQGHLLRQQQQQQQQVAR	2
ADAMTSL1	TSPLGTQLVLGPGNSALLGCPIK	1
FBN2	SIHQPDPTAVEQISLESVDMDSPVNMK,IKGVTCEDVNECEVFPGICPNGR,GVTCEDVNECEVFPGICPNGR	3
PPP1R12B	LGQTPFDVADEGLVEHLQLLQK	1
NHLRC1	AAPSALGALTCHHTFGGWGTLVNPTGLALCPK	1
PPT1	CPSPPMTNLISVGGQHQGVFGLPR	1
C2orf88	EEVKEPPGTNIVILEYAHR	1
APBA3	ESGIDPSQVGVHPSPGAR	1
VAV3	TPIALATGIRPFPTEESINDENIYK	1
LRRC34	AINLNRPILYGEQEESTVHVGR	1
MAP2K2	KLEELELDEQQKR,ELEAIFGRPVVDR	2
CHDH	VLLLEAGPKDVR,LTEDPAERVLLLEAGPKDVR	2
ITGAV	GVSSPDHIFLPIPNWEHK,GVSSPDHIFLPIPNWEHKENPETEEDVGPVVQHIYELR	2
PRNP	HMAGAAAAGAVVGGLGGYVLGSAMSR	1
NCF2	LYEPVVIPVGR,QKLYEPVVIPVGR	2
COG4	SEDYEQAAAHIHR	1
VASN	LQDNELQALPPLRLPR	1
MLC1	LQGASWDTQSGPQER	1
SH3BGR	AEEGGETEAQKEGSEDAGNLPEAQEK,EGSEDAGNLPEAQEK	2
HGFAC	QGHVEQCECLGGR,VRQGHVEQCECLGGR	2
IDUA	LGGPGNSFHTPPR	1
BCAT2	PVLIGNEPSLGVSQPR	1
FERMT2	KKLDDQSEDEALELEGPLITPGSGTAVLYIGPLK,KLDDQSEDEALELEGPLITPGSGTAVLYIGPLK	2
NID1	SNGAYNIFANDRESIENLAK,GFPEISFQPSSAVVVTWESMAPYQGPSRDPDQK,CPDNTLGVDCIER	3
PALD1	QVQGGLTVFGMGQPSLLGFR	1
D2HGDH	HLHLASPVQESPFYILIETSGSNAGHDAEK,LGHFLEHVLGSGLVTDGTMATDQR	2
PEAK1	LENLLLVHYQPGGTAQGFGPAEPTPTSSYPTR	1
PLCG1	EDELTFTK,AQREDELTFTK	2
KIZ	VAVQEGINSGTAMSR	1
CROCC2	SSQALVASLR,PQATQALESQEWTHQQR,AEVSPEPLR,SSELMDVATVQDVLR,AHLWELEQAR	5
NACAD	EVPEAPPAACPEVSQAR,GLQAQEGTVSWAVEAAPQTSDR,GLQAQEGTVSWAVEAAPQTSDRGAYLSQR	3
MRPL41	DFKDGTFDPDNLEEYGFEPTQEGK	1
CD200	EQLYTTASLK	1
FREM2	IIMATDLDSEDK,EGETQHVVEIEVIFDGVR	2
STAB1	TRPGELMVGEDDAR,VCVAIDECELDVR	2
IGHV3-74	DNAKNTVYLQMNSLR,NTVYLQMNSLR	2
LYZ	YWCNDGKNPGAVNACHLSCSALLQDNIADAVACAK	1
TF	SMGSKEDLIWELLNQAQEHFGK,SMGSKEDLIWELLNQAQEHFGKDK,KSVEEYANCHLAR	3
PARP4	TSEDASEYYENYIEELKK,QITLHALSLVGEK,EFCTMVSTTELQK,GFGSYHPSAYSPFHFQPSAASLTANLR,HITSNTTAAEFIMSATPTMGNTDFWK,KVSPWETSTSSFFPILAPAVGSYLTPTAR,KTSEDASEYYENYIEELKK,WQQLNPDAPEALQAPAQVPSLFR	8
GDPGP1	DLTAEGIQWPR	1
DAB2	DISNDAFTALDPLGDK,DISNDAFTALDPLGDKEIK	2
TMPO	AMQADISEAAQILSSDPSR	1
C2CD2	ALGEDQVAETSAMSDALKDILK	1
HTT	VGALHGILYVLECDLLDDTAK,LRDGDSNSTLEEHSEGK	2
CLYBL	AFGLQAVDLVYIDFR	1
CD200R1	ASQALQSEVDTDLHTL	1
SKAP2	IYQFTASSPK	1
RYR2	GKGEHFPYER	1
DPYD	EGGANGITATNTVSGLMGLK	1
PALM2AKAP2	RAQQEQLLLQQQLQQQQQQPPSQLCTAPASSHER,AQQEQLLLQQQLQQQQQQPPSQLCTAPASSHER	2
FAM83H	VNLHHVDFLR,SLENCLLDLR	2
TRMU	HVVCSLSGGVDSAVAALLLR	1
DBH	AFYYPEEAGLSFGGPGSSR	1
KCNMB1	DQNQQCSYIPGSLDNYQTAR	1
CTBP2	SSSFSHRSELLHGDLASLGAAAPPQTASPR,SSSFSHRSELLHGDLASLGAAALQPQPAAPPQTASPR	2
ALDH3A1	LIQEQEQQLVGALAADLHK	1
RBMXL3	SYGGPCGTAPVWGTPPSYGGGCR	1
IFITM2	EEQEVAMLGAPHNPAPPTSTVIHIR,MLKEEQEVAMLGAPHNPAPPTSTVIHIR	2
SEPTIN4	IREEIVHFGIK	1
VEZT	TEYLCENALEGK	1
AP3B1	QLIVPNEK,FIRQLIVPNEK	2
SELP	AVQCQHLEAPNEGTMDCVHPLTAFAYGSSCK,GEFNVGSTCHFSCNNGFK	2
TRIM5	GHHTFLTEEVAQEYQVK,LQGSVMELLQDVDGVIKR,LQGSVMELLQDVDGVIK	3
DLST	LKEAQNTCAMLTTYNEIDMSNIQEMR	1
MRPL40	WSLYKQQEHKMER	1
MRPL23	NVVYPLYQLGGPQLR	1
TBXAS1	EAAEDCEVLGQR	1
SRP14	TKAAAAAAAAAPAAAATAATTAATTAATAAQ,AAAAAAAAAPAAAATAATTAATTAATAAQ	2
RABEPK	YQWDLDTCK	1
ACAA2	QTVQVDEHARPQTTLEQLQK,GKQTVQVDEHARPQTTLEQLQK	2
TNFRSF11A	NTECAPGLGAQYPLQLNK	1
PLEKHA6	CLSLQAEHAGVR	1
EFHD1	LSEIDVALEGVR	1
MUC16	VDLLCTYLQPFSGPGLPIK,DSSAMAVDAICTHRPDPEDLGLDR	2
PRAP1	AWMETEDTLGR	1
DDX60L	SDNPVVPSLFK	1
TSPYL6	EAGPGPGPLNVGLHLNPLESIQLELDSVNAEADR	1
PTPRC	TLLLDVPPGVEK	1
DSC3	VLNDGTVYTAR	1
CYP4A22	VWPNPEVFDPSR	1
CYP4A11	VWPNPEVFDPSR	1
FAM110C	TGDEGKAGNPETVPTTPGPAADPATPETPAPAAR	1
COL18A1	IFSFNGKDVLR	1
PMPCB	LCTSVTESDVAR	1
CERS4	NGTAGGPRPAPTDGPR,NGAAGGPRPAPTDGPQSR	2
CEP70	IGELEDESLNR	1
SPEN	LGEPAGESVENQEVQSK,VVAPVESHVPESDQAQGESPAANEGTTVQHPEAPQEEK	2
APOE	CLAVYQAGAR	1
CHID1	MVWDSQVSEHFFEYK,DHRPQMVWDSQVSEHFFEYK,DHRPQMVWDSQVSEHFFEYKK	3
COL6A3	LLPSFVSSENAFYLSPHIR,TRPEFYLNSYMNQQDVVNAVR,NNLFMSSAGYR,LHWERPEPPGPYFYDLTVTSAHDQSLVLK,AAGSDVNIDMAFILDSAETTTLFQFNEMKK,VAVVQYSDRTRPEFYLNSYMNQQDVVNAVR	6
HTATIP2	FFGSLPDSWAR	1
LRRC8C	SNTIQSGPEGSLVNSQSLK	1
FBLN2	GCIDMNECWASPGR	1
LONP1	VLFICTANITDTIPEPLRDR	1
COBL	RASLAPLQAEHSQPHEK,AREEVPALHPASHDIGK,EEVPALHPASHDIGK,AVTASNDEDLLIAGEFR	4
HEATR5A	LAQMVDDGAFTAGLAQVSFDK,LAQMVDDGAFTAGLAQVSFDKLK	2
TAAR9	TDLSTTNLFSEEVETD	1
IGHV2-70D	IDWGDDQFYSTSLK,ESGPALVKPTQTLTLTCTFSGFSLNTSAMR	2
EHBP1L1	HAGPVPVQVPLR	1
LTF	CLAENAGDVAFVKDVTVLQNTDGNNNDAWAKDLK,DVTVLQNTDGNNNDAWAK,SVQWCTVSQPEATK,CLAENAGDVAFVKDVTVLQNTDGNNNDAWAK	4
NPTX1	CESQSTLDPGADEAR	1
CEP170	NHEAGTSGCSIDAK,TNGKPEEKNHEAGTSGCSIDAK,LQSAGSAVPTSSSFK	3
GPLD1	VYALISDAQPLLLSTFSGDR,MYALISDAQPLLLSTFSGDRR,VYALISDAQPLLLSTFSGDRR,MYALISDAQPLLLSTFSGDR	4
CEP192	AARPPPDQLASEEPWTVLPEHLILVAPSPCDMAK,NLFLKPGEEHEVIVSFTPK	2
HAAO	VMFVGGPNTRK,VMFVGGPNSR,VMFVGGPNTR	3
WAPL	ISHVVIEDTVVSDK	1
EPCAM	RAKPEGALHNNDGLYDPDCDESGLFK,AKPEGALHNNDGLYDPDCDESGLFK	2
XPC	DPSLPVASSSSSSSK,AAASHLFPFEKL,AAASHLFPFEK	3
CCT6A	VEDACILTCNVSLEYEK	1
PPID	MSNWQGAIDSCLEALEIDPSNTK	1
CMYA5	CTLHLGIEPLDSVR	1
LHB	RSTSDCGGPKDHPLTCDHPQLSGLFL,STSDCGGPKDHPLTCDHPQLSGLFL	2
GHDC	LDHCLQEASPHYK,DKLDHCLQEASPCYK,LDHCLQEASPCYK	3
ASPSCR1	QGGPPGPTRPLTSSSAKLPK	1
CRNN	AHQTGQTVTGSGTQTQAGATQTVEQDSSHQTGR	1
TSC1	LMLLNTPGQLPQTLSSPSTR	1
RNF213	EIAAVISPELER,HILELQEVYDYLYQPSYR,TTDNFDDILK,IMCTVDHQGQR	4
IGKV1-39	VTITCRASHSISTYLNWYQQKPGK,LLIYAASNLQSGVPSR	2
POSTN	LLQEDTPMR,FIEGGDGHLSEDEEIK	2
NEFH	SEKETVIVEEQTEK,ETVIVEEQTEK	2
TBC1D5	GQGQSVQMSGAVK	1
PREX1	GSLAEMAGLQVGR	1
SPEF2	KDEEDALPVLQEEIK,DLLNTNDYEEYK	2
PRODH	EQSAAGPAAVPGGGSATAVRPPVPAVDFGNAQEAYR,DAYDNVTLDVELAHR,AAEIGYEDPINPTYEATNTMYHR	3
REPS1	SEDELRPEIDEHTQK	1
PSMF1	QDALVCFLHWEVVTHGYCGLGVGDQPGPNDK	1
PJA2	QTEHSPEDAACGPGHICSER	1
HNF1A	EALLQALGEPGPYLLAGEGPLDKGESCGGGR	1
UGT2B15	LEVYPTSLTKNDLEDSLLK,SSAIKLEVYPTSLTKNDLEDSLLK,NDLEDSLLK	3
CSH1	YSFLHNSQTSFCFSDSIPTPSNMEETQQK	1
ANXA3	DYPDFNPSVDAEAIQK	1
PIDD1	GPSAAGGHPGPAASEPVLPPLPGPQR	1
KLHDC7A	AEAPQSCSCENPR,TAVGSNPDTPHFPR	2
ODF3B	GTNGAPAYSIYGRPR,GTNGAPAYSIYGR	2
GRIPAP1	EAGKFSAVSEGQGDPPGGPAPTVLAPMPLAEVELK	1
CRIP1	CGKTLTSGGHAEHEGKPYCNHPCYVAMFGPK,PYCNHPCYVAMFGPK	2
AKAP5	DGDEVCESNVSNSITSGEK,KDGDEVCESNVSNSITSGEK	2
THBS1	IPEAGGDNSVFDIFELTGAAR	1
GALC	VVNVIGAHYPGTHSAK	1
ACSL5	ADIAVVICDTPQK,KPVPPSPENLSVICFTSGTTGDPK	2
RPN2	VKISTEVDITNVDLSTVDKDQSIAPK,NPILWNVADLVIKFPEEEAPSTVLSQNLFTPK,ISTEVDITNVDLSTVDKDQSIAPK	3
ITIH5	LIDGEYKDYLASHPFDTGMTLGQGMSR,VYIHHMSPTGGTDINGVLQR,PGGDGEGDPNHIER,DYLASHPFDTGMTLGQGMSR,DVTGSPRPGGDGEGDPNHIER,AGKDVTGSPRPGGDGEGDPNHIER	6
CLMN	SSESDHFSCVQLR	1
UROS	IGLVTEGETCGNAEK	1
MTMR7	AALGTLYLTATHVIFVENSPDAR	1
SCRIB	LAEAPSPAPTPSPTPVEDLSPQTSTSPGRLPLSGK	1
TMEM177	SLLGKEGEKLYTPSGNIVPR	1
DDT	SHSAHFFEFLTKELALGQNR,ELALGQNR	2
RILP	ELLTDHRVPSLLLEAMK	1
SMARCAD1	LDHGEESNESAESSNNWEK,VFAEDQDMQYASQSEVPNGK	2
KLHDC4	TQTVEVPCPPPSPR	1
COL6A6	EGVTIFTLGIEGTSDTQLEK	1
IGHV4-61	IYTSGSTNYNPSLK,QPAGKGLEWIGR,GLEWIGRIYTSGSTNYNPSLK	3
IGHV4-4	IYTSGSTNYNPSLK,QPAGKGLEWIGR,GLEWIGRIYTSGSTNYNPSLK	3
IGHV4-31	IYTSGSTNYNPSLK,QPAGKGLEWIGR,GLEWIGRIYTSGSTNYNPSLK	3
IGHV4-59	IYTSGSTNYNPSLK,ANYNPSLK,QPAGKGLEWIGR,GLEWIGRIYTSGSTNYNPSLK	4
GLMP	LLHTADTCQLEVALVGASPR	1
STN1	EIHATAYYK	1
MMP3	YLENYYDLEK	1
GBP3	DKNFNLPQLCIWK,NFNLPQLCIWK	2
PNPLA2	APADPAPAPADPASPQHQPAGPAPLLSTPAPEAR,MRAPADPAPAPADPASPQHQPAGPAPLLSTPAPEAR	2
CROT	WCQSMQDPSLNLR	1
MINK1	LDSSPVLSPGNK,NRVGASSKLDSSPVLSPGNK,SNSAWQLYLQR	3
ENPP1	SLCACSDDCKDQGDCCINYSSVCQGEK	1
ADH7	FPVIVGHEATGIVESIGEAVTTVKPGDK	1
P3H1	RIIESYFR	1
ARL2	EALELDSIR	1
DNAI2	AEEEFFDIIFTELK,AEEEFFDIIFTELKK	2
LY75	TPDWYNPER,EAYVSCQNQGADLLSINSAAELTYLKDKEGIAK	2
IFITM1	PLPLPQGLR,MHKEEHEVAVLGAPPSTILPR	2
DHRS1	CVVALAIDPNILSLSGK	1
GALNS	GDTLMASTLGQHK	1
IGKV6D-21	ASQNIGSSLHWYQQKPDQSPK	1
SPINDOC	TPPPRPSPLQAGSDGCEEPK	1
FMNL1	FSESTAMGASR	1
TXNDC11	DLSVKYPEDLPITLPNLLR,YPEDLPITLPNLLR	2
MYOF	SKTTEIIHSTLNPTWDQTIIFDEVEIFGEPQTVLQNPPK	1
TNXB	LGELTMTDATPDSLSLSWMVPEGQFDHFLVQYRNGDGQPK,CVDGHCVCNPGFTGEDCGSRR,LGELTMTDATPDSLSLSWMVPEGQFDHFLVQYR,LGQMTVRDITSDSLSLSWTVPEGQFDHFLVQYKNGDGQPK,CVDGHCVCNPGFTGEDCGSR	5
ATG2B	GIVDGVILPTETR	1
PODXL	GGSSGNPTTTIESPK	1
PLIN5	AQDTLAQLQETLELIDHMQCGVTPTAPARPGK	1
GNL3	NSLEFFTMLAQR	1
HAL	GETISGGNFHGEYPAK	1
IGHV3-20	AEDTALYYCAR,NSLYLQMNSLRAEDTALYYCAR	2
SLC5A6	LLSLFPLSCQK	1
ACSF3	YGMTEIGMALSGPLTTAMR	1
TGM4	DITYQYKYPEGSSEER,RDITYQYKYPEGSSEER	2
MTHFD1	DVDGLTSINAGR,MDTESELDLISR	2
CPA3	AIFMDCGIHAR	1
ARVCF	DVIPMDALGPDGYSTVDQR,AGPLGLGPGDGCFTLPGHR	2
VCAN	TYGQVSGEAIK	1
SYTL3	LGSKGDTAVGGDACSQSK	1
DOCK8	IQFMCGEDASNVMPVIFGK,TLQLAVAINQEPPDPK	2
MRPL9	NLGVVVAPHTLKLPAEPITR	1
TJAP1	ELEIGQNCLELELGQSR	1
RIOX2	IGRPVHEFMLQPGDLLYFPR,LQFKDHIVLTVLPDQDQSDETQEK,DHIVLTVLPDQDQSDETQEK	3
EIF3K	YGWSANESGQIFICSQEESIKPK	1
SH2D4A	KQDEEINQIEGER,KKQDEEINQIEGER	2
IDH1	VTYLVHNFEEGGGIAMGMYNQDK	1
LHPP	GVLLDISGVLYDSGAGGGK,LGFDISEQEVTAPAPAACQILKER	2
CEBPZ	ASLIEEDEPAEKENSSK,ASLIEEDEPAEKENSSKK,ASLIEEDEPAEK	3
SREBF2	GDFAAAAANLQTCLAVLGR	1
DNAH10	DIVDSFIRGSVLEAR	1
MRPL30	IKPLKLPQGLPTEENMSNTCLK,LPQGLPTEENMSNTCLK	2
AMACR	SSLWEAPR,TADGEFMAVGAIEPHFYELLIK	2
TACSTD2	AAGEVDIGDAAYYFER	1
C8G	GAVNVVVAETDYQSFAVLYLER	1
QRICH1	EIQEAIAVASASTMH	1
STK31	MTLDLNDENDAGNLITFPK,KMTLDLNDENDAGNLITFPK	2
H1-6	SETVPAASASAGLAAMEK	1
PTX3	LTSALDQLLQATR	1
ITGA6	DSMFGITVK	1
NUP153	KPAFNLSAFGTLSPSLGNSSVLK	1
STEAP2	SQFLEEGIGGTIPHVSPER,IILFLPCISQK,SLSETCLPNGINGIKDAR	3
TUBG2	KEDVFKDNFDEMDR	1
FMN1	SPDHSPTEQDDRTPGR,SPSVVLSEPSQESK,SNSKPADGPSDSKSPDHSPTEQDDR	3
CD6	QLGCGWAVQALPGLHFMPGR,EDAGVVCSEHQSWR	2
PDE12	TAVEKLSWAEAGSQTAAGAMER,LSWAEAGSQTAAGAMER	2
SAA1	RGPGGVWAAEAISDAR,GPGGVWAAEAISDARENIQR,GPGGAWAAEVISDAR,RGPGGAWAAEVISDAR,GNYDAAKRGPGGVWAAEAISDAR,RGPGGVWAAEAISDARENIQR,GPGGVWAAEAISDAR	7
F8A1	LHLQLGQPAAAAALCLELAAALR	1
IRAG1	SSPGDSPSAVSSNLSPSASPTSSR	1
TAP1	SGAHSFISGLPQGYDTEVGEAGSQLSGGQR,SGAHSFISGLPQGYDTEVGEAGSQLSGGQQQAVALAR	2
SP140L	TFEDSEDSCR	1
NMI	EHLPDEFIKDEQNK,EHLPDEFIKDEQNKGLIDEITK	2
PDHA1	GPILLELQTYR	1
ZNF638	SVVSDVPEELDFLVPK	1
TGM3	EEYVQEDAGILFVGSTNR	1
CDH17	STHNLQVAALDANGIIVEGPVPITIEVK,HTDFEEREYVVLIR	2
PSMD13	DVPGFLQQSQSSGPGQPAVWHR,MKDVPGFLQQSQSSGPGQPAVWHR	2
ALPP	LGPELPLAMDR,DKLGPELPLAMDR,DKLGPELPLAMDRFPYVALSK,LGPELPLAMDRFPYVALSK	4
ZHX3	VMIPLSSIPTYSAAMDSNSFLK	1
WWOX	VETMTLDLALLR,AKVETMTLDLALLR	2
FECH	LFLDQDLMTLPIQNK	1
DMKN	QVPGFGAADALGNR	1
TRIM22	ENQEAEKLEDDIR,LIKENQEAEKLEDDIR	2
EPS8L1	QQSAPEVAVNGHR,GFSSGTVDALGVLTGAQLFSLQR,STTTGPEAAPKPSAK	3
APOB	EVLKESQLPTVMDFR,NEVQIHSGSFQSQVELSNDQEK,WKNEVQIHSGSFQSQVELSNDQEK	3
ARMCX4	AEAGAGAEAGAGAGAEAGAEAR,AAAQPQAVASTHAEAMSNAKVK	2
UQCR10	AFDQGADAIYDHVNEGK	1
CD33	EGAIISGDSPVATNKLDQEVQEETQGR	1
FOXD2	AFYPASLSPPAAGTAAGLPTALLR	1
KRT6B	AGGSYGFGGAR	1
DNAJC3	AEAYLIEQMYDEAIQDYETAQEHNENDQQIR,DRAEAYLIEQMYDEAIQDYETAQEHNENDQQIR	2
KRR1	SVSFEQAVQILQDDVACDIIK	1
FAM171B	AELSRSDLSLIQQQQQQQQQQQQQQQQK,SDLSLIQQQQQQQQQQQQQQQQK,AELSRSDLSLIQQQQQQQQQQQQQQQK	3
CDH11	VTITLTDVNDNPPKFPQSVYQISVSEAAVPGEEVGR,FPQSVYQISVSEAAVPGEEVGR	2
PEBP4	HWLVTDIKGADLKEGK	1
GPSM1	DSLPIPVR	1
PGM5	LYAESYERNPSGHDQEPQAVLSPLIAIALK	1
PRRG3	EAASSPQVVLGPSR	1
PXK	SALENSEEHSAR	1
TNC	GLCVDGQCVCEDGFTGPDCAELSCPNDCHGR,DCSNRGLCVDGQCVCEDGFTGPDCAELSCPNDCHGR,VPGDQTSTIIR,VPGDQTSTIIRELEPGVEYFIR,YGDNNHSQGINWFHWK,CVDGQCICHEGFTGLDCGQHSCPSDCNNLGQCISGR,LIPGVEYLVSIITMK	7
ANPEP	QWMQNPNNNPIHPNLR,QQQDYWLMDVR,LPNTLKPDSYQVTLRPYLTPNDR	3
HERC1	IPQDTTQTNVTSAEGWWDQESNCQDGYRK	1
KANK2	SQEVVETMCPVPAAATSNVHTVK	1
PTPRN2	TQLHEDLLPR,THTAQDRPPAEGDDRFSESILTYVAHTSALTYPPGPR	2
PPP1R32	QPTGFSLNNPMYVR	1
TARS1	FENEEAQAVYWHSSAHIMGEAMER	1
CYP4F11	RTLPTQGIDDFLK,FNQENIKER	2
ACSM5	NNDVINSSSYR,HCLTGGEALNR	2
KIAA1522	VSLQALEAEAEAGAETEAVLQR	1
ATP6V1E2	HMMAFIEQEANEKAEEINAK,AEEINAKAEEEFNIEKGR	2
ADAMDEC1	ECTSLCCEALTCK	1
TRIM33	TEPADMNESCK	1
PCCA	MADALDNYVVR	1
MYLK	FSASAVETRPSIWGECPPK,TLSEDELKEIPAEQMDFR,TLSEDELK,GQGWPEEEDGEDVR	4
CLIP1	EENSGLLQELEELRKQAEK,MSGDNPSQLTK	2
CAPN2	DREAAEGLGSHER,QDIQSDGFSIETCK,LAKDREAAEGLGSHER,RQDIQSDGFSIETCK,EAAEGLGSHER	5
RCC1L	GEVYSCGWGADGQTGLGHYDITSSPTK	1
FBP1	GKIYSLNEGYAKDFDPAVTEYIQR,IYSLNEGYAKDFDPAVTEYIQR	2
ETFB	QAIDDDCNQTGQMTAGFLDWPQGTFASQVMLEGDKLKVER	1
FILIP1	FSKEHEEMNAK	1
IGHV4-39	VTISVDTSKNQFSLR,LNSVTAADTALYYCAR,GLEWIGSIHYR	3
KLK3	LSEPAEITDAVK	1
ANKZF1	LLLEAGADPTVQDCR,LAAQLGAPTSLIPDSAIVNTR	2
ACSS3	VDDVINVSGHR	1
SPATA7	AAVDCSVPVSMSTSIK	1
KANK1	DAAVGTLVQMR	1
SVEP1	EVTFHCHEGYVLHGAPK	1
PPA2	NCNGGAINCTNVQISDSPFR,ALLMKNCNGGAINCTNVQISDSPFR	2
TM9SF1	WSETSVEHR	1
CLGN	LLSDTDDLILENFYDK,IPDPSAIKPEDWDESEPAQIEDSSVVKPAGWLDDEPK	2
SQOR	ALQNFKEGNAIFTFPNTPVK	1
TMEM43	EIGHKNPSAMAVESFTATAPFVQIGR,NFDREIGHNNPSAMAVESFTATAPFVQIGR,EIGHNNPSAMAVESFTATAPFVQIGR,NPSAMAVESFTATAPFVQIGR	4
DCAF8	VHDRSEEEEEEEEEQPR	1
PRSS35	EASGGDQREGTREHLQER	1
LACTB	YAMAWGVVEK,EGQSNEKNDFTK,YAMAWGVVEKK,ENVAFEQEKEGQSNEKNDFTK,ENVAFEQEKEGQSNEK	5
PLIN1	VVEYLLPADK,VVEYLLPADKEESAPAPGHQQAQK	2
TRIM63	NLLVENIINIYKQECSSRPLQK	1
RNASEH2A	LQDSDTDYGSGYPNDPK	1
EMC1	TSNSEDGSMGSFSEK,NEVQKTSNSEDGSMGSFSEK	2
HRG	HPLKPDIQPFPQSVSESCPGK	1
CAVIN3	MRESALEPGPVPEAPAGGPVHAVTVVTLLEK,ESALEPGPVPEAPAGGPVHAVTVVTLLEK	2
LILRB2	YGCQYYSHAR	1
DCAF13	NYDPALHPFEVPREYVR	1
HSPBP1	VLSQPMPPTAGEAEQAANQQER,LPLALPPASQGCSSGGGGGGGGGSSAGGSGNSRPPR	2
HSD11B2	AHTTSTGLWGLINNAGHNEVVADAELSPVATFR	1
MAPT	EEVDEDRDVDESSPR	1
KRT8	ASLEAAIADAEQHGELAIKDANAK,ASLEAAIADAEQHGELAIK	2
HABP2	KEEFHEQSFRVQK	1
NCF1	QGTLTEYCGTLMSLPTK,AAENHQGTLTEYCSTLMSLPTK	2
SWAP70	EQALQEAMEQLEELELER,VLKEQALQEAMEQLEELELER,VLKEQALQEAMEQLEELELERK,EQALQEAMEQLEELELERK	4
DSC2	GGHQTSESCQGAGHHHTLDSCR	1
ATP5MJ	NLWIPMKPYYTK	1
CFH	SPPDISHGVVAHMSDSYQYGEEVTYK,SLGNIIMVCR	2
LUZP1	VGDTITVAAWNHSASMEEEGEDCTLNVYR	1
NSUN5	TCSNDVVDYFKR	1
TBC1D4	LLPADALANCDLLLR	1
RDH13	DIRGETLNHHVK	1
MYO1D	RFQEALQTIFNR,FQEALQTIFNR	2
SEC14L4	LFPMAFNLVK	1
CRACR2A	GDEDLGDMGKDEEAQFR	1
RINT1	SDINVTVLIGCK	1
RSF1	FYETKEESYSPPKDR	1
ZFPM1	AAPQNGGSSEPPAAPR	1
TSEN15	GDSEPTPGCSGLGPDGVR	1
MAST2	SGLITSQYFYELQENLEK	1
DYNC1H1	GNEIVLSAGSTLR	1
SIGLEC5	KKPWPDSAGDQASPPGDAPPLEEQK	1
CYP27A1	DFAHMLLLK	1
DOCK1	KQTSVDSGIVQ	1
PLA2G7	LKGDIDSNAAIDLSNKASLAFLQK,LKGDIDSNAAIDLSNK	2
IGKV4-1	SSQSVLYR	1
TCIRG1	RFVVDVWR	1
ITGAM	QNTGTWESNANVK,LACESASSTEVSGVLK	2
TBC1D20	LLNVNASDPPPISGK	1
MYOM2	LCFTVQGFPMPMVQWYK,FVVHGLTTGEQYLFR	2
LMO7	YNGDIEDIKR,STTELDDYSTNKNGNNKYLDQIGNTTSSQR,GATYSSEIPKEDSTTFAK,STQMESTCVSASLPR,YLDQIGNTTSSQR	5
SIRT5	FHFQGPCGTTLPEALACHGNETVS	1
EFHC1	NDWGDHYHWK	1
DUOX2	IPPGDLVFDPDQR,IPPGDLVFDPDQRGDVVLPFQR	2
IGKV2D-30	SSQSLVHSDGNTYLNWFQQRPGQSPR	1
IGKV2-30	SSQSLVHSDGNTYLNWFQQRPGQSPR	1
PGLYRP2	WGAAPYQGRPK	1
NUDT19	EAFEEAGVLLLQPR	1
HEPACAM	VLMEDDDLYSCVVENPISQGR	1
SEPTIN11	LTIVDTVGFGDQLNK,LTIVDTVGFGDQLNKDDSYKPIVEYIDAQFEAYLQEELK,LKLTIVDTVGFGDQLNK	3
ELP1	VFLENVETFIK	1
CPOX	GIGGIFFDDLDSPSKEEVFCFVQSCAR,YFEVEEADGHK	2
CFAP251	DKLGLQILPVDGNPHK	1
RAD51D	TQDEEEQAEALQR	1
RNF130	SALGNLAGDNSLGLEPLR	1
POMGNT1	NHFLVVGVPASPYSVK	1
H2BS1	AMGIMNSFINDIFER	1
TMED5	SGHIQILLR	1
IRS1	VGNTVPFGAGAAVGGGGGSSSSSENVKR	1
MTUS1	QINDLKSQNDALNEK	1
BAG3	GMPETTQPDKQR,IDPQTGWPFFVDHDSR,AAPSTAPAEATLPKPGEAEAPPK	3
NUDCD1	LMHLTSEELNPHPDK,SFTFVQAGQDLEENMDEDVSEK	2
SLC12A8	SLQSPQEQIILAPSLAK	1
NPEPL1	ASEDPLLNLVSPLGCEVDVEEGDVGRDSK	1
CCDC88B	EAPQGELVPEAR	1
ERO1B	ELEVCEQANK	1
BOLA2B	DLEAEHVEVEDTTLSR	1
GOT2	NVFLPKPTWGNHTPIFR,TCSFDFTGAVEDISK	2
TTR	YTIAALLSPYSYSTTAVITNPKE	1
ACAT2	RGLIEVKTDEFPR,AGHFDKEIVPVLVSTRR	2
KTN1	AEVQKLQALANEQAAAAHQLEK,LQALANEQAAAAHQLEK,QTEDSLASERNR	3
UGT1A8	GIGCHYLEEGAQCPAPLSYVPR	1
ANKRD22	NPSLIPLLLEAR	1
MEAK7	SILDADPEAQALLEISGHLR,VQVLAAQLLSEMK	2
LSS	ILGVGPDDPDLVQAR,VVYALLNLYEHHHSAR	2
KRT24	QTMQSLNDR	1
CTSD	YSQVVPAVTEGPIPEVLK	1
PIK3AP1	EWQLNQKR	1
WDR17	FGGGIGVPTKEER	1
PLPP7	GPYEMSPSLLDYLTMDIYAFPAGHASR	1
PRR4	HPPPPPFQNQQRPPQR	1
TTC1	VTDTQEAECGGPPVPDPK	1
NTAN1	KHPSPANTLFPGNK	1
HGD	PFESIDEGHVTHNWDEVDPDPNQLR,CPGSLPEGQNNPQVCPYNLYAEQLSGSSFTCPR	2
CP	MYYSAVDPTKDIFTGLIGPMK,MYYSAVDPTK,ADDKVYPGKQYTYMLLATEEQSPGEGDGNCVTR,MYYSAVDPTKDIFTGLIGPMKICK	4
PPIL3	TYRPLNEVHIK	1
FAM185A	WPGSETEVPPPGPAR	1
LRIG1	AEAPYLLVSNGHLPK	1
SLC7A6OS	LRSDAVESAAQKTSEDLER	1
SLIT3	SLTSLVLYGNKITEIAK	1
SGPL1	AFEPYLEILELYSTK	1
PALM	LEKEIEVLERGDSAPAAAK,EIEVLERGDSAPAAAK,GDSAPAAAKENAAAPSPVR	3
TRDN	AKEEIGAVSSK	1
ARHGAP6	WQGSPAELESDTQGAR	1
SLC26A2	RDYEAIGIQVLLAQCNPSVR	1
ZC3H3	GSLEEYEDTPWSDQRPR	1
CLEC18A	LETTNEVTDSDFETR	1
CLEC18B	LETTNEVTDSDFETR	1
PON1	SLDFNTLVDNLSVDPETGDLWVGCHPNGMK,GIETGSEDMEILPNGLAFISSGLK,GIETGSEDMEILPNGLAFISSGLKYPGIK	3
MCM3	DSKEPFSSVEIQAALSK	1
GLO1	ATLELTHNWGTEDDATQSYHNGNSDPR,KATLELTHNWGTEDDATQSYHNGNSDPR	2
F5	MRPWEDPPSDLLLLK,LLSLGAGEFR	2
CPZ	FPPEEALYTLWQHNK	1
TRAPPC5	VFSVAELQAR	1
PAX9	NNFPAAAPHPVNGLEK	1
GEMIN4	FLGQILTAFPALR,ALFREPDLVLR	2
VWA3B	EVAALTGGEFHFYNFGCKDPTPPEAVQNEDVTLLVK	1
MSRB2	GQAGGGGPGTGPGLGEAGSLATCGLPLAK	1
DDC	GKEMVDYVANYMEGIEGR,EMVDYVANYMEGIEGR	2
C2orf69	QCLQLSTVPGAEPQR	1
LRRFIP1	HGIILNSEIATNGETSDTLNNVGYRGPTK,ALDSNSLENDDLSAPGREPGDFNPESR,KALDSNSLENDDLSAPGREPGDFNPESR,SAVEAQNEVTENPKQEIAAESSENVDCLENPK	4
SEC23B	GAIQFVTHYQQSSTQR	1
DGKG	QAPAEDQVAASPLEPPVPR	1
CYP2C9	RSIEDCVQEEAR	1
PIEZO1	DPGLEPGPDSPGGSSPLR,ESDQHVVPTAPDTEADNCIVHELTGQSSLLR	2
SIRT3	ELYPGNYKPNITHYFLR	1
WRAP53	LQLWWCGGGPDSSIPDDHQGEK	1
FARP2	HDEILTELEK	1
DENND4C	ESGMATAFIHALER	1
ITGA7	ICQSNLQLVHAR,QGCGEDKICQSNLQLVHAR	2
TBL2	LALSPNAQILALASGSSIHLYNTR	1
GNB1L	ALAVWSLDGQQALQVR	1
GRIN2C	ALREAPLGLR	1
IGHV3-33	DNAQNSLYLQMNSLR	1
AKR7A2	LQCPQVDLFYLHTPDHGTPVEETLHACQR	1
WDR33	GMQGAPPQGSMLGPPQELR	1
CLCA1	DMVTQASLYLFEATGKR,DMVTQASLYLFEATGK	2
ALG2	ERDPVPKPSVLFLHPDLGVGGAER	1
INF2	ALEQQASTPPPPPPLLPGSSAEPPPPPPPPPLPSVGAK,ALEQQASTPPPPLLPGSSAEPPPPPPPPPLPSVGAK	2
ABCB11	ILNDLNMAIKPGEMTALVGPSGAGK	1
ACIN1	ELLVPQHTVQLVGGLSPLSSPSDTK,EAPILKEFKEEGEEMPR,EFKEEGEEMPR,ELLVPQHTVQLVGGLFPLSSPSDTK	4
PDCD4	DSGRGDSVSNSGSDALRSGLTVPTSPK,NSSRDSGRGDSVSNSGSDALR,DSGRGDSVSNSGSDALR	3
ZNF830	EASQGSSASSAPQSVKR	1
PRODH2	EQELLSQELWQR	1
NPEPPS	AFFQSHPAPSAER	1
GGA3	LHTLQEVNNNVR	1
NES	AWLSSQAAELER,SLKEESIEAVK	2
PPIAL4H	HTGSGILSMVNAGPNTNGSQFFICTAK,KHTGSGILSMVNAGPNTNGSQFFICTAK	2
PPIAL4F	HTGSGILSMVNAGPNTNGSQFFICTAK,KHTGSGILSMVNAGPNTNGSQFFICTAK	2
PPIAL4C	HTGSGILSMVNAGPNTNGSQFFICTAK,KHTGSGILSMVNAGPNTNGSQFFICTAK	2
PPIAL4E	HTGSGILSMVNAGPNTNGSQFFICTAK,KHTGSGILSMVNAGPNTNGSQFFICTAK	2
IGKV3-11	ASQSVSGYLAWYQQRPGQAPR,LLIYDASVR	2
UBE3A	AACSATAMEEDSEASSSR	1
LTN1	TSSSESSAVISAFFECLR	1
RGPD2	LAAVAQGLQQTSIPK	1
IGKV1-8	ITQSPSSLSASTGDR,MTQSPSSLSASTGDR	2
CYP4F3	LVHDFTDDVIQER	1
LYAR	EQNQRPLHPVANPHAEISTK	1
GKN2	QALDNMFSNK	1
MYH7	NAYEECLEHLETFK	1
WDR81	DRLVAGEDDLEQATEALDSISLAGK	1
ZNF793	DPLSAVNAGNRLVRSHTSMYIEK	1
LRRK2	TLINESLNFK,KTLINESLNFK,KNVSIEFPVIDR	3
GOLGA3	TEDSNAGNSGGNVLAPDSTKGSLKQNR,SLADYRTEDSNAGNSGGNVLAPDSTK,LQAEANDLQIR,DVLQAAAAEHQDQGQEVSGEVR,EHLVQKLQAEANDLQIR,TEDSNAGNSGGNVLAPDSTK	6
SLCO1B3	IYVDIGYVDLSTIR	1
MYO18A	VQLTPVEEAHQQLER,ISELTSELTDERNTGESASQLLDVETAER,QNPATQNVPR	3
FAM207A	ASPLLAIGQTLAR,DALPELLGLEAGIR	2
PPFIBP1	LNATEEMLQQELLSR	1
CHGA	GWRPSSWEDSLEAGLPLQVR	1
RABEP1	DVQEQIAVLMQSR	1
GMPPB	FVEKPQVFVSNKINAGMYILSPAVLR,INAGMYILSPAVLR	2
CINP	WETLNDAGFTTANNIAK	1
ESF1	SLDPALSMLIK	1
CALB2	QHVGSSTEFMEAWR	1
SUN2	SSLEERHGDANWGEDLR,FTYDQDSEPIQTFHFQAPTMATYQVVELR	2
NBEA	SSHGSGKPQEVPQSVTATAASK	1
EEF1AKNMT	MDVTQMEFPDASFQVVLDK	1
MOGAT2	VEFAPLFVPWER	1
FKBP4	FEIGEGEKLDLPYGLER	1
PLIN2	SQQTIPQLHSTVHLIEFAR	1
C11orf96	GAPAQRPPSESPGAPPPGPADAGGAMAAK	1
PLSCR4	NNSDQMVYVVTEDTDDFTR	1
BCL2L15	NVIAETIKGQTGAILQNTVESLSK,GQTGAILQNTVESLSK	2
QSOX1	NNEEYLALIFEKGGSYLAR	1
PCK2	LCQPEGIHICNGTEAENTATLTLLEQQGLIR	1
FGD5	ANNSMEQGENLQK	1
DUS2	QAPDQDPGGPR	1
HEBP2	SFNGFSSAQKNQEQLLTLASILR	1
RALGAPA2	VLYGPLEGCLAPSGR	1
SCRN1	CICNQLSLTTK	1
SBSPON	TESLTPHCALENRPLTR	1
CAST	AAAPAPVSEAVSR,KAEPELDLR,TEESKAAAPAPVSEAVSR	3
LBR	NTQEKFNLSQESSYIATQYSLRPR	1
FAM174B	FGSGAAGGSGSSNSSGDALVTR	1
NDUFC1	QHNEDILQYKR,QHNEDILQYK	2
KIDINS220	SSESSPNHSLHNEVADDSHLEK	1
DNAJB12	KQYDQFGNDKSQAAR,QYDQFGNDKSQAAR	2
NOL10	NGTLSVSNTTVGSK	1
MICALL2	TDQALVGSLVSSTCGVCGK,QALSALEEAGAPAPGRPSPATAPVPSSQPK	2
ABCA6	NISFCVQEGEILGLLGPSGAGK	1
DNPEP	LEQQLVHVERPVLR	1
UBXN1	LYVELHRGQELGGGQDPVQLLSGFPR	1
RGPD3	EMLNSVMQELENYSEGGPLYK,DGQYFEPVVPLPDLVEVSSGQENEQVVFSHR	2
TRIM25	LQELTPSSGDPGEHDPASTHK	1
DENND2A	FQNDHLSVLK	1
DENND3	EDSQTAGANCGTLGK	1
SYPL2	IQYEMPLCDEGSSSK	1
EEA1	QILKQDFETLSQETK,QEEEKQILKQDFETLSQETK	2
PGM2	ASYFICHDQDTIK,ASYFICHDQDTIKK	2
CLEC1B	NYLQDENENR	1
NCAM2	AVDGFTFTEGDKSPDGR	1
KRT2	WELLQQMNVDTRPINLEPIFQGYIDSLKR	1
RPS6KA1	EITPPFKPAVAQPDDTFYFDTEFTSR	1
PFKM	LQAAYNLVK	1
GPRIN2	EVGAGGCCHALPATGILAFPK,AVATSPSLEAPAALHVFPEVTLGSSLEEAPSPVR	2
WDR44	ENITSDSLLTTSMASESTVK,TPDIDVPKENITSDSLLTTSMASESTVK	2
PYGB	LKQEYFVVASTLQDIIR,RWLLLCNPGLANTIVEK,QEYFVVASTLQDIIR,WLLLCNPGLANTIVEK	4
SZT2	EIPLTPVDQAAFLSEVLQR	1
PLEKHG1	FVDADFSDNVCSGNTSHSLNSPR	1
SIGLEC1	FAAITLTQAGAYHCQAQAPGSATTSLAVPISLHVSYAPR	1
CENPVL3	SVVIEEVGGGDPGEEAAK	1
LEMD2	GLVYPARPAQLR	1
SOGA1	RGPGPGSAVACSAASSSRPDK	1
H6PD	LFGSPLSDYYAYSPVQER,ESLLVSAWSEELISK	2
ADAM15	ESVHTQTPPEHPLGQR	1
SPICE1	LQPEESTETVDSSYVVGHVLNSR	1
GLYAT	ILSPSGGKPK	1
MRM3	VVFPSEEVVEQK	1
ATAD3A	ATVEQEMELR,RATVEQEMELR	2
SAMD9	VELTEDKIDYTK,SLKVELTEDKIDYTK	2
IGLC2	AGVETTIPSK	1
GCFC2	DIDLSCGSGSSK,VILEEHSACENEVSK	2
PDIA2	ELAEEFGVTEYPR	1
TEKT2	VLCNETNNQTIWDEHDNR	1
PTGFRN	VPGFADDPTELACQVVDTK,AVEVATVVIQPTVLR	2
CYP11A1	HQAQGDMATMLQLVLLLK	1
MOXD1	CASIPDIMQQLQFIGVK	1
IGKC	HKLYACEVTHQGLSSPVTK,VDNALQSGNSQESVTEQDSKDSTYSLSNTLTLSK,LYACEVTHQGLSSPVTK	3
DNAJC11	NLDKNTMGYLQWR,NTMGYLQWR	2
SAMD15	EYYAIGSLR	1
ARHGAP28	INPQAEWVIKPQPSS	1
ABCC8	HVNALISPGQK	1
ARSL	LAGSEVPQDR	1
TPO	APSACAPEPGIPGETR	1
NPNT	CQCPSPGLHLAPDGR	1
ALCAM	SSNTYTLMDVR	1
LRRC1	RLEELDLGNNEICNLPESIGALLHLK,LEELDLGNNEICNLPESIGALLHLK	2
IGKV2D-24	FSGVPDRFSGSGATDFTLK	1
APPL1	LIAASSRPNQASSEGQFVVLSSSQSEESDLGGGGK	1
NIN	VSQMNSLEEELETIHLENEGLK	1
VCPKMT	YLETPEFSGDGDHALSR	1
MYO7B	YLVNFIGQGPATYGPFCAER,TSVAIGGIIK	2
DTX2	LSAASGYSDVTDSK	1
ICAM5	EGLPWPEQQR	1
DLG5	IASSYYPEGDGDSSHLLAK	1
REPIN1	LPLPCPECGHR	1
C1orf116	GGPKETITQQGR,SMPIPIPK	2
CYP2B6	HRETLDPSAPR	1
RASA4B	HRELSGGTEAGTVPTSPGK	1
RASA4	HRELSGGTEAGTVPTSPGK	1
PCSK5	ECMPEFFLHDDMCHQSCPR	1
ZFYVE19	VLQQLTEEAALDEASGFNIPAEQASRPWTQPR	1
CPN1	YGDPNHHLPLPDNWK	1
TMCO4	VGAIEEFTFLPLTESR,TSSVQLHVAGLQPVLLQDR	2
CYP2A7	TLDPNSPQDFIDSFLIR	1
SMC6	TAQILNLQQHLSTLEK,HALSYNQGQLK	2
VPS8	LSSSAIPHLYSEALK,KGTSEPVLDPQQTQAFDQLCR,GTSEPVLDPQQTQAFDQLCR	3
LSM14A	VSRPESEQLR	1
ATIC	TVASPGVSVEEAVEQIDIGGVTLLR	1
GYS2	SDITVVVFFIMPAK	1
BCAS1	VEDQENEPEAETYK,GDGGITHSEEINGKDSSCHTSDSTEK,MLDAQVQTDPVSIGPVGKPK	3
VARS1	GALINVPSPFLGLPR	1
NHLRC2	VSTIAGIGIQGTDK,VSTIAGIGIQGTDKEGGAK	2
BCS1L	DVQEFINNPK,DVQEFINNPKWYTDR	2
ZYX	PQVQIHVQSQTQPVSLANTQPR	1
WDR92	LVATSLEGKFHVFDVR	1
ATP9B	DKQVNSQLYSK	1
BCO2	FIAVNGATAHPHYDPDGTAYNMGNSFGPYGFSYK	1
ACTBL2	VAPDEHPILLTEAPPNPK	1
CSPG4	DVNERPPQPQASVPLQLTR	1
SPTA1	TKLEDYANLK,HQTFAHEVDGRSEQVHGVINLGNSLIER,TGQEMIEGGHCASDNVTTR,YLKHQTFAHEVDGRSEQVHGVINLGNSLIER,SEQVHGVINLGNSLIER,GDCGDTLAATQSLVMK	6
RADIL	NGPSGLRGAAPEGDSAALAEESPPAPSSR	1
SLC16A4	NLTVSQNQSEEFYHGPNR	1
MKI67	YENESLQSGR,SQPAASTLESESVQR	2
AIMP1	QIAFPSGTPLHANSMVSENVIQSTAVTTVSSGTK	1
AOC3	TIHDAFCVFEQNQGLPLRR,TIHDAFCVFEQNQGLPLR	2
LYRM4	AQVLALYR	1
GSDMA	GHEVNLEALPK	1
MMP24OS	HPPQPQPQPQPQPQPQPEPEPSPWGPLDDVR	1
SLC25A33	NSTSFFGLMAAAAISK	1
RABGGTA	AAYLDDLR	1
AFDN	GHAEQGDPGAPEQTGPQR	1
PDE5A	ADNSVPGTPTR	1
ABCD4	SQDCEILGESK	1
SALL1	LQNSEPSAPLAGLEK	1
IGKV2D-29	PGQSPQLLIYEVSNR	1
RIF1	AATMENAVLLETNTVEEK	1
DPEP1	VFQAVEQASNLTQAPEEEPIPLDQLGGSCR	1
GPN2	ANGYCFGAQEQR	1
RESF1	MTNTTYSEPAQNSK	1
TEKT1	ENTIYINEVLCMQMR	1
RRAD	DLQAALTPGALTAAAAGTGTPGPR	1
TTLL12	LEHEVFDAGEVFGIMQVEEVEEEEDEAAWEVRK,KQQPNPGSELCYK,QQPNPGSELCYK	3
LRP1	QWECDGENDCHDQSDEAPKNPHCTSPEHK	1
SIRPA	KGSPDTEFKSGAGTELSVR	1
CLOCK	ELGIEESIPETAADK	1
DLL3	CGPGLRPCAPLEDECEAPPVCR	1
MLPH	MALGIAAALGSNVIR,ASSESQIFELNKR,LQGGAGPEPISEER,ASSESQGLGAGAR	4
SCARF2	AATDLPGPETPR	1
HP1BP3	GKASGSFVVVQK	1
SMG6	QQVSVSSTDSLDEDRIDEPDGLGPRR	1
NUCB2	LQGIPPSGPAGELK,KLQGIPPSGPAGELK,KLQGIPPSGPAGELKFEPHI	3
MOCS1	GLNEDELLDFAALTEGHPLDVR	1
MTARC1	DCGEAAAQWITSFLK	1
LSR	NSSAGGQGSYVPLLR,SVDALDDLTPPSTAESGSRSPTSNGGRR	2
LRG1	TLDLGKNQLETLPPDLLR,NALTGLPSGLFQASATLDTLVLK	2
MMS19	HPAGQQLDEFLQLAVDKVEAGLDSGPCR	1
PYCR3	HVGSSETNLLQHLLEACGR	1
PSME4	NFDDAFLPVLKPHLEHLVADTHESTQR	1
SETD6	QSVQAGELLFVVPR	1
GRK5	EIFSACAQSVHEYLR	1
NLE1	HWVLSISWSPDGKK	1
GPD2	TDPQTGKVHVSGAR	1
PKD1	VLTTGPTPSSFPR	1
TBC1D1	AILQQLLLLR,GSESPRPNPPHAAPTGSQEPGR	2
LECT2	SQRPHQGVDVLCSAGSTVYAPFTGMIVGQEKPYQNK	1
DNAI4	TMLIPPELK	1
EMILIN1	VLLNDGGYYDPK	1
USP47	EGSVGSTSDYVSQSYSYSSILNK	1
MCCC1	QYNIVGLPTNIDFLLNLSGHPEFEAGNVHTDFIPQHHK	1
VPS13C	GEPLHIVNSSNVTDEPLLK,WNYIASSECLPFWPENLSGK,LENVIVTDVDPK	3
CYP2A6	DPSFFSNPQDFNPQHFLDEK	1
EIF2A	NTVLATWQPYSTSK	1
PECR	KHGGSIVNIIVPTK	1
THG1L	LQGTLAADKNEILFSEFNINYNNEPPMYR	1
RPL13	STESLQTNVQR,NKSTESLQTNVQR,STESLQTNVQRLK	3
SPEG	GTQDSSAVPSAAHQEAPVTSGPAR	1
LIPC	LSPDDASFVDAIHTFTR	1
EHD4	SISIIDSPGILSGEK	1
CLEC4M	NWHNSVTACQEVR	1
CUL2	SAVDEDRKMYIQAAIVR	1
AAK1	KKSMEELTVIQCTSQELPAQTGLLSQTGDVPLPASR	1
SMC5	VAALNIQVGNLCEFLPQDKVGEFAK	1
KIF26B	TRGDSQPAEAGEAAAGK	1
VMAC	AELLQDICHR	1
ENGASE	EEENFTCR	1
HDLBP	VHIEFTEGEDKITLEGPTEDVSVAQEQIEGMVK	1
PARD3B	EVLNGVQTELLTSPK	1
TBCD	LLSMTLSPDLHTR	1
ARHGAP12	HSTIVLDTNDKESPTASKPCSPENESSPSSPK	1
KDR	FLSTLTIDGITR	1
LZTFL1	SLEENLATAKHNLLR	1
SAA2	LTGHGAEDSLADQAANKWGR,LTGHGAEDSLADQAANK	2
GALNT2	SGGLSVEMCGPALSQQWK	1
EPS15	EKDPEMFCDPFTSATTTTNK,AELTSQELQISTYEEELAK	2
USP36	TFVGEPQRLGSETCLPQHIR,LGSETCLPQHIR	2
SHANK2	SMTSELEELDKPEEIVPASKPSR	1
ZG16B	YFSTTEDYNHEITGLR	1
TARS3	LRDEQLNSPYSCQAEGPCLTR	1
HIP1R	QEELGAMVDK	1
PIR	IEPHHTAVLGEGDSVQVENKNPK	1
TOR1A	ITHVALDFWR	1
KRT16	RVFQGLEIELQSQLSMK	1
POLR1B	IVMEEGCLTQK	1
GOLGA8N	NQTAEPLAPEPPAVPSEVELQHLR	1
ZCCHC4	YVSLENQHCEHCNSCTSK	1
STAT2	IEEIMPNGDPLLAGHNTVDEVYVSR	1
SEH1L	SESGNWHCTASWK,VWDKSESGNWHCTASWK	2
SPG11	SSVSEQFDHLSSHLYLR	1
GSTZ1	IDGITIHQSLAIIEYLEETRPTPR	1
DMAC1	PATPATPGAPTSPAEHR	1
LDAH	QVPELPVIR	1
NCAPD2	SIDPGLKEDTLEFLIK	1
GPC6	DESMTAGTSNEEECWNGHSK	1
ASPDH	RENPAEPGAVTGSATVTAFWR,ENPAEPGAVTGSATVTAFWR	2
FBXW8	AKEHMLQTNWK	1
FUCA2	VNGEAIYETYTWR	1
MYO7A	GDFPTDCVYVMPTVTMPPR	1
NDUFV3	LEAEGEAMEDAAAPGNDR	1
FLVCR1	AGTFPVNGPPRDSLAAASGVLGGPQTPLAPEEETQAR	1
GCAT	GILEGELEGICGAGTWK	1
KPRP	LRPEPSISLEPR	1
SCN5A	DLGSEADFADDENSTAGESESHR	1
AGL	HLSLGSVQLCGVGKFPSLPILSPALMDVSYR,FPSLPILSPALMDVSYR	2
NUP210	NPLLDLAAYDQEGR,FVCAPPSRLTLVPVYTSPQLDMSCPLLQQNK	2
ITIH3	EHLVQAMPENLQEAR,ILEDMKEEDYLNFILFSGDVSTWK	2
PON2	FEEGENSLLHLK,NTVEIFKFEEGENSLLHLK	2
IGHA1	SAVQGPPDR,SAVQGPPDRDLCGCYSVSSVLPGCAEPWNHGK	2
THEMIS2	WLDLTVVEAK	1
GDF15	ARNGDDCPLGPGR	1
CSRP1	TVYFAEEVQCEGDSFHK	1
TBC1D10A	AILDAEPGPRPALQPSPSIHLPLDAPLPGSK	1
PNP	HRPQVAIICGSGLGGLTDKLTQAQIFDYSEIPNFPR,LTQAQIFDYSEIPNFPR	2
DDX20	LQTEAQEDDWYDCHRETR	1
CPNE1	SDPLCILLQDVGGGSWAELGR	1
PARP9	SPAINLMGFNVEEMCEAHAWIQR	1
CFAP46	MSGDEAVNQGEASQTLK	1
SERPINA10	NLELGLSQGSFAFIHK	1
L3MBTL3	ADNKEDGEERDDEMENK	1
ATP5PO	SLNDITAR	1
ACAN	CQPSGHWEEPR	1
NIPSNAP3A	YDNFAHRTEVQK	1
PATJ	GPGSDSSLFATYNVELVR,VLGLSIVGK	2
COMMD3	GFQMLADPGSFDSNAFTLLLR	1
GGA2	NLLDLLSPQPAPCPLNYVSQK	1
AP3D1	LLESGDLSMSSVK	1
NAXD	AYSPELIVHPVLDSPNAVHEVEEWLPR	1
C17orf97	GFHPDPEALKGFHPNPEALK	1
SPRR1A	IPEPCQPK	1
KLK1	ILPNDECEK	1
SLC52A3	LREENDLGPAGMVDSSQGQGYLEEK	1
ANK1	EGQNVNMENLYTALQSIDR,EGQNVNMENLYTALQSIDRGEIVNMLEGSGR	2
DHX57	TTQIPQFILDDSLSGPPEK	1
GBA	VGLVASQKNNLDAVALMHPDGSAVVVVLNR	1
MMRN2	AEAEDTSKDPVGR	1
MAGEB10	DVSQSSLDGASNNPHGLQEAQSTSTSATAASHTR	1
HFM1	FQFAFPSDKYEQDDLNLEGVGNNDLSHVAGK	1
MGAT1	RVHLAPPPTWEGYDPSWN,VHLAPPPTWEGYDPSWN	2
AKR1B10	ACNVLQSSHLEDYPFDAEY	1
CRACD	RQEILEEEGEGQEPPLEAER	1
H1-2	SETAPAAPAAAPPAEKVPVKK	1
KARS1	KENVATTDTLESTTVGSSV	1
BNIP2	ASSGDIGSLDYQEFVVDIESR	1
PAK6	GSAVPVDGYISGLLNDIQK	1
COMT	MVDFAGMK,MVDFAGMKDK	2
TNRC6B	MVSALQQQQQQQR	1
PDLIM1	TAASGVEASSRPLDHAQPPSSLVIDK,TAASGVEASSRPLDHAQPPSSLVIDKESEVYK	2
SLC1A5	SELPLDPLPLPTEEGNPLLK	1
RDH5	VLASCLTPSGAEALQR	1
SERPINF1	SSMSPTTNVLLSPLSVATALSALSLGAEQRTESIIHR	1
DHCR24	LGCQDAFPEVYNKICK	1
ZNF598	VGSEKPGTTLPQPPPTTCPPGALQAPEAPASR	1
HIBCH	KGCAGVITLNRPK	1
ZC3HAV1	GYCNPGIQLCSVGSYTINFR	1
AHDC1	AASYGLTPATSDCR	1
MIA2	NLQTQQASLQSENTHFENENQKLQQK,NLQTQQASLQSENTHFENENQK	2
LPP	REPGYTPPGAGNQNPPGMHPVTGPK,EPGYTPPGAGNQNPPGMHPVTGPK	2
WARS2	KAVTDFTSEVTYDPPGR	1
CRB2	GCATQPCHHGALCVPQGPDPNGFR,AEAPGSPAVVLPGR	2
THUMPD1	NNQQVPDNTEELGQTK	1
ERAP1	QTWTDEGSVSEQMLR,TMMNTWTLQR	2
CAPSL	GLNDYAVVMEKEEVEELFQR,EEVEELFQR	2
IMPACT	SQMTEPGPEVK	1
EPB41L3	TESSGIETESTVHHLPLSTEK,METKTESSGIETEPTVHHLPLSTEKVVQETVLVQER,VVQETVLVQER,VVQETVLVQERR	4
RAB11FIP1	AELQTESLTPVPNSGSSVLGSLFK	1
SDF2L1	NLHTHHFPSPLSNNQEVSAFGEDGEGDNLDLWTVR	1
ERMP1	EAGAQEPLVDGCSGGGR	1
TNR	VVYSTLAGEQYHEVLVPK	1
SHROOM2	CLFDSLQPER	1
GIMAP6	KEDLAGSSLEDYVR	1
CD163	GFGHIWLDSVSCQGHEPAVWQCK,GPDMLWQCPSSPWEK	2
PTK2B	SLDPMVYMNDTSPLTPEK	1
NRP1	YPNSLECTYIVFAPK,SPGFPEKYPNSLECTYIVFAPK	2
PSG4	VSEGKNVLLLVHNLPQNLAGYIWYK	1
WDR18	HVWSHHTLPITDLHCGFGGPLAR	1
CALD1	EAEGAPQMEAGKR,EAEGAPQMEAGK	2
PRR16	VQANAPLIKPPAHTSAILTVLR	1
IGHV3OR16-13	EFGLSVFLVAILKGVQCEVQLEESGGGLVQPGGSLR	1
NAT10	TLHEVSLQESIR	1
RBP5	NMENYLQALNISLAVR,HWLEGELLYLELTAR	2
CALHM6	STEGDTVIPVLGFVDSSGIK	1
NPC1	SCATEEQYKGTER,DNGQAPFTITPVFSDFPVR	2
HSD17B7	LLELEEHIR	1
MCM3AP	GASAEELLAQCLSSSLR	1
PRCC	GPGLNLPPPIGGAGPPLGLSKPK	1
LMAN1	NSLSETVR	1
RIPK2	KQPFEDVTNPLQIMYSVSQGHRPVINEESLPYDTPHR	1
REXO1	TLAASGSQPSNGPEPGGQQLK	1
HEXD	LHVGCDEVYYLGEGEASRR	1
ABAT	GFSQEELETCMINQAPGCPDYSILSFTGAFHGR	1
MEP1A	FYNSEGYGFGLTLYPNSR,QVIITILDQEPDVQNR	2
ZG16	SSSYSGEYGSGGGK,SGSLIDAIGLHWDVYPTSCSR	2
HNF4G	SMIYKDILLLGNNYVIHR	1
GNPTAB	NIFLVTNGQIPSWLNLDNPR	1
CD5	LSAYPALEGVLHR	1
CYP8B1	QGISNWLGNMLQFLR	1
EPRS1	LKTEKAPQDQVDIAVQELLQLK	1
IBA57	LLTQDEGPALVPGSR	1
APOA4	TQVNTQAEQLRR,TQVNTQAEQLR	2
NAT9	LTASEPLTLEQEYAMQR	1
PITPNM3	LDEHQGEGTTPCTSSILQEK	1
FUT2	ENIDTSHSDVVFAGDGIEGSPAK,QEILQEFTLHNHVR	2
CRACR2B	HDLQGLQSDLPLTPEQLEAVFESLDQAHTGFLTAR	1
PTGS1	ALGHGVDLGHIYGDNMER	1
NTN4	ALSPPHDTENPYSAK	1
RNH1	ELTVSNNDINEAGVHVLCQGLK	1
COL12A1	SQDNVEAPSKK,IGVLITDGKSQDNVEAPSKK	2
MRPL37	VFHFLVFQLNTTDLDSNEGVK,MILFAFGSAVAQAR	2
MBD1	LLPSVWSESEDGAGSPAPYR	1
SEC16A	QSGPGAPNLDCFYQQVTK	1
OPA1	ALPNSEDLVK,KALPNSEDLVK	2
ABHD10	DDVVPWHTSMQVADR,LLHGMKDDVVPWHTSMQVADR	2
ATP6V0A2	CLIAEVWCPEADLQDLHR	1
TLN1	LLSDLLPPSTGTFQEAQSR,RLLSDLLPPSTGTFQEAQSR	2
COL10A1	YQTPTGIK	1
OGDH	LLDTAFDLDIFK	1
PRSS2	ITNNMFCVGFLER	1
MT1X	MDPNCSCSPVGSCACAGSCKCKQCK	1
SYNE3	ANLQEEEGSHEDFSQLLR	1
CPAMD8	KLCAGPACNEVER	1
APOL2	AQACNLDQSGTNVAK	1
CPN2	LTMSIEAR	1
C6orf47	RMDSLNWDQPISSTQESGR	1
ADPGK	APQEFMTSHLEAGSR	1
IVL	QLELPEQQEGQLK	1
CTU2	LFSVPSVFTPAIDTK,LFSVPSVFTPAIDTKAPEK	2
PRKCSH	SEALPTDLPTPSAPDLTEPK	1
FASN	CVLLSNLSSTSHIPEVDPGSAELQK	1
NDUFS2	MAPGEIKVDDAK	1
MYO15B	QIMGTYLVR	1
VWA5A	LIIYAQLTGK	1
RAI1	LSYDQQQQQQQQQQALQSR	1
EPHX2	GGPEGATTWLMK	1
CCDC154	RPGGVPEKPHSR	1
APLP2	GSGVGEQNGGLIGAEEK	1
DOCK9	FTWALSKPGTAAELR	1
HMCN1	NSVSLTCEASGIPLPSTTWFK	1
PZP	GEESYCICGSER	1
TASOR2	NAHVPIQTEGVNTADEPTTFKK	1
ARHGEF40	IQQHLGEEASPR,RIQQHLGEEASPR,LENGLAALSPSSK,HKLENGLAALSPSSK	4
IGLV3-25	ITCSADALPK	1
FHIT	FHDLRPDEVANLFQTTQR	1
DDX60	HGDVHFDHFHPCAALTTDHIER	1
IGLV3-16	KYAYWYQQKPGQAPVLVIYK	1
NSUN2	AGEPNSPDAEEANSPDVTAGCDQAGVHPPR	1
RSPH1	KPTSTDGPGQDAPGAESAGEPR	1
CGN	TEEELKELQAER,TEEELKELQAEQQSQEVAGR	2
DCC	VVVLPSGALQISGLQPGDIGIYR	1
srpk1a	LCFVALDFEQEMATVASSSSLEK	1
WDR4	SQENKGEDAPLDQGSGAILASTFSNSGSYFALTDDSKR	1
CELSR1	FDAIHEEFPR	1
TRAPPC10	YLPHHSAHSSQLDADSWIENDSLSVDKHGDNQPDSSSLK,RQESSSSLEMPSGVALEEGAHMLR	2
PSMD9	QSGGSSQAGAVTVSDVQELMR	1
SRRM2	SSTGPEPPAPTLLLAER	1
CEP85	ETEFSSAGHSLQDK	1
IGLC7	ATLVCLVSDFYPGAVTVAWK	1
BAZ2B	INENIAAASSTLFSSPVNLSTSGR	1
GPRIN1	ADPVPLESMDSASTGK,ADPVPLESMDSASTGKTEPGLLGK	2
FGL1	QLLQENEVQFLDKGDENTVVDLGSKR,QLLQENEVQFLDKGDENTVVDLGSK,IKQLLQENEVQFLDKGDENTVVDLGSK	3
PSG5	DRDGGMHSDPVTLNVLYGPDLPSIYPSFTYYR,DRDGGMHSDPVSLNVLYGPDLPSIYPSFTYYR	2
RSPH3	GSTYALQTGPLLGQPDSLELQR,ELLLDGDYLQR	2
KCTD3	AGGHCGSVPAAAAGSGEIVQLNVGGTR	1
JMJD1C	IHEDEVDDMEEN	1
ANO10	VTLSALDTSESSFTPLVVIELAQDVKEQTK	1
PLD2	TPIYPYLLPK	1
TRIM9	GATIGVLLDFNRK	1
SCN7A	THNEDHEEEDLKPNPDLEVGK	1
CEP131	ANNAGGGLPAAGPGDR	1
IGHV3-13	GLEWVSAIGTAGDTYYPGSVK	1
CMC2	KCLKNEYIENR,CLKNEYIENR	2
ENPP2	VNSMQTVFVGYGPTFK	1
ERCC6	SDPLKDDPHVSSNVTSNDR	1
RSPH9	NYGYIYVGTGEK	1
ILVBL	RPLMVLGSQALLTPTSANK	1
COL5A1	FGGGSDAGSKGPMVSAQESQAQAILQQAR,TVLEINTPKVEQVPIVDIMFNDFGEASQK	2
OTULIN	YNTEEFITVYPTDPPKNWPVVTLIAEDDR	1
RIBC2	GDLLSENPQQAASSLGPHR	1
PLCD1	EEAAGPALALSLIEHYEPSETAK,TFAEAAGSGETLSVNQLVTFLQHQQR	2
GOLGB1	DDCNRLQEQFDEQSKENENIGDQLR	1
TSKU	ESAARGPTIL	1
SLC4A1	VYVELQELVMDEKNQDLR	1
AARS2	TLSVCISDGVFPGMSGPPLVLR	1
ODR4	GNTQATSHCFDVR	1
FN1	GATYNIIVEALKDQQR,GATYNIIVEALK	2
USP24	NTFQLLHEILVIEDPIQAER	1
MTRR	GQEEISGALPVASPASLR	1
GBP2	TLSGGIAVNGPR	1
SMG1	IKEQTVPITSHLMELGLTAAK	1
CRELD2	EHGQCADVDECALAEK	1
NLRP6	LLIAPESAAPEEALGPAEEPEPGR	1
TRARG1	TLSGPLDLEQNGQGLPFK	1
PREP	SNFLVVCYLHDVK	1
COQ8B	VGQMLSIQDNSFISPQLQR,GAALKVGQMLSIQDNSFISPQLQR	2
ARHGEF10L	EPAPADGAALEHSEEDGSIYEMADDPDVWVR	1
SRA1	SPPVGSGPASGVEPTSFPVESEAR	1
RAB11FIP5	AAEPQGEPGGGGGGGGGGR,AAEPQGEPGGGGGGGGGGRGGSSVWLEPR	2
AOC1	SSFGLQVLNVHFGGER	1
TBL3	ALLPKNTAPDNGPILLQAQTTQR	1
FNDC1	APEQQPPPPVATSQHHPGPQSR	1
INTU	ESQGSDGFEESGTLLK	1
TMEM214	HLSQSSLLLEHLLSSWQQIPK	1
INPP5D	DNTELPYHGK	1
IRAK2	DLLLSEIPSSTASLCSR	1
LDB3	ASGVGLPGGANYQER	1
DMRT2	CGPISDTLLYQQCLLNATTSVQALKPGASWDLKGPR	1
ADHFE1	LAPRPQSEEDLAALFEASMK	1
SERPINB8	DGDIHQGFQSLLSEVNR	1
RAD18	SAAEIVQEIENIEK	1
CPVL	QVGDFHQVIIR	1
DYSF	KVPSRPPPHYPGIK	1
PYGL	WIDTQVILALPYDTPVPGYMNNTVNTMR	1
LYPLAL1	ILIGGFSMGGCMAMHLAYR	1
FAT1	KPIEEKPSQPYSAR	1
AGRN	SGCTPCSCDPR,RAPVCGDDGVTYENDCVMGR	2
DMAC2	LGAAVAPEGSQK	1
SHROOM3	GQEEMLLLFHHLTPR	1
TEFM	QFLFDSLLK	1
ALDH18A1	LIDIFYPGDQQSVTFGIK	1
PRRC2A	GSEGKPSLTLPASAPAPEEALTTVTVAPAPR	1
SELENBP1	GGPVQVLEDK	1
SI	TLFDTSIGPLVYSDQYLQISAR	1
GFM1	GIIDLIEER	1
CLIP2	YSLIDPSSAPELLR	1
IGHD	EVNTSGFAPARPPPQPGSTTFWAWSVLR	1
NLRP2	VEGFLEEDKR	1
GPATCH2	IQNEGVVLESEETNQTNK	1
FNIP1	ELLGISDECR	1
MAP9	QAIDEYEK	1
TBCK	VDIPPLIR	1
EPB41L5	SIIMCRVSLLDGTDVSVDLPK	1
NEK1	EANHSEGQEGSEETDMR	1
MEDAG	LQPGAFQLSGDQLVVAGPGEPAAAR	1
HMGN1	VSSTEGAAKEEPK	1
HERPUD1	VYPERPHPEDQR	1
PARVB	NAINSPMSPALADVHPEDTQLEENEER	1
ACAD9	DSLGQTVDLGLTGNHGVVHPSLADSANKFEENTYCFGR	1
CAPN7	TSYETTDKVLQNK	1
NT5C	DKTVVLGDLLIDNKDTVR	1
SART3	AGPKAEGEEDEVK	1
GIPC1	SAGGRPGSGPQLGSGR	1
MICALL1	VEQMPQASPGLALR	1
GSN	AGALNSNDAFVLKTPSAAYLWVGTGASEAEKMGAQELLR	1
PECAM1	TTAEYQLLVEGVPSPR	1
ZBED3	EAAVEQGERALER	1
TRAF3IP2	VILNYPSPWDQEERPAQR	1
GRHL2	AENFTPVFMAPPVHYPR	1
PPP6R1	ELPSEQQEQWEAFVAGPLAETNKK	1
KIAA0040	ISAFFSSVWDTILTK	1
PAM16	LDEELKIQAKEDR	1
GTPBP10	GKDWEIPVPVGISVTDENGK	1
DSG2	DMAGAQAAAVALNEEFLK	1
PSME2	EVPKCGFLPGNEK	1
EFL1	LAAAQGQAPLEPTQDGSAIETCPKGDEPR	1
WASHC4	LGITPEGQSYLDQFR,KLGITPEGQSYLDQFR	2
CRTC1	PAGISPLSLSTEAR	1
STOM	NSTIVFPLPIDTLQGIIGAK	1
IGHV5-51	ASDTAMYYCVR	1
CAVIN2	VLIFQEENEIPASVFVKEPVSGAVEGK	1
BCHE	VLEMTGNIDETEWEWK	1
IQCG	QFFSHVIADTIK	1
CNTN5	GQPIDFEEQGGHFESIR	1
STON1	ACLGSLHELESEPVIQVTVGSAK	1
LMOD1	QMPSGPTKPSEGPAK	1
RGMA	AAAGLPLVPR	1
PLA2G4F	GIPFPSIEVGPEDVEEAR	1
PGGHG	VSIACLAPGSGPITLLLR	1
COL1A2	GHNGLQGLPGIAGHHGDQGAPGSMGPAGPR	1
TUBGCP2	ERAELAATAVGSSTTSINVPAAASK	1
ABI3	LSAASSASSLASAGSAEGVGGAPTPK	1
AFM	ETLLNHFLYEVAR	1
SPECC1	LIYLEHSPNSEGAASHTGDSR,CPTSITQESSFGSPTGNQLSSDIDEYKK	2
NUDT6	SVLSIQQQHTNPGAFGK,FIAPAASLGFR	2
ACTN4	MAPYQGPEAVPGALDYK	1
TMEM263	NQQEIPSYLNNEPPEGSMK	1
POLE4	EEEVPAGEAAASQPQAPTSVPGAR	1
IGHV2-26	ALEWLAHISSNDEK	1
MCUR1	MQQEIAFQQVMSQIANVK	1
EXD2	ALLNAESLPTHR	1
EIF3J	ETFGVNNTVYGIDAMNPSSR	1
COPE	APPAPGPASGGCGEVDELFDVK	1
DGAT1	ASSAAAPHTVSYPDNLNYR	1
CEMIP2	SAGVLLLVVDPCNVPFR	1
CENPC	TISPAESTALFQGR	1
LSP1	QQHEGAQGTLDSGEPPQCR,QQHEGAQGALDSGEPPLCR	2
SERPINB5	GVALSNVVHK	1
CHST3	LSAELGLQQPAWLR	1
HAUS3	EFYVYFLKDEDYLKDTVENLETQSK	1
TOPBP1	GYMLSEEPYIHANYQPVEIPVSHQPESK	1
SUMF2	FLMGTNSPDSRDGEGPVR	1
ANO1	ACPDSLGSPAPSHAYHR	1
KRT23	TFQALEIDLQAQYSTK	1
H4C6	RLSGLIYEETR	1
CUX1	LEQDLSIIQSIQRPDAEGATEHR	1
TACC3	ALNSASTSLPTSCPGSEPVPTHQQEQPALELK	1
PMS2	EAVSSSQGPSDPTDR	1
KDM5A	AQEAMTDETPDSSK	1
HPD	QAASFYCSK	1
ASS1	NPWSMDENLMHISYETGILENPK	1
CFAP52	ETLIATCHFDAVK	1
HLTF	CSQQPSISDIKEK	1
CSMD1	LAFEEFQLER	1
METTL7B	FVVAHGEDMR	1
DNAH5	SKLPAAIEQLIVPHLAK	1
ARHGAP25	NSGEEEIDSLQSMVQELR	1
BCL2L13	LQEQHLSSPQGVQLDR	1
AHR	NLGIDFEDIK	1
LOXL4	TLSDCPALEGSQNGCQHENAAAVR	1
MTRF1L	LLNEKEQELR	1
NAA25	GLETHIIALK	1
LAD1	NLPSLAEQGASDPPTVASR	1
ACSBG1	CTLDPDTSDQTDNLTEQAVEFCQR	1
CFAP410	ELDAEGLEAVR	1
GLI4	IHTGEKPYECADCGK	1
ALAD	YGVNRLEEMLRPLVEEGLR	1
PGM3	VISTTNAER	1
UGT2A2	AFITHGGTNGIYEAIYHGVPMVGIPIFADQPDNIAHMK	1
UGT2A1	AFITHGGTNGIYEAIYHGVPMVGIPIFADQPDNIAHMK	1
FARSB	FELTMPCSSLEINIGPFL	1
HMGXB4	VSGSSGELPLEDGVSHK	1
QRSL1	DSTTVHEPISKPFMLPSLADVSK	1
RAB35	ENINVEEMFNCITELVLR	1
SLC27A3	ALAAAAADPEGPEAGCSLAWR	1
RAB6C	DSAAAVVVYDITDVNSFQQTTK	1
NUGGC	DVFGQEPHPVEDDLYKEPTR	1
IGHV3-43	NSLYLQMNSLRTEDTTLYYCAK	1
DLG1	VNDCILQVNEVDVR	1
NANS	ALDRPYTSK	1
GPR158	KEEVWDSFKV	1
ORM2	EQLGEFYEALNCLCIPR	1
NAAA	NLDYPFGNILR	1
CEL	LGAVYTEGGFVEGINK	1
SLC25A15	TFLNVVKNEGITALYSGLKPTMIR	1
CHCHD6	YEQEHSAIQDK	1
ACOT11	DLLANCAIQDDLESR	1
LAMA1	ISDISVEVGR	1
NT5C3B	NSSVCENCGYFQQLEGK	1
LXN	QASMEDIPGRGHKYR	1
RAB3IL1	ESPGALVETSAGEEAR	1
APOH	EHSSLAFSK	1
PARP14	SEDVQSIEVQVK	1
ZSCAN18	RPHPEDGDEQSLEGVSSSGDSAGLEAGQGPGADEPGLSR	1
YY1AP1	AENNLLALGLK	1
HYKK	ECINHGDLNNHNILIESSK	1
C6	SVLRPSQFGGQPCTEPLVAFQPCIPSK	1
USE1	QSAAELDLVLQR	1
NFU1	TMDFPTPAAAFCSPLAR	1
WDR55	FELLSEPQFGDLTSVTLMK	1
IKBIP	FLSLESDR	1
ALOX12	LVLPSGMEELR	1
LRWD1	QPPLLLAALQAPTQILK	1
EIF2S3	SCGSSTPDEFPTDIPGTKGNFR	1
PIKFYVE	NSDPFAHSKDASSTSSGK	1
DNAAF5	LFSILSTALLR	1
LENG9	LDPAYFSVGYVDR	1
PDLIM2	SRPPGCYTCADCGLNLK	1
FGGY	AALVDQSGVLLAFADQPIKK	1
SNX30	TRPLEFAAMGDYLDTFALK	1
GLB1	TTLPQDCSNPAPLSSPFNGVHDR	1
PI16	AQVSPPASDMLHMR	1
MFGE8	CVEPLGMENGNIANSQIAASSVR	1
CASR	NAMAHGNSTHQNSLEAQK	1
GHRL	LSGVLYQQHSQALGK	1
TNN	NTEDSLLVSWEPSSQVNHYLLSYYPLGK	1
MUC3A	HLLHLLLSPLEVR	1
ZFR	LQSTGNKAEDTKGTECVK	1
IGKV3OR2-268	FSGSGSGTDFTLTISSLK	1
IGHV3-23	DNSQNTVFLQMNSLR	1
CARD10	GDCSVRDPEDTAMPGR	1
IFIH1	ADESTYVLVAHSGSGVIER	1
LAMB3	SFSGLLTMYQR	1
XYLB	ASGFEFSQVLALSGAGQQHGSIYWK	1
CPT1A	AGNTIHAILLYR	1
NTS	MTLLNVCSIVNNLNSPAEETGEVHEEELVAR	1
CHD4	KEEEEEDDDDDDSKEPK	1
ALDH7A1	FQNEEEVFAWNNEVK	1
UCHL1	MQLKPMEINPEMLNKVLYR	1
CHL1	THPVEVFEPGAEHIVR	1
CCL14	IMDYYETNSQCSEPGIVFITK	1
CROCC	QALLQAQLEEQLQDK	1
MAGEA10	AEILESVIK	1
CLCN2	NLGESPTGSADSAGIALR	1
CDKN1B	VPAQESQDGSGSRPAAPLIGAPANSEDTHLVDPK	1
GALNT4	FNSVTELCAEIPEQK	1
HCFC1	ISVATGALEAAQGSKPQCQTR	1
ASNS	DEPLHALYDNVEK	1
C16orf89	QQEGCFGEPDAEDEESSK	1
PPTC7	AGGGGGDYGLVTAGCGFGK	1
TBC1D12	GVGAGGPEEGAPPATSAQR	1
UTP14A	ASSEGTIPQAQR	1
MUC17	SSPTTSEGTSMPTSTPSEGSTR	1
DHX37	TPLEDYSGECFQK	1
MYO1A	VLEELSMSSGELAFGK	1
MRPL53	NFLQTVSSEK	1
GGT5	VNVYHHLVETLKFAR	1
ENPP3	HLANTDVPIPTHYFVVLTNCK	1
UQCRC1	HLGGIPWTYAEDAVPTLTPCHFTGSEIR	1
POLRMT	QYWEALGAPEALR	1
TRIP10	HARPPDSPASAPPDSSSNSASQDTK	1
GEMIN5	SSSSYHTWNTGTEGSFVER	1
PNPLA7	QVFYGEEEQLK	1
IRF2BPL	YGLSAAAAAAAAAAAVEQR	1
ARMT1	CGTDWEEYIK	1
UGT2B10	GHEVTVLASSASILFDPNYSSTLK	1
ZNF22	SFGQSSTLFQHQK	1
HOMER3	AAQLLDVR	1
DHTKD1	HAMVVCQETDDTYIPLNHMDPNQK	1
ITGA8	KMPYTDQPAKLPEGSIAIK	1
ZNF267	SHTGERPYECEECGK	1
PSG7	DLYHYVTSYVVDGQIIK	1
FHL5	DDYPFCMDCYNHLYANK	1
MPC2	LLNKVELMLPEK	1
