gene_symbol	peptides	Count
FLG	PRGSSVSQDSDSQGHSEDSER,NHLGSAWEESRDGSRHPGSHQEDR,HSVSQEGQDTIR,SGSFLYQVSTHEQSESTHGQSVPSTGGR,NHLGSAWEESRDGSR,HSAYQDGQDTIR,QGSSVSQDSDSQGHSEDSERR,QGYHHEQSVDR,HHEASSWADSSRHSQAVQGQSEGSR,SSAGDRHGSHHQQSADSSR,TSRPRGSSVSQDSDSQGHSEDSER,HSGTGQGQASSAVR,GSSGSQASDSEGHSEDSDTQSVSAHGQAGPHQQSHQQSTR,HSQSGQGQSAGPSTSRNQGSSVSQDSDSQGHSEDSER,CQGSSVSQDSDSQGHSEDSERR,WSGSASRNHHGSAGEQSR,NWGSSFSQDSDSEGHSEDSER,RPGSSVSQDSDSEGHSEDSER,AGLRQQSHQESAR,HSAYQDGQDTIRGHPGSSR,SGHSGYHHSHTIPQGR,GYSGSQATDSEGHSEDSDTQSVSAQGK,SSAGERHGSHHQLQSAESSR,ADSSRHSQVGQGQSEGPR,HQLQSADSSRHSGTGQGQASSAVR,DSGHRGSSGSQATDSEGHSK,RQGSSVSQDSDSQGHSEDSERR,HAGIGHGQASSAVRDSGHR,HHEASSWANSSR,HAGIGHGQASSAVR,SGSSLYQVSTHEQSDSAHGR,HSQSGQGQSAGPSTSR,EHGHFSSLPQDSAYHSGIQSR,SGSFLYQMSTHEQSESAHGR,AGLRQQSHQESARGR,HSVSQEGQDTIRGHPGSSR,NHHGSAGEQSRDGSRHPGSHQEDR,CQGSSVSQDSDSQGHSEDSER,HGSHHQQSANSSR,NHLGSAWEESR,HGSHHQQSADSSTDSGTGCR,HTQTSSSGQAASSHEQARSSAGER,GSSGTQASDSEGHSEDSDTQSVSAHGQAGPHQQSHQQSTR,HTQTSSGGQAASSHEQARSSAGDR,GSSVSQDSDSQGHSEDSERR,TSRNWGSSFSQDSDSEGHSEDSER,HSGIGHGQASSSVR,RQGSSVSQDSDSQGHSEDSER,HGSHHQLQSAESSR,HSASQEGQDTIRAHPGSSR	50
AHNAK2	VEANVSLPSMQGDLK,FSFAAPSSEDDVFIPTVR,SVEDSMDVSAPK,VDLKGPQLDVK,LDGAQLQGDLSLADK,AKLDSAQLEGDLSLANK,AEADVSLPSMQGDLR,LEGDLSLANKDVTAKDSK,SIKASVDVSPPKVEADMSLPSMQGDLK,AEVTAPDVEVSLPSVEVDIEAPGAK,LPEGHLPEVAGLK,MLSFGVSAPGK,MPSFGVLAPGK,ATDLSIQPPSTDLK,VEVRVPDVEVSLPSVEVDVQAR,AKLDSAHLQGDLTLANKDVTTK,VDIKGPQVDIK,LSEGPVPEGAGLK,SIQASVDVSALK,SVEDSVDVSAPK,GCGLEDVPVSQPCGEGIAPTPEDPLQPSCR,AKLDSAQLEGDLSLANKDVTAK,AGTGLKGEEVEGAGWMPGREPTTHAEAQGNEGDGEEGLQR,LEGDLSLANKDVTAK,MSLSSVEVDVQAPR,LLEGPLPEGASLK,DSQESWFK,TTDLSIPLPSADLVVQAGQVDMK,LDSARLEGDLSLADK,AKLDGAQLQGDLSLADK,SIEAMVDVSAPK,TTDLSIQLPSADLEVQAGQVDVK,TSAFPIVESVVHEGDLHDPSR,VDIKGPQVDVK,LDSAQLEGDLSLANK,AKLDGAQLQGDLSLADKAVTAK,SIAASVDVSAPK,GEEVEGAGWMPGREPTTHAEAQGNEGDGEEGLQR,VDHKGPQIDIK,SIEASVDVSPPKVEADVSLPSMQGDLK,TTHLSIQSPSADLEVQAGQVNVK,AEVTAHEVAVSLPSVEVDIQAPGAK,LDSAQLEGDLSLANKDVTAK,EPTTHAEAQGNEGDGEEGLQR,LLEGPVSEGAGLK	45
TTN	GRPMPEITWSR,FCAMISGRPQPK,LEADVHGKPLPTTEWLR,LLQGKDYIFR,NAYSLEIR,EFMEVEEGTDVNIVAK,CDVNVGEWTMCTPPTGINK,VPNLEEGK,LYVEPAAPLGAPTYIPTLEPVTR,VDGTPEIGISWYK,DHENLQTSFVDNVATLK,VTGHPKPIIK,TSFRVPNLEEGK,LYVEPAAPLGALTYIPTLEPVSR,VLDSPSAPVNLTVR,EAPPAKVPEVQKR,IDGYIISYREEEQPADRWTEYSVVK,GRPMPEITWSREEGEFTDK,LEADVHGKPLPTTEWLRGDK,NAAHEDGGIYSLTVENLAGSK,DGGSPITGYLVEYQEKGTQDWIK,SPEPSHLK,VEPASAGK,VIGYHLECK,FVVTITVHPEPHVTWYK,TSFRVPNLEEGKSYFFR,DGMTLTWYPPEDDGGSQVTGYIVEHK,MAVDISESEAVESGFDLR,DAAYPPGPPSNLHVTDTTKK,IASPHFTVSK,TTATFTAK,LYVEPAAPPGAPTYIPTLEPVSR,IDGYIISYR,PLPTTEWLR,MSGYPIPK,DAAYPPGPPSNLHVTDTTK,ASFTNVTETQFTISGLTQNSQYEFR,VLDTPGPPINVTVK,QGTDLASR,IDGYIISYREEEQPADR,GFCQVNVVDHPGPPVGPVSFDEVTK	41
EPPK1	RDELLAQHAAGALGLPNLVAVLTR,AEAEAGSPRPEPR,AVPVWDVLVSGYVSGAAR,LAAELSATLEQAAATAR,STTQELMEDDCVKR,EGQGEGETQEATAAAR,GFFDPNTHENLTYVQLLQR,GMLQPGTALVLLEAQAATGFVIDPVR,SQREGQGEGETQEAAAAAAAAR,VPVDVACR,FLNPNTLER,EGQGEGETQEAAAAAAAAAR,EGQGEGETQEAAAAAAR,QVVSAVTALVEAAER,CRPQEDTGWVLFPVNK,AGTLTVEELGATLTSLLAQAQAR,EELLAEFGSGTLDLPVLTR,VIAETEER,EELLAESGSGTLDLPALTR,RLTAIIEEAEEAPGARPQLQDTWR,EGQGEGETQEAAAATR,DAHVTPGSGALQGQSVSVWELLFYR,DELLAQHAAGALGLPNLVAVLTR,EGQGEGETQEAAAAAAAAR,MSIYQAMWKGMLQPGTALVLLEAQAATGFVIDPVR,LTAIIEEAEEAPGARPQLQDTWR,EGQGEGETQEAAAAAAAR,LTAIIEEAEEAPGAWPQLQDAWR	28
CHGB	GEAGAPGEEDIQGPTNADTEK,GYPGVQGPEDLEWER,DPADATEAHESSSR,GQPQSQEESEEGEEDATSEVDK,GEQGEDSSEEK,SSQESGEEAGSQENHPQESK,DPADATEAHESSSRGEAGAPGEEDIQGPTKADTEK,LLRDPADATEAHESSSR,EKSSQESGEEAGSQENHPQESKGQPR,EDEEEEEGENYQKGEQGEDSSEEK,GEQGEDSSEEKHLEEPGETQNAFLNER,MAHGYGEESEEERGLELGK,DPADATEAHESSSRGEAGAPGEEDIQGPTK,GYPGVQGPEDLEWERYR,ERADEPQWSLYPSNSQVSEEVK,GEQGEDSSEEKHLEEPGETQNAFLNERK,ADEPQWSLYPSNSQVSEEVKTR,ADEPQWSLYPSNSQVSEEVK,ERADEPQWSLYPSNSQVSEEVKTR,ASEEEPEYGEEIKGYPGVQGPEDLEWER,DPADASEAHESSSRGEAGAPGEEDIQGPTNADTEK,LLRDPADASEAHESSSRGEAGAPGEEDIQGPTNADTEK,EKSSQESGEEAGSQENHPQESK,HLEEPGETQNAFLHER,DHHSTHYRASEEEPEYGEEIKGYPGVQGPEDLEWER,LLRDPADATEAHESSSRGEAGAPGEEDIQGPTK	26
PLEC	KVPAQRLQEAGILSAEELQR,QQALQALEELR,TRYSELTTLTSQYIK,EQLQQEQALLEEIER,EQLQQEQALLEEIERHGEK,MLLQGSGCLAGIYLEDTK,HGYFDEEMNR,LQAEEKAHAFVVQQK,QEQIQAMPLADSQAVREQLQQEQALLEEIER,GANVIAGVWLEEVGQK,VQSGSESVIQEYVDLRTR,LAQGHTTVDELAWR,AGVAAPATQVVQVTLQSVQR,EQLQQEQALLEEIERHGEKVEECQR,SQVMDEAMALQLR,FLEVQYLTGGLIEPDMPGRVPLDEALQR,AHAFVVQQKEQELQQTLQQEQSVLDQLRGEAEAAR,GANIIAGVWLEEAGQK,FLEVQYLTGGLIEPDMPGR,LKAGVAAPATQVVQVTLQSVQR,AHAFVVQQK,LQEAGILSAEELQQLAQGHTTVDELAR,VQAEREAVQSR	23
PLIN4	NTLGSGVTGAANVAK,DTVCSGVTSAANVAK,NTFGSGVTGAVNVAK,GLATDVATFTQGAAPGREDTGLLTTTHGPEEAPR,TTQNIATGTKNTLGSGVTGAANVAK,DTVCSGVTSAMNVAK,TTQNIATGTKNTFGSGVTGAANVAK,TVLTGTKDIVCSGVTGAANVAK,GAMQTGLNTTQNIATGTKDAVCSGVTGAMNLAR,EDTGLLTTTHGPEEAPR,TTQNIATGTKNTFGSGVTGAVNVAK,DAVCSGVTGAMNLAR,EAVSSGVTGAMDMAK,TVLTGTKDTVCSGVTGAAK,DTVCSGVTGAAK,NTFGSGVTGAANVAK,TVLTGTKDTVCSGVTSAMNVAK,TVLTGTKDTVCSGVTGAVNLAK,DTVCSGVTGAVNLAR,DTVYSGVTSAVNVAK,SVLTGTKDTVSTGLTGAVNLAK,DTVCSGVTGAVNLAK,DTVSTGLTGAVNLAK	23
MUC5AC	GCPVTSASVTAPSTPSGR,TTTAPGTATSVK,WFDVDFPSPGPQGGDKETYNNIIR,CPKPVGCPEGAR,SHPEVSIEHLGQVVQCSHEEGLVCR,TSTNHVSVSK,EEGLVCQNQDQQGPFK,AESHPEVSIEHLGQVVQCSREEGLVCQNQDQQGPFK,DVWGLEGCYPK,TTSAPTTSTTSVPTTSTISGPK,MDDPTEQCQDPVPEPPR,TSAATSSTTSSSGTTPSPVTTTSTASVSK,VPTASTTFAPTTR,TCGLCGDFNGMPVVR,SSTPSTTSAPTTSTTSFHTTSTTSPPTSSTSSTPQTSK,WFDVDFPSPGPQGGDK,SSTTSAVTTSTTSGPETTPR,ICHRPEEITR,GPSGFPLRGATVFPSLR,AISPTQSTSSWQK,AKSHPEVSIEHLGQVVQCSHEEGLVCR	21
AHNAK	ISVPDLDLNLKGPK,ADLDVSGPKVDVDIPDVNIEGPDAK,VDIDTPDINIEGPEGK,VDVEYPDVNIEGPEGK,GPKVDIDTPDINIEGPEGK,AEDPEVDVNLPK,EKEEETTRELLLPNWQGSGSHGLTIAQR,GPTVGGGLPGTGVQGLEGNLQMPGIK,VKGDMDVSLPKVEGDMQVPDVDIK,LEGPDVSLKVPGVDLPSVNLSMPK,VKGDVDVSLPKVEGDVK,GDVDVSLPKVEGDVK,GPKVDIDAPDVDVHGTDWHLK,FSMPGFKGEGPDVDVKLPK,VDIDAPDVDVHGTDWHLK,ADIDVSGPKVDVEYPDVNIEGPEGK,GPKVDIDVPDVGVQGPDWHLK,GPEVDIRGPK,VEGDMQVPDVDIKGPK,VEGDLKGPEVDIRGPK	20
RRBP1	KAEGAQNQGR,LHSLTQAKEESEK,KAEGAPNQGK,AEGAQNQDKKAEGAQNQGR,QKLTAEFEEAQTSACLLQEELEK,EKLHSLTQAKEESEK,LTAEFEEAQTSACLLQEELEKLR,LKGELESSDQVREHTLHLEAELEK,KAEGAQNQDK,EHTLHLEAELEKHMAAASAECQNYAK,LTAEFEEAQTSACLLQEELEK,AEGAPNQGK,AEGAQNQDK,LHSLTQAK,EKLHSLTQAK,QKLTAEFEEAQTSACLLQEELEKLR,AEGAQNQGR,EHTLHLEAELEK,AEGAQNQGRK	19
HSPG2	CESCAPGYEGNPIQPSGK,SPLPWQYR,ATFSSVPLVASISAVSLEVAQPGPSNRPR,CSATGSPVPTIHWSK,CVSTNMCIPASFHCDEESDCPDRSDEFGCMPPKVVTPPR,GMLEPVQRPDVVLVGAGYR,LENNMLMLPSVQPQDAGTYVCTATNR,AAGGPGPEQEASFTVTVPPSEGSSYR,RCESCAPGYEGNPIQPSGK,TYGLMDSHTVLQISSAK,GSIYIGGAPDVATLTGGR,LRSPLPWQYR,LPQVSPADSGEYMCR,SDEFGCMPPKVVTPPR,TYGLMDSHTVLQISSAKPSDAGTYVCLAQNALGTAQK,GNVYIGGAPDVATLTGGR,YELARGMLEPVQRPDVVLVGAGYR,ASYAQQPTESR,LENNMLMLPSVRPQDAGTYICTATNR	19
HLA-B	GHNQLAYDGK,GHNQFAYDGKDYIALNEDLSSWTAADTAAQITQR,EEPRAPWIEQEGPEYWDRNTQICK,GHNQLAYDGKDYIALNEDLSSWTAADTAAQITQR,APWIEQEGPEYWDRNTQICK,GYNQFAYDGKDYIALNEDLSSWTAADTAAQITQR,YFHTAMSRPGR,MSGCDVGPDGR,ASAQTYRENLR,AQTDREDLRTLLR,FLRGHNQYAYDGKDYIALNEDLSSWTAADTAAQITQR,ADPPKTHVTHHPVSDHEATLR,GYNQLAYDGKDYIALNEDLSSWTAADTAAQITQR,FDSDAASPRTEPRAPWIEQEGPEYWDGETR,GYHQDAYDGK,GYNQLAYDGK,YFHTAMSR,LLRGYNQFAYDGKDYIALNEDLSSWTAADTAAQITQR	18
SYNE2	VLNGNPQQEDGGLAGVTEQQSGAFDRWEMIQAQELHNK,QEMECCLNNILK,EKQATSDVQESTQESATVEK,GTEEPGEK,QATSDVQESTQESATVEK,IQILNNWMEAQEER,DKVPSLTTYEGGDLNNTLEDLR,LLEHVTQEQNELLK,LENHVNDLK,EFVSFSDKPVDQIVVEEK,FQQLANISMSGNNLAEILPPALQDIKELQHNVQK,QQSVESLAEEVKDKVPSLTTYEGGDLNNTLEDLR,LNAEESDKLYK,TNVLNHAYENLTR,QEELESTVAR,QLVASVSCAELEGQIAK,ENPDSFLNHVLALTAQSPNIEHLNEVSLK,KQEELESTVAR	18
TG	PMSLGSWQSLALSSVVVDPSIR,SLRVEVDLLIGSSQDDGLINR,WCDADPCCTGFGFLNVSQLK,DLCLLECSQHEACLITTLQTQPGAVR,SGPYVPQCDAFGSWEPVQCHAGTGHCWCVDEK,QFEESQGR,QFEESQGRTSSK,RSLRVEVDLLIGSSQDDGLINR,CPTPCQLQAEQAFLR,ILDCGSPDIEVHTYPFRWYQK,SLQIPQCLTTCEK,AVLMGGSALSPATVISHER,KCPTPCQLQAEQAFLR,LLALSGPFHYWGPVIDGHFLR,MCSADYAGLLQTFQVFILDELTAR,AVKQFEESQGR,DGADVASIHLLTAR	17
IGHG3	GFYPSDIAMEWESSGQPENNYK,TPEVTCVVVDVSHQDPEVQFKWYVDGVEVHNAK,NQVSLTCLVKGFYPSDIAMEWESSGQPENNYK,GFYPSDIAMEWESSGQPENNYKTTPPVLDSDGSFFLYSK,DTLMISRTPEVTCVVVDVSHQDPEVQFK,GFYPSDIAVEWESSGQPENNYK,CPAPELWGGPSVFLFPPKPK,GVESSGQPENNYKTTPPMLDSDGSFFLYSK,TPEVTCVVVDVSHQDPEVQFK,RGVESSGQPENNYKTTPPMLDSDGSFFLYSK,SRWQQGNIFSCSVMHEALHNHYTQK,WQEGNIFSCSVMHEALHNR,WQQGNIFSCSVMHEALHNHYTQK,PAQASPSSSSSSSAPELLGGPSVFLFPPKPK,CPGKPAQASPSSSSSSSAPELLGGPSVFLFPPKPK,DRAPELLGGPSVFLFPPKPK	16
AKAP12	GALNGQGALNSQEEEEVIVTEVGQRDSEDVSERDSDK,ADSQDAGQETEKEGEDPQASAQDETPITSAK,SPSWISASVTGPLEQVEAEAALLTEEVLER,TEAEPTHVNK,DEGEGAAGAGDHQDPSLGAGEAASK,DSEDVSERDSDK,EGEDPQASAQDETPITSAK,VSVAIEEDLEPENGILELETKSSKLVQNIIQTAVDQFVR,VSVAIEEDLEPENGILELETK,DSEDVSER,TEETATEMLTSELQTQAHMIK,KDEGEGAAGAGDHQDPSLGAGEAASKESEPK,KDEGEGAAGAGDHQDPSLGAGEAASK,EGEDPQASAQDETPITSAKEESESTAVGQAHSDISK,EQSHAEISLPAESGQAVEECK	15
LAMA5	CRPCDCHEAGTVPGVCDPLTGQCYCK,LELEEAATPEGHAMR,ALFSQISSAVSLR,DCQVIPLPPGLPLTHAQDLTPATSPAGPR,SPLGPHHETAQQLEVLEQQSTSLGQDAR,RASQSLDGTYQGGGVCIDCQHHTAGVNCER,RPLSVHPGEDAAQLLAK,YELYSETQR,ASQSLDGTYQGGGVCIDCQHHTAGVNCER,DNATLQATLLAAR,CQAGFMSSRDDPSAPCVSCPCPLSVPSNNFAEGCVLR,ALFSQISSAVSLRR,WLFPTGGSVR,DDPSTPCVSCPCPLSVPSNNFAEGCVLR,CDCTPCGTEACDPR	15
HLA-C	YFYTAVSRPSR,GYDQFAYDGK,YFSTSVSWPGR,YFSTSVSWPGRGEPR,GYDQFAYDGKDYIALNEDLR,GHDQLAYDGK,EPWVEQEGPEYWDRETQK,MFGCDLGPDGR,GEPREPWVEQEGPEYWDRETQK,GHDQLAYDGKDYIALNEDLR,EPWVEQEGPEYWDR,SWTAADTAAQISQR,GEPREPWVEQEGPEYWDR,LLRGHDQLAYDGK	14
PARP4	KTSEDASEYYENYIEELK,DDSIPCFLEVK,GFGSYHPSAYSPFHFQPSAASLTANLR,HITSNTTAAEFIMSATPTMGNTDFWK,MELSQPEVSEDFEEDALGVLPAFTSNLER,WQQLNPDAPEALQAPAQVPSLFR,TSEDASEYYENYIEELKK,KVSPWETSTSSFFPILAPAVGSYLTPTAR,EFCTMVSTTELQK,TSEDASEYYENYIEELK,MDDPSISR,KTSEDASEYYENYIEELKK,QITLHALSLVGEK,WQQLNPDAPEALQAPAQVPSLFRNDR	14
OBSCN	LHVSLMENYPGTLEALGEPIR,RLVVQQAGQADAGEYSCEAGSQR,QVAAGEDVCLELEVVAEAGEVIWHK,HHHIDQLGDGTCSLLITGLGR,LVVQQAGQADAGEYSCK,LVVQQAGQADAGEYSCEAGSQR,HQDCIEGATATLR,EQGTATMEVQLSHADVEGSWTR,RLVVQQAGQADAGEYSCK,DAVASAWLTVLGLPDPPEDAEVVAR,LHVSLMENCPGTLQALGEPIR,LQQGPTCHLAVR,EQEGTESTTDEGQLPQVVEELRDVQVAPGTR,GLVVHDVSPEDAGLYTCHMGSEETR	14
FCGBP	ALASYVAACQAAGVVIK,EGCVCDAGFVLSGDTCVSVGQCGCLHDGR,FDFQGTCNYVLATTGCLGVSTQGLTPFTVTTK,NENRGNPAVSYVR,EEFCGLLSSPTRPLSSCHK,SLAAYTAACEAAGVAVKPWR,LEQYEGPGFCGPLASGTGGPFTTCHAHVPPESFFK,AVSFGLMAPAPSGVAVGLGVAR,KFDFQGTCNYVLATTGCLGVSTQGLTPFTVTTK,ALASYVAACQAAGVVIKDWR,KFDFQGTCNYVLATTGCLGVSTQGLTPFTVTTKNENR,VTYDLVYYVR,GCVLDVCMGGGDHDILCK	13
SYNM	STFQSVVSESPQEDSAGDTSGAEMTSGVSR,ALLEGESNPEIVIWAEHIENMPSEFR,AIDCLEDEK,EGFSGQIQFTAPLSDKVELGVIGNSVHMEGLPGSSTSIR,ELYIPLGESEVAGGASHSSGQR,SPAPGSPDEEGGAEALAAGIR,QRSPAPGSPDEEGGAEALAAGIR,LEEFSVPFK,VELGVIGNSVHMEGLPGSSTSIR,ENEWNLFSR,EVHDSYALLLAESWR,VVNVEIVEEPVSYVSGEKLEEFSVPFK,SYHYTDSLLQRENEWNLFSR	13
NEB	GIGWVPIGSLDVEK,EGHALASDVDYR,YDTPHDMFNVVAAK,TSDYEQSETSKPALAQPASAK,TSDYEQSETSKPALAQPASAKPVER,GEEIIHNYNLPPDLPQFIQAK,DWHDLIAK,SASALSVSGGEEK,NALENYPNFTSVVDPPEIVLAK,FSSPVDMLGVVLANK,ATISIPVDMVSISAAK,FTSVPDSMGMMLAQHNTK	12
MYOM3	DAGFHSEIFKR,GLVEVTIQNLSEEDKGSYTAQLQDGK,QGPYFEQPLQWK,EDEGLYTVRVPSPFGPR,TYLGKDAGFHSEIFKR,VSCTYKEDEGLYTVR,GRAPLTYSLEK,EDEGLYTVR,GLVEVTIQNLSEEDK,PVTSGPISGTHLR,DAGFHSEIFK,KQGPYFEQPLQWK	12
RPL14	GTAAAAAAAAAAAAKVPAK,GTAAAAAAAAAAAK,GTAAAAAAAAAAAAAAAKVPAK,GTAAAAAAAAAAAAAAAK,GTAAAAAAAAAAAAKVPAKK,KAPGTKGTAAAAAAAAAAAAAAAK,GTAAAAAAAAAAAAK,GTAAAAAAAAAAAAAAK,GTAAAAAAAAAAAAAK,GTAAAAAAAAAAAAAAAKVPAKK,GTAAAAAAAAAAAAAAAAK,GTAAAAAAAAAAAAAAAAKVPAK	12
SMTN	STSLMEPEPAEPLAAAVEVANGAEQTR,STSLMEPEPAEPLAAAVEAANGAEQTRVNK,STSLMEPEPAEPLAAAVEAANGAEQTR,MEPEPAEPLAAAVEAANGAEQTR,DPQVGHPAAQMEPEPAEPLAAAVEAANGAEQTR,MEPEPAEPLAAAVEVANGAEQTRVNK,GGCSIKMEPEPAEPLAAAVEVANGAEQTRVNK,STSLMEPEPAEPLAAAVEVANGAEQTRVNK,MEPEPAEPLAAAVEVANGAEQTR,LEKQGAAGSPGGPR,MEPEPAEPLAAAVEAANGAEQTRVNK,VAVTQAAEVAVATMEPVAR	12
NRAP	MKGTAHYHSLPAQDNLVLKR,YSLVTDTPQIVQAK,VYGLQSELQYK,KVYGLQSELQYK,GVACVVPGTLEIEGR,GMAGPAIGTEGILTR,MKGTAHYHSLPAQDNLVLK,GLQIGYCSVDDDPR,FSTVADTPELLR,GSFPAMITPACQIAK,GVACVVPGTLEIEGRK,GTAHYHSLPAQDNLVLKR	12
HLA-DRB5	PSAEYWNSQK,FLDRYFYNQEEYVR,YFYNQEEYVR,HNYGAVESFTVQR,ALVDTYCR,GIYNQEENVRFDSDVGEYR,GIYNQEENVR,AVTELGRPDAEYWNSQKDILEDER,CIYNQEESVRFDSDVGEYR,CIYNQEESVR,DILEDERAAVDTYCR,AVTELGRPSAEYWNSQK	12
TNS1	TVGTNTPPSPGFGRR,WIQPEEDEGKVVVR,QGAACNVLFINSVDMESLTGPQAISK,TMDSCELDLVYVTER,GLNSWQQQQQQQQQQPRPPPR,TVGTNTPPSPGFGR,EATSDPSWTPEEEPLNLEGLVAHR,QGSTTDNACHLFAELDPNQPASAIVSFVSK,KQGSTTDNACHLFAELDPNQPASAIVSFVSK,GLNSWQQQQQQQQQQQPRPPPR,WIQPEEDEGK,RWIQPEPR	12
HLA-DRB1	HFHNQEELLR,AVTELGRPDEEYWNSQKDFLEDR,PSAEYWNSQK,FLDRYFYNQEEYVR,YFYNQEEYVR,HNYGAVESFTVQR,CIYNQEESVRFDSDVGEYR,CIYNQEESVR,HFHNQEELLRFDSDVGEFR,DILEDERAAVDTYCR,AVTELGRPSAEYWNSQK	11
SYNE1	QADIVTFPEINLMNESTELHTQLAK,TTAKDIQQTEQTIEQR,CTAQWHNYQK,GAVALSGDHSALESQIRQLGK,DSLFVLHELGEQLK,TGQTILPSLNEVNHSYLSEK,GAVALSGDHSALESQIR,TYLDLLCSMCDLSNASVKTTAKDIQQTEQTIEQR,VPTNLAVEEALSLQDGCR,GAVALSDVMIPESPEAYVK,DIQQTEQTIEQR	11
PRUNE2	QEEIISILEEK,ADGENPDILTHCEHDSNSQASDSPDICHDSEAKEETEK,NTWDLHPTSSK,NEESLPFQNLPIEK,AGPDAVTHDSEWEMLSPQPVQK,ISEKQEEIISILEEK,AGPDAVTHDNEWEMLSPQPVQK,SLDFGDVPIDSDVHVSSTR,EDHDEALKNTWDLHPTSSK,EIPELEEEKTIPTKEPEQIK,EIPELEEEK	11
C8A	QCDNPAPQNGGASCPGRK,SLKYNPVVINFEMQPIHEVLR,YNPVVINFEMQPIHEVLR,FGGTICSGDIWDQASCSSSTTCVRK,QCDNPAPQNGGASCPGR,RECDNPAPQNGGASCLGR,RQCDNPAPQNGGASCPGRK,ECDNPAPQNGGASCLGR,ECDNPAPQNGGASCLGRK,RQCDNPAPQNGGASCPGR,RRECDNPAPQNGGASCLGR	11
CD99	ENAEQGEVDVESHR,ENAEQGEVNMESHR,ENGQLAGSLGPCIR,ENEQGEVDVESHR,LCFKENAEQGEVNMESHR,LCFKENAEQGEVDVESHR,NAIAEPAVQR,KLCFKENAEQGEVNMESHR,ENEQGEVNMESHR,ENAEQGEVNMESHRNANAEPAVQR,ENAEQGEVDVESHRNAIAEPAVQR	11
SYNPO2	APQMPDSHRGR,TEVPLAENQSGPDCAASLKEETGPSYQR,TEVPLAENQSGPDCAASLK,TEVPLAENQSGPDCAGSLK,TQCTEFFLAPVKTEVPLAENQSGPDCAASLKEETGPSYQR,APQMPDSHR,VTEELILR,TEVPLAENQSGPDCAGSLKEETGPSYQR,TQCTEFFLAPVKTEVPLAENQSGPDCAASLK,SYIEVSHGLGHVPQQNGFSGASETANIQR,TQCTEFFLAPVKTEVPLAENQSGPDCAGSLKEETGPSYQR	11
COL6A2	DYDSLVQPGFFDR,EQGLRDIASTPHELYRNDYATMLPDSTEINQDTINR,VGVVQYSHEGTFEAIQLDDEHIDSLSSFK,NDYATMLPDSTEINQDTINR,SETGTRVGVVQYSHEGTFEAIQLDDEHIDSLSSFK,NDYATMLPDSTEINQDTINRIIK,DIASTPHELYRNDYATMLPDSTEINQDTINRIIK,DYDSLAQPGFFDRFLR,DIASTPHELYRNDYATMLPDSTEINQDTINR,AAVFHEKDYDSLAQPGFFDRFLR	10
TNC	CVDGQCICHEGFTGLDCGQHSCPSDCNNLGQCISGR,QCPKDCSNRGLCVDGQCVCEDGFTGPDCAELSCPNDCHGR,LIPGVEYLVSIITMK,YGDNNHSQGINWFHWK,AQALEVFCDMTSDGGGWIVFLR,VPGDQTSTIIRELEPGVEYFIR,VPGDQTSTIIR,GLCVDGQCVCEDGFTGPDCAELSCPNDCHGR,EQCTAGAVCCLQPATGR,DCSNRGLCVDGQCVCEDGFTGPDCAELSCPNDCHGR	10
TPSAB1	DSCKGDSGGPLVCK,IIRDDMLCAGNTR,VHTVMLPPASETFPPGMPCWVTGWGDVDNDEPLSPPFPLK,IIRDDMLCAGNSQR,DRYWMHFCGGSLIHPQWVLTAAHCLGPDVK,VNGTWLQAGVVSWDEGCAQPNRPGIYTR,IQKLAGCVGSCLYSQLQK,DDMLCAGNSQR,VHTVMLPPASETFPPGMPCWVTGWGDVDNDEPLPPPFPLK,YWMHFCGGSLIHPQWVLTAAHCLGPDVK	10
LAMA2	NLHMAEAPANLEQPTSSFHVGTCFANAQR,QTGQAYYVILLNR,NLHMAEAPANLEQPTSSFHVGTCFANAQRGTYFDGTGFAK,TRGIFAVQVDENRR,IYFGGLPTLSNLSMK,MNVEGIHCDR,NIADADATVK,GIFAVQVDENRR,LIQLAKGNLNTLVTEMNELLTR,EGWECVFCGDECTGLLLSDLAR	10
LMO7	STQMESTCVSASLPR,NPSSSMPRPSAGSVK,STTELDDYSTNKNGNNKYLDQIGNTTSSQR,YNGDIEDIK,YLDQIGNTTSSQRR,YLDQIGNTTSSQR,YNGDIEDIKR,GATYSSEIPK,GATYSSEIPKEDSTTFAK	9
IGHA2	QEHSQGTTTFAVTSILR,SAVQGPPDRDLCGCYSVSSVLPGCAEPWNHGK,MAGKPTHVNVSVVMAEVDGTCY,EKYLTWASQQEPSQGTTTYAVTSILR,YLTWASRQEHSQGTTTFAVTSILR,EKYLTWASRQEHSQGTTTFAVTSILR,SAVQGPPDR,SAVQGPPDRDLCGCYSVSSVLSGCAEPWNHGK,DLCGCYSVSSVLSGCAEPWNHGK	9
DMD	KQAEVVDTEWEK,ELQDGIGQWQTVVR,DQAANLMANHGDHCR,QAEVVDTEWEKLNLHSADWQR,NQLEIYNQPNQEGPFDVQETEIAVQAK,LSGLQPQIER,AEEWLKLLLEYQK,SLEGSNDAVLLQR,DEVNRLSGLQPQIER	9
IQGAP2	RQTFIDNTDSVVK,ESSWVTPESCFYKESWLTGK,VLWLDEIQQAVDEANVDEDRAK,QTFIDNTDSVVK,VAAVGYINEAIDEGNPLR,VLWLDEIQQAVDDANVDEDR,ESSWVTPESCFYK,KYDYYYNTDSKESSWVTPESCFYK,VLWLDEIQQAVDEANVDEDR	9
MYH6	EMNERLEDEEEMNSELTAK,LEDEEEMNSELTAK,VKLEQQVDDLEGSLEQQKK,EMNERLEDEEEMNSELTAKK,LEQQVDDLEGSLEQQK,LEQQVDDLEGSLEQQKK,LEDEEEMNSELTAKK,EFDINQQNSKIEDEQALALQLQK,VKLEQQVDDLEGSLEQQK	9
SPTA1	TKLEDYANLK,HFNENLTGR,HQTFAHEVDGRSEQVHGVINLGNSLIER,GDCGDTLAATQSLVMK,YLKHQTFAHEVDGRSEQVHGVINLGNSLIER,LISPQHNQSK,SEQVHGVINLGNSLIER,NQANACQQQQDAPVEGVAGEQR,TGQEMIEGGHCASDNVTTR	9
HLA-DQB1	HNYEVAYR,PSAEYWNSQK,HIYNREEYAR,HIYNREEYVR,HNYEVGYR,EEYVRFDSDVGVYR,TEALNHHNLLICSVTDFYPSQIK,HIYNREEYVRFDSDVGVYR,AVTPQGRPVAEYWNSQK	9
COL6A3	PAAVRPPAAAAK,GGPGQLGFEGEQGTR,VAVVQYSDRTRPEFYLNSYMNQQDVVNAVR,TRPEFYLNSYMNQQDVVNAVR,LLPSFVSSENAFYLSPHIR,AAGSDVNIDMAFILDSAETTTLFQFNEMKK,AIYHGSFSTK,LHWERPEPPGPYFYDLTVTSAHDQSLVLK,NNLFMSSAGYR	9
GSN	VPEARPNSMVVEHPEFLR,ATEVPVSWESFNNGDCFILDLGNNIHQWCGSDSNRYER,VVEHPEFLR,GGTSREGGQTAPASSR,AGALNSNDAFVLKTPSAAYLWVGTGASEAEKMGAQELLR,TPSAAYLWVGTGASEAEKMGAQELLR,MGAQELLR,ATEVPVSWESFNNGDCFILDLGNNIHQWCGSDSNR,EGGQTAPASSR	9
PDLIM5	ILGEVINALK,KILGEVINALK,ISNSAAYSGSVAPANSALGQTQPSDQDTLVQRAEHIPAGK,VTSTNNMAYNKAPRPFGSVFSPK,SMPESLDSPTSGRPGVTSLTTAAAFKPVGSTGVIK,PGVTSLTTAAAFKPVGSTGVIK,SMPESLDSPTSGRPGVTSLTTAAAFK,APRPFGSVFSPK,ISNSAAYSGSVAPANSALGQTQPSDQDTLVQR	9
LAMC3	SVGGSEHPPQWSPNGVLLSPEDEEELTAPGK,SVGGSEHSPQWSPNGVLLSPEDEEELTAPGK,LAQASHTCGSPPEDFCPHVGAAGAGAQCQR,QEGQYLRPGEDER,EAFLEQMMGLEGAVK,HEGQYLRPGEDER,TYGRHEGQYLRPGEDER,RQELEEAEQVGAGLSEMEQQIR,LTSQMQATLQQASQQVLASEAR	9
PPL	ENLQLETRR,YMEDYHQFHEDVKDAQEMLR,LQLERENLQLETR,SLLDLENGRSSHVSKR,AQVDEVLQLR,NRPDSGVEQAWK,AQVDEVLQLREELEALRR,IEPDRAQVDEVLQLR,ENLQLETR	9
SORBS3	TGFSFPAQEPRPQTQNLGTPGPALSHSR,ELAKLSAELDKDLR,SPADPTDLGGQTSPR,SPADPTDLGGQTSPRR,SARHPSSPSALRSPADPTDLGGQTSPR,TGFSFPAQEPR,RTGFSFPAQEPRPQTQNLGTPGPALSHSR,HPSSPSALRSPADPTDLGGQTSPR	8
MYLK	TSLSVDHSR,DTGHFKVLQNEDVFTLVLK,RGHAGTADNEK,FSASAVETRPSIWGECPPK,TLSEDELKEIPAEQMDFR,GQGWPEEEDGEDVR,TLSEDELK,TLGDRFSASAVETRPSIWGECPPK	8
TACC2	IGTTEVEK,IGTAEVEKPAGLLFQQPNLDSALQIAR,AQQEQAAHQATLR,IGTTEVEKPAGLLFQQPDLDSALQIAR,TEGPSPALLEETPLEPAAGPK,IFEKPVLGALTTPGEK,AQQEQAAHQATLRK,QGTSGGVNTSSEQIATLTGFPDFR	8
GSTP1	EVGKDDYVK,CKYVSLIYTNYEAGK,CKYVSLIYTNYEAGKDDYVK,YVSLIYTNYEVGKDDYVK,YVSLIYTNYEAGK,YVSLIYTNYEVGK,CKYVSLIYTNYEVGKDDYVK,YVSLIYTNYEAGKDDYVK	8
GAA	APSPLYSVEFSEEPFGVIVHR,EPAIHSEGQWVTLPAPLDTINIHLR,YEVPLETPR,RYEVPLETPR,APSPLYSVEFSEEPFGVIVHRQLDGR,NHNSLLSLPQEPYSFSKPAQQAMR,VHSRAPSPLYSVEFSEEPFGVIVHR,NHNSLLSLPQEPYSFSK	8
HCLS1	RSPEAPQPVLAMEEPAVPAPLPK,AEPEPEPEPEPEPENDYEDVEEMDRHK,TTPIEAASSGAR,EHPVPLLPIRQTLPEDNEEPPALPPRTLEGLQVEEEPVYK,TLEGLQVEEEPVYK,QTLPEDNEEPPALPPRTLEGLQVEEEPVYK,SPEAPQPVLAMEEPAVPAPLPK,KTTPIEAASSGAR	8
TNXB	KVTIPDLEPSRK,CVDGHCVCNPGFTGEDCGSR,CVDGHCVCNPGFTGEDCGSRR,LGELTMTDATPDSLSLSWMVPEGQFDHFLVQYR,AVSYPAAVR,CLCDPGYTGPTCATHMCPADCR,LGQMTVRDITSDSLSLSWTVPEGQFDHFLVQYKNGDGQPK,LGELTMTDATPDSLSLSWMVPEGQFDHFLVQYRNGDGQPK	8
MYH11	ENTDLAGELRVLGQAK,DVASLSSQIQDTQELLQEETR,LQNEAESVTGMLNEAEGK,NKQTLEKENTDLAGELR,ENTDLAGELR,LAKDVASLSSQIQDTQELLQEETR,QTLEKENTDLAGELR,DVASLSSQIQDTQELLQEETRQKLNVSTK	8
IGHV4-59	ANYNPSLK,IYTSGSTNYNPSLKSR,VTISVETSKNQFSLK,GLEWIGYIYYSGRANYNPSLK,VTISVETSK,QPAGKGLEWIGR,GLEWIGRIYTSGSTNYNPSLK,IYTSGSTNYNPSLK	8
SAA1	GNYDAAKRGPGGVWAAEAISDAR,RGPGGAWAAEVISDAR,RGPGGVWAAEAISDAR,RGPGGVWAAEAISDARENIQR,RGPGGAWAAEVISDARENIQR,GPGGVWAAEAISDARENIQR,GPGGAWAAEVISDAR,GPGGVWAAEAISDAR	8
IGHG2	TPEVTCVVVDVSHEDPEVQFNWYVDGMEVHNAKTK,KCCVECPPCPAPPVAGPSVFLFPQNPR,GFYPSDIAVEWESNGQPENNYKTTPPMLDSDGSFFLYSK,SRWQQGNIFSCSVMHEALHNHYTQK,WQQGNIFSCSVMHEALHNHYTQK,DTLMISRTPEVTCVVVDVSHEDPEVQFNWYVDGMEVHNAK,TPEVTCVVVDVSHEDPEVQFNWYVDGMEVHNAK,EPQVYTLTPSREEMTK	8
ENO3	LSVADQEKVDK,LSVADQEK,AVENINSTLGPALLQKK,LSVADQEKVDKFMIELDGTENK,KLSVADQEK,AVENINSTLGPALLQK,KLSVADQEKVDK	7
NID2	GEADDLKSEGSYFSLTSTEQSVK,SYPASDHTTPLSR,FAVTNQIGPVKEDSDPTLVNPCYDGSHMCDTTAR,FAVTNQIGPVKEDSDPTPVNPCYDGSHMCDTTAR,HLEESSTLDPHTK,CECQSGYEFADDR,EDSDPTPVNPCYDGSHMCDTTAR	7
PCNT	TEASTELAGTVAHELQGVHQGEFGSEKK,AALQELESEHGK,SHTLELSEALR,LSPGSGGPEAR,TQEACVHQDTQAHHALLR,NLYEKLQHETR,TEASTELAGTVAHELQGVHQGEFGSEK	7
MUC1	CHLGPGEQAGPGLHRPPSPR,CHLGPGHQAGPGLHRPPSPR,PAPGSTAPPAHGVTSAPESR,APPPPQPTVSPRPR,CHLGPGHQAGPGLHR,PAPGSTAPAAHGVTSAPESR,CHLGPGEQAGPGLHR	7
MTTP	MKDVNVENVNQHR,PTLLHLTHGK,DVNVENVNQHR,YTAIPIVGQVFQSQCK,AVDSKYTAIPIVGQVFQSQCK,ENLEALQRPTLLHLTHGK,DVNVENVNQHRGEK	7
NIBAN1	EVNEVSQHFQTTK,ASAILPGVLGSETLSNEVFQESEEEKQPEVPSLLAK,ASAILPGVPGSETLSNEVFQESEEEK,QPEVPSLLAK,RASAILPGVPGSETLSNEVFQESEEEK,RASAILPGVPGSETLSNEVFQESEEEKQPEVPSSLAK,ASAILPGVPGSETLSNEVFQESEEEKQPEVPSSLAK	7
TXNRD2	RLPDGQLQVTWEDR,VSVVDYVEPSPQGTR,KVSVVDYVEPSPQGTR,QILLSADHIIIATGGR,EATSVPHIYAIGDVVEGRPELTPTAIMAGR,GGKQILLSADHIIIATGGRPR,KVSVVDYVEPSPQGTRWGLGGTCVNVGCIPK	7
MAP4	GISEDSHLESLQDVGQSAAPTFMISPETITGTGK,VALSSQTEVALAR,LGHCSLSESGCVSGSSSCGGPGNQR,RECVVNSSAAR,TSDMAPSKETEMALAKDMALATK,DLVLLSEIEVAQANDIISYTEISSAEK,GISEDSHLESLQDVGQSAAPTFMISPETITGTGKK	7
SVIL	DSPVLHICESK,DRLPFEEKLEVENVMK,GLASPTAITPVASAICGK,LFVLSSSSGDFAATEFVYPAR,TCAGESKDYALHAGDGSSDPEVLLNIENQR,KGLASPTAITPVASAICGK,DYALHAGDGSSDPEVLLNIENQR	7
NOP56	FSKEEPVSSGPEEAAGK,RLAALALASSENSSSTPEECEETSEK,IGAAIQEELGYNCQTGGVIAEVLR,EEPVSSGPEEAAGK,KFSKEEPVSSGPEEAAGK,EEPVSSGPEEAAGKSSSK,LAALALASSENSSSTPEECEETSEKPK	7
SORBS1	SQVLSPPHPPLPQK,SKSEMSCIDGEK,NASGLVLPTDMDPTK,ASGSFAPISQAPPSFSPPPPLVPPAPEDLRR,SEMSCIDGEK,AVMNGLAPGSNGQDKDMDPTK,ASGSFAPISQAPPSFSPPPPLVPPAPEDLR	7
LRRFIP1	QEIAAESSENVDCLENPK,SAVEAQNEVTENPKQEIAAESSENVDCLENPK,HGIILNSEIATNGETSDTLNNVGYRGPTK,ALDSNSLENDDLSAPGREPGDFNPESR,KALDSNSLENDDLSAPGREPGDFNPESR,ALDSNSLENDDLSAPGGEPGDFNPESR,ALDSNSLENDDLSAPGGEPGDFNPESREDTRGGNEK	7
PITRM1	IAKDPSWIIR,EAYFSVGLQGIVEK,AFSSLNTLPEELRPYVPLFCSILTK,STHSLAILGPENPK,LSVFSTIDAPVAPSDK,STHGLAILGPENPKIAKDPSWIIR,EAYFSVGLQGIVEKDIETVR	7
MMUT	EDTVEVLAIDNTSVR,SSRDQALAEHCLAALTECAASGDGNILALAVDASR,MVSGAYRQEFGQSKEITSAIK,DQALAEHCLAALTECAASGDGNILALAVDASR,MVSGAYRQEFGQSK,YQLEKEDTVEVLAIDNTSVR,EVAQQAVDADVHAVGVSTLAAGHK	7
GBP6	ASDYYSQQMAQR,FLESQMVIK,FPTDTLQELLDVHAACER,LQEQQQQMEAQVK,QKLQEQQQQMEAQVK,GLMESISAGSFSFPGGHK,VKFPTDTLQELLDVHAACER	7
IFI16	SMKLPQEQSQLPNPSEASTTFPESHLR,TEPEEVFIEDSAQSDLK,TSLSAPPNTSSTENPK,LKTEPEEVFIEDSAQSDLK,LKTEPEEVFIEDSAQSDLKEVMVLNATESFVYEPK,LPQEQSQLPNPSEASTTFPESHLR,TSLSAPPNTSSTENPKTVAK	7
FRAS1	VENLLFHVVSTPTNGQLVLSR,FRGQFVMEHHTLPDVK,KPEEGLQVEQLSGVGIPSGECLAQCR,HQHVCSNLVTTDDLR,DSKPNVVSNNVFHIQWSLISFK,GQFVMEHHTLPDVK,TSNGQHFHLTSTFTMEDIYQNR	7
IGHG4	TKGQPREPQVYTLPPSQEEMTK,SRWQQGNIFSCSVMHEALHNHYTQK,WQQGNIFSCSVMHEALHNHYTQK,VEPKYGPPCPSCPAPEFLGGPSVFLFPPKPK,VVSVLTILHQDWLNGK,VVSVLTILHQDWLNGKEYK,EPQVYTLPPSPEEMTK	7
F13A1	VRGTQVVGSDMTVTVQFTNPLKETLR,RAVPPNNSNAAEDDLPTVELQGLVPR,GTQVVGSDMTVTVQFTNPLK,VRGTQVVGSDMTVTVQFTNPLK,GTQVVGSDMTVTIQFTNPLK,AVPPNNSNAAEDDLPTVELQGLVPR,GTQVVGSDMTVTVQFTNPLKETLR	7
GSTO1	EDYDGLKEEFRK,SQNKEDYDGLK,EDYDGLKEEFR,KDPTVSALLTSEK,LEVLTNKK,SQNKEDYDGLKEEFR	6
GPX1	LAAAAAAQSVYAFSAR,LAAAAAAQSVYAFSARPLAGGEPVSLGSLR,LAAAAAQSVYAFSARPLAGGEPVSLGSLR,RFQTIDIEPDIEALLSQGLSCA,RFQTIDIEPDIETLLSQGPSCA,LAAAAAQSVYAFSAR	6
CP	QYTDSTFHVPVER,MYYSAVDPTKDIFTGLIGPMK,MYYSAVDPTKDIFTGLIGPMKICK,ADDKVYPGKQYTYMLLATEEQSPGEGDGNCVTR,MYYSAVDPTK,QYTDSTFHVPVERK	6
LAMB1	CLAGYYGDPIIGSGDHCRPCPCPDGPNSGR,SFYYQHPER,NCEQCKSFYYQHPER,MEMPSTPQQLQNLTEDTR,FGYYGDALR,CLAGYYGDPIIGSGDHCRPCPCPDGPNSGRQFAR	6
FLNB	TGLVEPVNMVDNGDGTHTVTYTPSQEGPYMVSVK,VGEAGLLSVNCSEAGPGALGLEAVSDSGTKAEVSIQNNK,VGEAGLLSVNCSEAGPGALGLEAVSDSGTK,GLVEPVNMVDNGDGTHTVTYTPSQEGPYMVSVK,VVASGPGLQHGK,ADIEMPFDPSKVVASGPGLQHGK	6
IGKV1-39	ASQSIRSYLNWYQQK,VTITCRASHSISTYLNWYQQKPGK,ASQSIRSYLNWYQQKPGK,APKLLIYAASNLQSGVPSR,LLIYAASNLQSGVPSR,ASHSISTYLNWYQQKPGK	6
TJP2	EESYDFFK,AEQIASVQNAQR,YQEEPPAPQPK,TQNKEESYDFFK,TQNKEESYDFFKSYEYK,KVQVAALKASPPLDQDDR	6
ACIN1	ELLVPQHTVQLVGGLFPLSSPSDTK,EEGEEMPR,EAPILKEFKEEGEEMPR,EFKEEGEEMPR,LSEGSQPAEEEEDQETPSK,ELLVPQHTVQLVGGLSPLSSPSDTK	6
DST	KPQYEQLTAAGQGILSRPGEDPSLHGIVK,LLTPLEIAK,AAECSDFPVPSTEGTPIQGSK,LNVLESLIK,KLEALIASNDNANK,AVQDKLNQMVFIWENIHTLVEER	6
GBP1	CSGLLQVIFSPLEEEVKAGIYSKPGGYR,LQDEELDPEFVQK,VQLPTESLQELLDLHR,VQLPTESLQELLDLHRDSER,VQLPTESLQELLDLHRDSEREAIEVFIR,CSGLLQVIFSPLEEEVK	6
SEPTIN9	RAEVLGHKTPELAPR,LNEGSSAMANGVEEK,RLNEGSSAMANGVEEKEPEAPEM,LNEGSSAMANGVEEKEPEAPEM,RLNEGSSAMANGVEEK,AEVLGHKTPELAPR	6
MACF1	TLLPEDTQKLDNFLGEVR,SRLETMNQCWESVLQK,TLLPEDTQK,LETMNQCWESVLQK,ATDETDRDIIREPLTELR,GLNLEEITVSRPDSK	6
GOLGA3	TEDSNAGNSGGNVLAPDSTK,TEDSNAGNSGGNVLAPDSTKGSLKQNR,DVLQAAAAEHQDQGQEVSGEVR,SLADYRTEDSNAGNSGGNVLAPDSTK,LQAEANDLQIR,EHLVQKLQAEANDLQIR	6
MYOM2	FVVHGLTTGEQYLFR,AVNAVGMSENSQESDIIK,GGISDHSAFLFVR,LCFTVQGFPMPMVQWYK,DDALYETETLPNLER,AEWYRDDLLLK	6
TPO	FPEDFESCDSIPGMNLEAWR,AAFGGGSDCQMTCENQNPCFPIQLPEEAR,VPVDAFQVGK,ATEVPSLTALHTLWLR,APSACAPEPGIPGETR,VICDNTGLTRVPVDAFQVGK	6
POTEE	FRCPEALFQPCFLGMESCGIQETTFNSIMK,CPEALFQPCFLGMESCGIHDTTFNSIMK,EKLCYVALDFEQEMATTASSSSLEK,LCFVALDFEQEMATVASSSSLEK,CPQALFQPCFLGMESCGIHETTFNSIMK,CPEALFQPCFLGMESCGIQETTFNSIMK	6
GFAP	VIPIQAHQIVNGAPPAR,QLQSLTCNLESLRGTNESLER,QLQSLTCNLESLR,VIPIQAHQIVNGAPPARG,SLTIRVIPIQAHQIVNGAPPAR,RQLQSLTCNLESLR	6
DNAJC10	AYQYHSYNGWNR,NPNNPNAHGNFLK,LHPDKNPNNPNAHGNFLK,EIYLEVIHNIPDFELLSANTLEDR,LALKLHPDKNPNNPNAHGNFLK,LHPDKNPNNPNAHGNFLKINR	6
IGHG1	SRWQQNVFSCSVMHEALHNHYTQK,LTVDKSRWQQNVFSCSVMHEALHNHYTQK,STSGGTAALCLVK,WQQGNVFSCSVMHEGLHNHYTQK,GPSVFPLAPSSKSTSGGTAALCLVK,WQQNVFSCSVMHEALHNHYTQK	6
ITIH5	DYLASHPFDTGMTLGQGMSR,DVTGSPRPGGDGEGDPNHIER,AGKDVTGSPRPGGDGEGDPNHIER,LIDGEYKDYLASHPFDTGMTLGQGMSR,PGGDGEGDPNHIER,VYIHHMSPTGGTDINGVLQR	6
IGHV1-69D	ASGGTFSSYTISWVR,VSCKASGGTFSSYVISWVR,ASGGTFSSYVISWVR,SGDTAVYYCAR,IIPILGIANYAQK,QAPGQGLEWMGR	6
TOR1AIP1	LQQQHSEQPPLQPSPVTTRR,TTRLQQQHSEQPPLQPSPVTTR,SSSQYIESFWQSSQSQNFTAHDKQR,RTTRLQQQHSEQPPLQPSPVTTR,TPQEWAPHTAR,LQQQHSEQPPLQPSPVTTR	6
SERPINB3	GKNLSMIVLLPNEIDGLQK,DLSMIVLLPNEINGLQK,GKDLSMIVLLPNEINGLQK,ETPVDLHLPR,GKDLSMIVLLPNEINGLQKLEEK,DLSMIVLLPNEINGLQKLEEK	6
HMCN2	NAAGSTSVAFLVEIHTVPTIR,DDPLGEVGVK,NYHVEVLIPPSISKDDPLGEVGVK,ADVWDAGHYTCEALNQAGR,IHPTATHHITNEGVPASLPCVASGVPAPTITWTK,EGHPTSLSCECR	6
CTSB	PSFHPVSDELVNYVNK,SRPSFHPVSDELVNCVNKR,SRPSFHPVSDELVNYVNK,ASHQWMNTQGGHLALGVYQHVTGEMMGGHAIR,PSFHPVSDELVNYVNKR,SRPSFHPVSDELVNYVNKR	6
NID1	CPDNTLGVDCIERK,ESIENLAK,CPDNTLGVDCIER,AQCIYTGGSSYTCSCLPGFSGDGQACQDVDECHPSR,GFPEISFQPSSAVVVTWESMAPYQGPSRDPDQK,SNGAYNIFANDRESIENLAK	6
MUC2	LHGHLYTPGQEITNDCK,CGCYVEDTHYPPGASVPTEEICK,INQPDVVCEDPEEEVAPASCSEHCAECER,ALSCQTLAAGYYHTECVSGCVCPNGLMDDGRGGCVVEK,HLAVLNGAMVSTPHYSPGLLIEK,ALSCQTLAAGYYHTECVSGCVCPNGLMDDGR	6
SIRPA	KGSPDTEFKSGAGTELSVR,VTTVSESTKR,VTTVSESTK,RENMDFSISISNITPADAGTYYCVK,GSPDTEFK,ENMDFSISISNITPADAGTYYCVK	6
SERPINA1	AVLTINEKGTEAAGAMFLEAIPMSIPPEVK,FNKPFVFLMIDQNTKSPLFMGK,FNKPFVFLMIDQNTK,GTEAAGAMFLEAIPMSIPPEVKFNKPFVFLMIDQNTK,LQHLVNELTHDIITK,PFVFLMIDQNTK	6
FLG2	SHACGYSNSSGCGRPQNASSSSQSHR,GHQHQEEESETEEDEEDTPGHK,HSSWSEEEEHGYSSGHSR,QSHACGYSNSSGCGRPQNASSSCQSHR,SGHSSYGQHGFGSSQSSGYGQHGSSSGQTSGFGQHK	5
SPRR3	VPEPDYTKVPEPGSIKVPDQGFIK,VPEPDYTK,VPEPCPSTVTPGPAQQK,VPVPGYTKVPEPCPSTVTPGPAQQK,VPEPDYTKVPEPGSIK	5
MMP9	KLDSVFEEPLSK,LDSVFEEPLSK,MFPGVPLDTHDVFQYQEK,KLDSVFEEPLSKK,SASEVDRMFPGVPLDTHDVFQYQEK	5
PRX	GAEVQGDRASPGEK,VPSVEIVTPQLPAVEIEEGRLEMMETK,GERAEGPEVAAGVR,AEGPEVAAGVR,MPEVAVPEVRLPEVQLPK	5
COBL	RASLAPLQAEHSQPHEK,ASLAPLQAEHSQPHEK,AVTASNDEDLLIAGEFR,AREEVPALHPASHDIGK,EEVPALHPASHDIGK	5
RNF213	HILELQEVYDYLYQPSYR,EIAAVISPELER,TTDNFDDILK,IMCTVDHQGQR,SLSPQDEK	5
MYOM1	YGMHTLEINACDFEDTAQYR,TGGAEITGYYVNYREVIDGVPGK,ELMTEVCK,TGGAEITGYYVNYR,NLLASEEGITTPK	5
SLK	DQQKQQMFENKLIK,KEPEVIVVSQPTEPQPVLIPSININSDSGENKEEIGSLSK,DVISNTSDVIGTYEAADVAQK,KEPEVIVVSQPTEPQPVLIPSININSDSGENK,SEEEKDQQKQQMFENK	5
SPARCL1	DQEDSDGDLSVNLEYAPTEGTLDIK,LLSDHSKPTAETVAPDNTAIPSLRAEDEENEK,AEDEENEKETAVSTEDDSHHKAEK,AEDEENEKETAVSTEDDSHHK,KAENSSNEEEASSEGNMR	5
IGHV3-48	NSLYLQINSLR,DNAKNSLYLQINSLR,LSCAASGFMFSTYEMNWVR,DEDTAVYYCAR,NSLYLQMNSLRDEDTAVYYCAR	5
LAMA4	LSDLQEALDQALNHVR,KNGAVWCICNENYAGPNCER,LSDLQEALDQALNHVRDAEDMNR,NGYLHVFYDFGFSSGPVHLEDTLKK,NGYLHVFYDFGFSSGPVHLEDTLK	5
SPTB	ETWLNENQR,WISAMEDQLQSDDPGK,LEGLDTGWDALGR,AAMRETWLNENQR,WISAMEDQLQSDDPGKDLTSVNR	5
PCMT1	VIGIDHIKELVDDSINNVR,MVGCTGKVIGIDHIKELVDDSINNVR,VIGIDHIKELVDDSINNVRK,ELVDDSINNVRK,ELVDDSINNVR	5
FLNA	ALGALDSCAPGLCPDWDSWDASKPVTNAR,SPFEVYVDKSGDASK,VHPGIQSGTTNKPNK,CAPGVGPAEADIDFDIIR,VPHDVTDASK	5
MAN2B1	NLDKLIQLVNAQQAK,NLCWDVLCVDQPVVEDPR,LIQLVNAQQAK,HLELEWSVGPIPVGNTWGK,QLAAGWGPCEVLLSNALSR	5
VWF	AEGLECAK,IALLLMASQEPQR,VALLLMASQEPQR,HGAGVAMDGQDIQLPLLK,IGCNTCVCR	5
SLC30A9	VPSFETAEGIGAELKAPLK,VEKVPSFETAEGIGAELK,VPSFETAEGIGAELKAPLKQEPLQVR,VPSFETAEGIGAELK,VEKVPSFETAEGIGAELKAPLK	5
THRAP3	DSRPSQAAGDNQGDEVK,SSSKDSRPSQAAGDNQGDEVK,PSQAAGDNQGDEVKEQTFSGGTSQDTK,PSQAAGDNQGDEVK,DSRPSQAAGDNQGDEVKEQTFSGGTSQDTK	5
LTF	DVTVLQNTDGNNNDAWAK,RSVQWCTVSQPEATK,CLAENAGDVAFVKDVTVLQNTDGNNNDAWAKDLK,CLAENAGDVAFVKDVTVLQNTDGNNNDAWAK,SVQWCTVSQPEATK	5
ALDH1L1	PGFFFEPTVFTGVEDHMFIAK,LTFFNSTLNTSGPVPEGDALPIPGAHRPGVVTK,EESFGPVMIVSR,EGATLVCGGNQVPRPGFFFEPTVFTGVEDHMFIAK,MPHQLFIGGAFVDAEGAK	5
SLC38A10	DGVIGLNPLPDVQVNDLRGALDAQLRQAAGGALQVVHSR,DLGPHAEGQLAPRDGVIGLNPLPDVQVNDLRGALDAQLR,DGVIGLNPLPDVQVNDLR,SLEHSEGPVGRDPAGPPDGGPDTEPRAAQGK,DGVIGLNPLPDVQVNDLRGALDAQLR	5
PRRC2C	LNGQQTALASQYR,TLSTPQEER,SIQTPQSHGTLTAELWDDK,SVEDVRPHHTDANNQSACFEAPDQKTLSTPQEER,VDSDSSKPPETLTNPPGVCQEK	5
FAM120B	EVPVYTYSEPR,QEVPTCSDPEPR,QEVPMCTDSEPR,QEVPIGTDPISK,QEVPMCTGPEPR	5
LAMA3	LPDDLEDLK,YVNPGNEAVSGHITIYPSWGAAQSK,VLAVPAENYDYQILHK,SGVEVRLPDDLEDLK,VLAVPAENYDYQILHKK	5
TNKS1BP1	YESQEPLAGQESPLSLATR,VPSSDEEVAEEPQSR,SSPCHSQLLEAQSPEASQASPCPAVTPSAPSAALPDEGSR,APVIRPGGTLGLSEAADSDAR,SSQFGIIGNDR	5
LAD1	GPWALEEESLGREPEER,NLPSLAEQGASDPPTVASR,SPAADAKPAPK,NLPSLAEQGASDPPTVASRLPPVTLQVK,GPWALEEESFGREPEER	5
GOLGB1	HQIEDNVSK,DDCNRLQEQFDEQSKENENIGDQLR,DDCNRLQEQFDEQSK,LSSTDQQESCSSTPGLEEPLFK,DQQVTEISFSMSEK	5
PDIA4	MDATANNVPSDRYK,EVSQPDWMPPPEVTLVLTK,VREVSQPDWMPPPEVTLVLTK,MDATANNVPSDRYKVEGFPTIYFAPSGDK,MDATANNVPSDR	5
LTBP4	SRGPGAPCQNVDECARSPPPCTYGR,FCQLHSSGARPPAPAIPGLTR,ACPSGHHLHR,TSAGMFPGSQPQAPASPVLPARPPPPPLPR,SRGPGAPCQNVDECAR	5
NUCB2	LQGIPPSGPAGELK,EFLEPDSWETLDEQQFFTEEELK,KLQGIPPSGPAGELKFEPHI,KLQGIPPSGPAGELK,KEFLEPDSWETLDEQQFFTEEELKEYENIIALQENELK	5
FKBP15	LSEIQETSEQAQSKFKSEK,LSEIQETSEQAQSK,LSEIQETSEQAQSKFK,CLSLQAQITALTK,FGAAVLGNHTTR	5
NES	AWLSSQAAELER,AWLSSQAAELERELEALR,SLKEESIEAVK,EESIEAVK,AWLSSQAAELERELEALRVAHEEER	5
OVGP1	EIPENSAVDQEA,TLTPVGHQSVSPGGTTMTPVHFQTETLR,TEITGATTMTSVGHQSMTPGEK,TEITGATTVTSVGHQSMTPGEK,KEIPENSAVDQEA	5
FYCO1	AQSLQKAAHQELNTLK,AQSLQEAAHQELETLK,ELQTCLQALELGAAEKEEDYHTALR,HLGDQMEVSLLAVR,ELQTCLQALELGAAEK	5
ECHDC3	NHPVPVIAMVNGLATAAGCQLVASCNIAVASDK,NHPVPVIAMVNGLATAAGCQLVASCDIAVASDK,RNTLSLAMLK,KRNTLSLAMLK,NTLSLAMLK	5
ASAH1	LTIYTTLIDVTK,DAMWIGFLTR,VMQVVDEK,KDAMWIGFLTR,WHELMLDKAPMLK	5
FTCD	RTVALQEGLRR,TVALQEGLRR,GVSMDECVLCAQAFGQR,VQGIGWYLDEKK,TVALQEGLR	5
SYTL4	DTVNPLYDETLRYEIPESLLAQR,TSIKRDTVNPLYDETLR,DTVNPLYDETLR,RDTVNPLYDETLR,RDTVNPLYDETLRYEIPESLLAQR	5
VWA8	LRETQDPTAQSLAASLSTGQLLR,MTENHVSQASVTIR,AGTAFYIDQCAVHAATEGR,ILPPGEVPLKDLYPK,ETQDPTAQSLAASLSTGQLLR	5
GC	AKLPDATPK,RSDFASNCCSINSPPLYCDSEIDAELK,AKLPEATPTELAK,LPEATPTELAK,LKAKLPEATPTELAK	5
CROCC2	AHLWELEQAR,SSQALVASLR,SSELMDVATVQDVLR,PQATQALESQEWTHQQR,AEVSPEPLR	5
BSN	PRPESSQEPAALPK,PLLQAQGLTPSER,APQAQPTPGPGPAGVK,GPHDGPSQPTGPR,APQQGRAPQAQPTPGPGPAGVK	5
CTSC	VGTASENVYVNTAHLK,RGTDECAIESVAVAATPIPK,GTDECAIESVAVAATPIPKL,GTDECAIESVAVAATPIPK,KVGTASENVYVNTAHLK	5
IGHV2-70	IDWDDEKYYSTSLK,ESGPALVKPTQTLTLTCTFSR,NQVVLTMTNMDPVDTATYFCAR,NQVVLTMTNMDPVDTGTYYCAR,ALEWLARIDWDDDKYSTSLK	5
KRT7	NKYEDEINRR,NKYEDEINR,SMQDVVEDFKNKYEDEINR,SLDLDGIITEVK,YEDEINRR	5
C7	GGGAGFISGLTYLELDNPAGNKR,LLEPHCFPLSLVPTEFCPSPPALKDGFVQDEGPMFPVGK,NVVYSCNEGYSLIGNPVAR,GGGAGFISGLTYLELDNPAGNK,DGFVQDEGPMFPVGK	5
PDCD4	MDVENEQILNVNPAENAGTEEVK,DSGRGDSVSNSGSDALRSGLTVPTSPK,MDVENEQILNVNPADPDNLSDSLFSGDEENAGTEEVK,DSGRGDSVSNSGSDALR,NSSRDSGRGDSVSNSGSDALR	5
MGAM	GELFWDDGETK,YEVPVPLNIPSMPSSTPQGQLYDVLIKK,IYDPNKNRYEVPVPLNIPSMPSSTPQGQLYDVLIK,GELFWDDGETKDTVANK,NRYEVPVPLNIPSMPSSTPQGQLYDVLIK	5
CORO7	KPGRLPDTALPTLQNGAAVTDLAWDPFNPHR,DKQLQIFDPR,LPDTALPTLQNGAAVTDLAWDPFNPHR,QLQIFDPR,LPDTALPTLQNGAAVTDLAWDPFNPHRLAVAGEDAR	5
IGHV3-74	DNTRNTVYLQMNSLR,NTVYLQMNSLR,NTVYLQMNSLRAEDTAVYYCAR,LSCAASGFTFSSSWMHWVR,DNAKNTVYLQMNSLR	5
LAMC1	CQPGFHSLTEAGCRPCSCDPSGSIDECNVETGR,PCSCDPSGSIDECNVETGR,TASDTSTEAYNLLLR,LQNIQNTIEETGNLAEQAR,ACNCNPYGTMK	5
CAPN2	RQDIQSDGFSIETCK,QDIQSDGFSIETCK,ELGPYSGK,DREAAEGLGSHER,EAAEGLGSHER	5
ADD1	WLNSGRGDEASEEWQNGSSPK,QKGCEENLDEAR,GCEENLDEAR,GCEENLDEAREQK,GDEASEEWQNGSSPK	5
PGM1	LKICIDAMHGVVGPYVK,LVVGQNGILSTPAVSCIIRK,LVVGQNGILSTPAVSCIIR,ICIDAMHGVVGPYVK,IAAANGIGRLVVGQNGILSTPAVSCIIR	5
MYH9	KLEMDLKDLEAHVDSANK,DLEAHVDSANKNR,DLEAHVDSANK,DLEAHVDSANKNRDEAIK,LEMDLKDLEAHVDSANK	5
ESD	AFSEYLGTDQSK,KAFSEYLGTDQSK,AFSEYLGTDQSKWKAYDATHLVK,KAFSEYLGTDQSKWK,AFSEYLGTDQSKWK	5
PCSK1	RDELEEGAPSEAMLR,DELEEGAPSEAMLR,CAGEIAMQADNHK,SPSSSSVGGRRDELEEGAPSEAMLR	4
IGKV1D-37	VSQGISSYLNWYQQKPGK,VSQGISSYLNWYQQK,VTITCRVSQGISSYLNWYQQKPGK,LLIYSASSLQSGVPSR	4
MYH3	DLEEATLQHEAMVATLR,KKHTDSVAELGEQIDNLQR,EKKALQEVHQQALDDLQAEEDK,KHTDSVAELGEQIDNLQR	4
SDHA	KHTLSFVDVGTGK,HTLSFVDVGTGK,VTLEYRPVIDKTLNEADCATIPPAIR,TLNEADCATIPPAIR	4
MYO18A	ISELTSELTDERNTGESASQLLDVETAER,LDYDGAILDVDEDDVEK,QNPATQNVPR,VQLTPVEEAHQQLER	4
TTLL12	KQQPNPGSELCYK,LPLDINPMVHPHGHIFK,YIESPVLFLREDMGK,QQPNPGSELCYK	4
WDFY4	STEGMDIVMDNLK,IPTIIGILACQLR,ATSEDTLNLR,MSVPGRPAGEEPLAQPPSPR	4
SEC23A	VPVTQATRGPQVQQPPPSNR,VPVTQATR,DLSAKQLQEMLGLSKVPVTQATR,QLQEMLGLSKVPVTQATR	4
CPPED1	TLDAFPAEK,KLADKFIHAGVR,LADKFIHAGVR,TLDAFPAEKESEWK	4
IGHV3-30	NTLYLQMHSLRTEDTAVYYCAR,NTLYLQMHSLR,LSCAASGFTFSNYAMHWVR,AEDTAMYYCAK	4
CR1	SFFSLTEIVR,SFFSLTEIIR,TPPDPVNGMVHVITDIHVGSR,VCQPPPEILHGER	4
IGKC	HKLYACEVTHQGLSSPVTK,LYACEVTHQGLSSPVTK,VDNALQSGNSQESVTEQDSKDSTYSLSNTLTLSK,DSTYSLSNTLTLSK	4
SCRN2	SVFKPFIFGVGVAQAPQVLSPTFGAQDPVRTLPR,SVFKPFIFGVGVAQAPQVLSPTFGAQDPVR,DKQSGICMDSGGFR,QSGICMDSGGFR	4
IGHV4-31	QPAGKGLEWIGR,GLEWIGRIYTSGSTNYNPSLK,IYTSGSTNYNPSLKSR,IYTSGSTNYNPSLK	4
ELAPOR1	VAVPHTPGLCTSLPDPVK,TPDGFDSVPLKTSSGGPDMDL,DSGTCHSCPPNTILK,RTPDGFDSVPLKTSSGGPDMDL	4
TMEM43	NPSAMAVESFTATAPFVQIGR,EIGHNNPSAMAVESFTATAPFVQIGR,EIGHKNPSAMAVESFTATAPFVQIGR,NFDREIGHNNPSAMAVESFTATAPFVQIGR	4
EEF1A2	GPFKYAWVLDK,VETGILRPGMGVTFAPVNITTEVK,ATQAALSLLEALDTILPPTRPTDKPLR,NMITGTSKADCAVLIVAAGVGEFEAGISK	4
ALPP	DKLGPELPLAMDRFPYVALSK,DKLGPELPLAMDR,LGPELPLAMDRFPYVALSK,LGPELPLAMDR	4
MLIP	YANLSSPTSTVSESQLTK,KVEQGPPGGIGTAAIRPK,VEQGPPGGIGTAAIRPK,YANLSSPTSTVSESQLTKPGVIRPVPVK	4
ECM1	RAPYPNYDRDILTIDISR,DILTIDISR,APYPNYDRDILTIDISR,EGMPAPFGDQSHPEPESWNAAQHCQQDR	4
ADPRHL1	TQSGESQERPLTQADLGR,AWEQGWEQTHIEAQGQAQK,LQNMSSGENKPSCICGGENVVENAHTEFPTVTENR,RGHDAMIAYDALLAAGNSWTELCHR	4
ITIH4	NPPVWVHASPEHVVVTR,KAFITNFSMNIDGMTYPGIIK,LAILPASATPATSNPDPAVSR,LLGLPGPPDVPDHAAYHPFRR	4
CAMKK1	IKNEPVVFPEGPEISEELKDLILK,NEPVVFPEGPEISEELK,IKNEPVVFPEGPEISEELK,NEPVVFPEGPEISEELKDLILK	4
ANPEP	LPNTLKPDSYQVTLRPYLTPNDR,QWMQNPNNNPIHPNLR,QQQDYWLMDVR,EIPENLMDQYNEVNAISTACSNGVPECEEMVSGLFK	4
AEBP1	VWPETPEEKAPAPAPEER,TQWLEVDTRR,VWPETPEEK,TQWLEVDTR	4
CFH	SPPDISHGVVAHMSDSYQYGEEVTYK,SLGNIIMVCRK,CGPPPPIDNGDITSFPLSVYAPASSVEYQCQNLYELEGNK,SLGNIIMVCR	4
MAVS	NPDGGPLESSSDLAALSPLTSSGHQEK,NEETPAAPTPAGATGGSSAWLDSSFENR,ASQGLPGPTGSVVSTGTSFSSSSPGLASAGAAEGK,GCELVDLADEVASVYESYQPR	4
GSTM1	HSLCGETEEEKIR,LGLDFPNGMLGSLLAQLSFPGFPSIQLPYLIDGAHK,LGLDFPNGMLGSLVAQLSFPGFPSIQLPYLIDGTHK,PMTLGYWNIRGLHSRLLEYTDSSYEEK	4
PLBD1	TLHQGMAEVYNFDFITMKPILK,HWDFNIIDKDTSSSR,HWDFNIIDK,TLHQGMAEVYNFDFITMK	4
H1-6	MSETVPAASASAGLAAMEK,SETVPAASASAGLAAMEKLPTK,SETVPAASASAGLAAMEK,LITEAFSVSQER	4
IGHV4-4	QPAGKGLEWIGR,GLEWIGRIYTSGSTNYNPSLK,IYTSGSTNYNPSLKSR,IYTSGSTNYNPSLK	4
APIP	IQPEDMFVYDINEKDISGPSPSKK,IQPEDMFVYDINEK,IQPEDMFVYDINEKDISGPSPSK,ERIQPEDMFVYDINEK	4
A2M	DLTGFPGPLNDQDDEDCINR,EQVPHCICANGR,DLTGFPGPLNDQDDEDCINRHNVYINGITYTPVSSTNEK,SFVHLKPMSHELPCGHTQTVQAHYILNGGTLLGLK	4
MIA3	TSGLAGEPEGELSKEDHGNTEK,RGLVQDETELEDENQEGMTVHSSVHSNNLNSMPAAEK,DSVEGDALVNGAR,GLVQDETELEDENQEGMTVHSSVHSNNLNSMPAAEK	4
HRG	EENDDFASFRVDRTER,PDIQPFPQSVSESCPGK,HPLKPDIQPFPQSVSESCPGK,GPCPFHCR	4
SERPINB10	TYFGAEPQSVNFVEASDQIR,TYFGAEPQSVNFVEASDQIRK,MDALATSINQFALELSKK,MDALATSINQFALELSK	4
ECI2	DFENSINQVK,ASQKDFENSINQVK,AFAKLPPNVLR,LKAFAKLPPNVLR	4
KANK4	LLVNLADR,NGNTALHYSVSHSNFSIAK,LLLAHPACNSSLTDK,ALSQHLPETGTATDQLLR	4
ERAP1	TMMNTWTLQR,MNQADYALDAAVTLLEFYEDYFSIPYPLPK,QTWTDEGSVSEQMLR,SELLLLACVHNYQPCVQR	4
APOB	EVLKESQLPTVMDFR,LNGEIQDLELPQKAEALK,NEVQIHSGSFQSQVELSNDQEK,WKNEVQIHSGSFQSQVELSNDQEK	4
FGL1	QLLQENEVQFLDKGDENTVVDLGSK,QLLQENEVQFLDKGDENTVVDLGSKR,GDENTVVDLGSK,IKQLLQENEVQFLDKGDENTVVDLGSK	4
CLU	ELNESLQVAERLTR,RELNESLQVAER,ELNESLQVAER,EILSVDCSTNHPSQAK	4
HEXB	APSVSAKPGPALWPLPLSVK,WHHEPAEFQAR,GILVDTSR,PGPALWPLPLSVK	4
POF1B	EELGHLQNDLTSLENDKMR,EELGHLQNDLTSLENDK,LVLSTFSNIREELGHLQNDLTSLENDK,LVLSTFSNIREELGHLQNDLTSLENDKMR	4
ALDH5A1	RVYGDIIYTPAKDR,VYGDIIYTPAK,VYGDIIYTPAKDR,RVYGDIIYTPAK	4
DSP	RGQSEADSDKNATILELR,ANSSATETIKK,ANSSATETIK,RGQSEADSDK	4
TRDN	AKEEIGAVSSK,EEIGAVSSK,EEIGAVSSKK,EHSVPSEK	4
TEP1	VAPLVFFHFSGARPDQGLALTLLR,SDFVSESEEAACR,AAGQPGSELLVVTIGLDGATR,TLISITQAKPESESSFLCASSDGMLWNLAK	4
CHGA	EEEEEEEEEEAEAGEEAVPEEEGPTVVLNPHPSLGYK,PSSWEDSLEAGLPLQVR,REEEEEEEEEEAEAGEEAVPEEEGPTVVLNPHPSLGYK,GWRPSSWEDSLEAGLPLQVR	4
C3	VLLDGVQNLRAEDLVGK,KVLLDGVQNLRAEDLVGK,VLLDGVQNLR,KVLLDGVQNLR	4
KRT16	GSCGIGGSIGGGSSR,SEVTELRRVFQGLEIELQSQLSMK,GSGIGGGIGGGSSR,IIVATIENAQPILQIDNAR	4
MPRIP	VAVTSSSSSSSSSSIPSAEK,VAVTSSSSSSSSSSIPSAEKVPTTK,SQVIEKFEALDIEKAEHMETNAVGPSQSSDTR,AEHMETNAVGPSQSSDTR	4
EPHX1	TKIEGLDIHFIHVKPPQLPAGR,IEGLDIHFIHVKPPQLPAGR,KQVEILNRHPHFK,QVEILNRHPHFK	4
PCK1	EEGWLAEHMLVLGITNPEGEKK,LAKEEGWLAEHMLVLGITNPEGEKK,EEGWLAEHMLVLGITNPEGEK,MGTPVLEALGDGEFVK	4
POTEJ	CPQALFQPCFLGMESCGIHETTFNSIMK,EKLCYVALDFEQEMATTASSSSLEK,LCFVALDFEQEMATVASSSSLEK,SYGLPDGQVITIGNER	4
R3HCC1	KQEEWGLTSTSVLKR,IHLDTSSFMEELPGEK,IQWVDDTHALGIFPCR,KQEEWGLTSTSVLK	4
IGKV1-27	LLIYAASALQSGVPSR,LLISAASTLQSGVPSR,ASQGISNFLAWYQQKPGK,ASQGISNFLAWYQQK	4
SWAP70	EQALQEAMEQLEELELER,EQALQEAMEQLEELELERK,VLKEQALQEAMEQLEELELER,VLKEQALQEAMEQLEELELERK	4
ENPEP	TTYTENGR,SIAATDHEPTDAR,TTYTENGRVK,SIAATDHEPTDARK	4
GLOD4	LLDDAMSADK,LLDDAMADDKSDEWFAK,LLDDAMSADKSDEWFAK,LLDDAMADDK	4
AKAP13	GGEKEEGNDGQDLRR,SCEESADAPVDQNSVVIPAAAK,GGEKEEGNDGQDLR,GNTDSSLQSMGK	4
WASHC1	EQEQVRATSQGGDLMSDLFNK,ATSQGGDLMSDLFNK,MQHSLAGQTYAVPLIQPDLRR,MQHSLAGQTYAVPLIQPDLR	4
HDGF	NSTLSEPGSGRGPPQEEEEEEDEEEEATKEDAEAPGIR,NSTLSEPGSGRGPPQEEEEEEDEEEEATK,NSTLSEPGSGR,EAATLEVERPLPMEVEKNSTLSEPGSGR	4
CYP2C9	MEEKHNQPSEFTIESLENTAVDLFGAGTETTSTTLR,YLDLLPTSLPHAVTCDIK,SIEDCVQEEAR,RSIEDCVQEEAR	4
SPINK5	ATSYAELCNEYRK,ENNPIQGPDGK,NAAGHGSSGGGGGNTQDECAEYQEQMK,ATSYAELCNEYR	4
SPEF2	VHCQIVGVQTVER,KDEEDALPVLQEEIK,DLLNTNDYEEYK,LEPTLHLLGVQFDQNVAHGIITEKPGVATK	4
TF	KSVEEYANCHLAR,SMGSKEDLIWELLNQAQEHFGK,SMGSKEDLIWELLNQAQEHFGKDK,SVEEYANCHLAR	4
STEAP2	SLSETCLPNGINGIK,SQFLEEGIGGTIPHVSPER,SLSETCLPNGINGIKDAR,IILFLPCISQK	4
MLPH	ASSESQGLGAGAR,ASSESQIFELNKR,LQGGAGPEPISEER,MALGIAAALGSNVIR	4
ALDH4A1	MEAIPCVVGDEEVWTSDVQYQMSPFNHGHK,GRMEAIPCVVGDEEVWTSDVQYQMSPFNHGHK,ETLQLIDSTTSYGLTGAVFSQDKDVVQEATK,YKETLQLIDSTTSYGLTGAVFSQDKDVVQEATK	4
IGKV4-1	VLIYWASTR,SSQSVLYSSNSK,NYLTWYQQK,SSQSVLYR	4
STING1	LPQQTADR,FLDKLPQQTADR,LFCQTLEDILADAPESQNNCR,FLDKLPQQTGDR	4
PRKDC	LLEEALLCLLPAELPAKR,EEENASVTDSAELQAYPALVVEK,KEEENASVTDSAELQAYPALVVEK,LLEEALLCLLPAELPAK	4
LDB3	DLAVDSASPVYQAVIR,ASGVGLPGGANYQER,VVVNSPANANYQER,VVVNSPANANYQERFNPSALK	4
GH1	AHRLHQLAYDTYQEFEEAYIPKEQK,LHQLAYDTYQEFEEAYIPK,LHQLAYDTYQEFEEAYIPKEQK,AHRLHQLAYDTYQEFEEAYIPK	4
IGHV4-61	QPAGKGLEWIGR,GLEWIGRIYTSGSTNYNPSLK,IYTSGSTNYNPSLKSR,IYTSGSTNYNPSLK	4
PALM	GDSAPAAAKENAAAPSPVR,EIEVLERGDSAPAAAK,GDSAPAAAK,LEKEIEVLERGDSAPAAAK	4
MYO9B	GEPGAEPGHFGVCVDSLTSDK,SLEAPSGQQHR,KGEPGAEPGHFGVCVDSLTSDK,TQAAVYLQAAWR	4
ITPKB	QDSDALPSPELLPQDQDKPFLR,RPEETTVSVQSAESSDALSWSR,QDSDALPSPELLPQDQDK,GTGVQSEGTWESQRQDSDALPSPELLPQDQDK	4
H4C6	LSGLIYEETRGVLK,RLSGLIYEETRGVLK,LSGLIYEETR,RLSGLIYEETR	4
EPS8L1	STTTGPEAAPKPSAK,GFSSGTVDALGVLTGAQLFSLQR,QQSAPEVAVNGHR,QQSAPEVAVNGHRDLEPESEPQLESETAGK	4
PANK4	SLDVLGWEERQLALVK,IAGMDPVVHSALREER,IAGMDPVVHSALR,SLDVLGWEER	4
CHID1	MVWDSQVSEHFFEYKK,MVWDSQVSEHFFEYK,DHRPQMVWDSQVSEHFFEYKK,DHRPQMVWDSQVSEHFFEYK	4
ARHGEF40	LENGLAALSPSSK,RIQQHLGEEASPR,HKLENGLAALSPSSK,IQQHLGEEASPR	4
HLA-A	YFSTSVSR,AHSQIDRVDLGTLR,APWIEQERPEYWDQETR,GYEQHAYDGKDYIALNEDLR	4
PYGB	QEYFVVASTLQDIIR,LKQEYFVVASTLQDIIR,WLLLCNPGLANTIVEK,RWLLLCNPGLANTIVEK	4
EEF1D	AFVEWSQALLLAPEGSR,SGLGPVDLALLGLSAER,RANGEAPSALPYCYFLQK,AFVEWSQALLLAPEGSRR	4
POTEI	CPETLFQPCFLGMESCGIHETTFNSIMK,CPQALFQPCFLGMESCGIHETTFNSIMK,EKLCYVALDFEQEMATTASSSSLEK,LCFVALDFEQEMATVASSSSLEK	4
CMPK1	KMDQTMAANAQK,KNPDSHYGELIEK,NPDSHYGELIEK,KMDQTMAANAQKNK	4
LACTB	YAMAWGVVEK,ENVAFEQEKEGQSNEKNDFTK,YAMAWGVVEKK,ENVAFEQEKEGQSNEK	4
BAG3	QCGQVAAAAAAAQPPASHGPER,IDPQTGWPFFVDHDSR,GMPETTQPDKQR,AAPSTAPAEATLPKPGEAEAPPK	4
KRT13	DAEEWFHAK,QSPGSPERDYSPYYK,QSPGSPER,RDAEEWFHAK	4
MYO7B	LAAQEGQFTEPRPEEPPQEK,TSVAIGGIIK,YLVNFIGQGPATYGPFCAER,KLAAQEGQFTEPRPEEPPQEK	4
CEACAM5	VDGNRQIVGYAIGTQQATPGPAYSGR,QIVGYAIGTQQATPGPAYSGR,NDVGPYECGIQNK,GERVDGNRQIVGYAIGTQQATPGPAYSGR	4
NCOA7	ERPQVSENLQK,KEDFIVQDLEVWAFE,ERPQVSENLQKTELSDGK,EPSDTSAAFESTAK	4
GPLD1	MYALISDAQPLLLSTFSGDRR,VYALISDAQPLLLSTFSGDRR,VYALISDAQPLLLSTFSGDR,MYALISDAQPLLLSTFSGDR	4
WASHC2A	SPYEPPPTGLFDDDDGDDDDDFFSAPHSKPSK,VSLLFEDDVDSR,TNTFPLLEDEDDLFTDQKVK	3
PDPR	DSILLLEDVTWK,LYHQLEQETGIQTGYTR,AVDVLSELSFAPMTPDHFPSLFCK	3
AKAP5	KDGDEVCESNVSNSITSGEK,LLEGEMQPAINAEDADLSK,DGDEVCESNVSNSITSGEK	3
PUS3	DCNDTLEEDNTNLETPTK,EDSNIRENSSGAGK,DCNDTLEEDNTNLETPTKR	3
TRIM5	GHHTFLTEEVAQEYQVK,LQGSVMELLQDVDGVIK,LQGSVMELLQDVDGVIKR	3
TBC1D17	DNDVLLHWAPVEEAGDSTQIIFSK,VVEKDNDVLLHWAPVEEAGDSTQIIFSKK,VVEKDNDVLLHWAPVEEAGDSTQIIFSK	3
VIL1	LYHLSDSEGNLVVR,QVVVEGQEPAKFWMALGGK,ANFLNSNDVFVIK	3
ATXN1	AEQQQQQQQQQQQQQQHQHQQQQQQQQQQQQQQQHLSR,AEQQQQQQQQQQQQHQHQQQQQQQQQQQQQQQQHLSR,AEQQQQQQQQQQQQHQHQQQQQQQQQQQQQQQHLSR	3
BDH2	KQIDQFASEVER,QIDQFASEVER,KKQIDQFASEVER	3
EPB41L3	TESSGIETESTVHHLPLSTEK,METKTESSGIETEPTVHHLPLSTEKVVQETVLVQER,VVQETVLVQER	3
IGHV3-20	AEDTALYYCAR,NSLYLQMNSLRAEDTALYYCAR,LSCAASGFTFDDYGMSWVR	3
C11orf16	ELPELEATAQLLPLEGPK,ELPELEATAQLLPLEGPKEEK,VPLGGLQSVSLTIWK	3
CFHR1	CRSTDTSCVNPPTVQNAYIVSR,CGPPPPIDNGDITSFPLSVYAPASSVEYQCQNLYELEGNK,STDTSCVNPPTVQNAYIVSR	3
TAP1	SGAHSFISGLPQGYDTEVGEAGSQLSGGQQQAVALAR,SGAHSFISGLPQGYDTEVGEAGSQLSGGQR,EAVAYAVNSWTTSISCMLLK	3
GRHPR	NTMSLLAANNLLAGLRGELMPSELK,TRNTMSLLAANNLLAGLRGELMPSELK,IGQAIAQR	3
MPP7	ALFNYNPNEDK,ALFNYNPNEDKAIPCKEAGLSFK,ALFNYNPNEDKAIPCK	3
IGHV3-53	DNSKNTLYLQINSLR,NTLYQMNSLRAEDTAVYYCAR,NTLYLQINSLR	3
RPN2	ISTEVDITNVDLSTVDKDQSIAPK,VKISTEVDITNVDLSTVDKDQSIAPK,NPILWNVADLVIKFPEEEAPSTVLSQNLFTPK	3
PLIN3	QRVQEALLQLSQALSLMETVK,AQEALLQLSQALSLMETVK,QRAQEALLQLSQALSLMETVK	3
PALM2AKAP2	TSRDGAEQQGPEATVEEAEAEAAAFGSEK,AQQEQLLLQQQLQQQQQQPPSQLCTAPASSHER,RAQQEQLLLQQQLQQQQQQPPSQLCTAPASSHER	3
MEGF6	CVCHVGYELGADGR,CSCPPAAACHHVTGACR,CQAECEPGYFGPGCWQACTCPVGVACDSVSGECGK	3
TKFC	LIDAETTAGAWPNVAAVSITGRK,LIDAETTAGAWPNVAAVSITGR,VAGALAEAGVGLEEIAKQVNVVTK	3
PDIA2	PYLLSQEIPPDWDQQPVK,ELAEEFGVTEYPR,EIPPDWDQQPVK	3
HEPACAM	DSPETEESPAPEPR,DKDSPETEESPAPEPR,VLMEDDDLYSCVVENPISQGR	3
ASS1	DGTTHQTSLELFMYLNKVAGK,NPWSMDENLMHISYETGILENPK,EFVEEFIWPAIQSSAPYEDR	3
CBR4	AAAGDLGGDHLAFSCDVAKEHDVQNTFEEMEK,EHDVQNTFEEMEKHLGR,EHDVQNTFEEMEK	3
PSG5	DRDGGMHSDPVTLNVLYGPDLPSIYPSFTYYR,DGGMHSDPVSLNVLYGPDLPSIYPSFTYYR,DRDGGMHSDPVSLNVLYGPDLPSIYPSFTYYR	3
PATJ	VLGLSIVGK,GPGSDSSLFATYNVELVR,ITSNQNQDTQEK	3
ABCC6	TTSQAQTEVPLDDPDR,VLEACALQPDVDSFPEGVHTSIGEQGMNLSGGQK,TTSQAQTEVPLDDPDRAGWPAGK	3
SYN2	RPPPASAPAPQPAPQPAPTPSVGSSFFSSLSQAVK,QTAASAGLVDAPAAAPAAAR,QTAASAGLVDAPAAAPAAARK	3
HSPA4L	NVVFIDMGHSAYQVSVCAFNK,QLGQDLLNSYTENEGK,NVVFIDMGHSAYQVSVCAFNKGK	3
OLFML1	EADECIVSEDKTLAEMLLQEAEEEK,EADECIVSEDKTLAEMLLQEAEEEKK,EADECIVSEDK	3
MRC1	GYEAMYTLLGNANGAICAFPFKFENK,EGSDLASIHTIEEFDFIISQLGYEPNDELWIGLNDIK,GYEAMYTLLGNANGAICAFPFK	3
RSPH3	DIEIGFLPWLTNEVEK,ELLLDGDYLQR,GSTYALQTGPLLGQPDSLELQR	3
COL6A1	CPDYTCPITFSSPADITILLDGSASVGSHNFDTTKHFAKR,CPDYTCPITFSSPADITILLDGSASVGSHNFDTTKHFAK,KCPDYTCPITFSSPADITILLDGSASVGSHNFDTTKHFAK	3
CENPV	SGASGASAAPAASAAAALAPSATRTR,SGASGASAAPAASAAAALAPSATR,RSGASGASAAPAASAAAALAPSATR	3
PRODH	AAEIGYEDPINPTYEATNTMYHR,EQSAAGPAAVPGGGSATAVRPPVPAVDFGNAQEAYR,DAYDNVTLDVELAHR	3
RBM19	AETEKPANQKEPTTCHTTVK,NLPAGTLAAELQETFGHFGSLGR,NLPAGTLAAELQETFGR	3
C17orf80	SDSHFQASHTGCQSPLCSAQR,DSVTGKESQGERPHLSLLIPR,ESQGERPHLSLLIPR	3
MEAK7	VQVLAAQLLSEMK,VQVLAAQLLSEMKLQDGKR,SILDADPEAQALLEISGHLR	3
ECH1	LTGSSAQEAASGVALGEAPDHSYESLRVTSAQK,VIRNQSLVNELAFTAR,LTGSSAQEAASGVALGEAPDHSYESLR	3
ACTN2	KHEAFESDLAAHQDRVEQIAAIAQELNELDYHNAVNVNDR,VEQIAAIAQELNELDYHNAVNVNDR,HEAFESDLAAHQDRVEQIAAIAQELNELDYHNAVNVNDR	3
DMGDH	MIGLEHPLIPVQHQYVVTSTIPEVK,LTPEDLSDDVFK,VGVTDLSPFGK	3
SLC2A9	ELGLVPLTDDTSHARPPGPGR,ADVSQEVEEVLAESHVQR,ADISQEVEEVLAESR	3
HEATR1	LVPDLLAIVQHK,QEIFHQFVSLSTSGGK,NFGAENPDPFVPVLSTAVK	3
NAALADL2	GDQPNTHQLLAMASR,NLVQLYKNEDDTEISKK,NEDDTEISK	3
LAMA1	AGAGAGAGAVLK,ISDISVEVGR,NAVDLVYRAEDHATEFQR	3
PRAM1	APLPEFGAVSLKPPQPQFTDLPK,KFSQPELSEHPQK,FSQPELSEHPQK	3
MKI67	YENESLQSGR,LTQTSGESTHTDKEPVGEGK,SQPAASTLESESVQR	3
FAM83H	VNLHHVDFLR,FLELGPDGHQR,SLENCLLDLR	3
EML2	GRPVPMVIPDELAPTYSLDTR,SHIYFWTLDGGSLSK,SNGGNLLCAVDESNDHMFSVWDWAK	3
XPC	AAASHLFPFEKL,DPSLPVASSSSSSSK,AAASHLFPFEK	3
CELA2B	IVVHKDWNSNQVSK,DWNSNQVSK,LQTNGALPDDLKQGR	3
RPL13	STESLQTNVQRLK,STESLQTNVQR,NKSTESLQTNVQR	3
MINK1	SNSAWQLYLQR,NRVGASSKLDSSPVLSPGNK,LDSSPVLSPGNK	3
CEACAM3	VDGNRQIVGYAIGTQQATPGPAYSGR,QIVGYAIGTQQATPGPAYSGR,GERVDGNRQIVGYAIGTQQATPGPAYSGR	3
IGLV2-14	LMIYDVSNR,LMIYDVSKRPSGVSNR,LMIYDVSNRPSGVSNR	3
CEP170	TNGKPEEKNHEAGTSGCSIDAK,NHEAGTSGCSIDAK,LQSAGSAVPTSSSFK	3
ADH1C	KFSLDALITNVLPFEK,FSLDALITNVLPFEK,SDEHVVSGNLVTPLPVILGHEAAGIVESVEGVTTVKPGDK	3
IGKV1D-39	ASQSISGYLNWYQQRPGK,VTITCRASQSISGYLNWYQQRPGK,ASQSISGYLNWYQQRPGKAPK	3
NAPRT	MKLTENPEK,LTENPEKQTLPGSK,MKLTENPEKQTLPGSK	3
HLA-DPA1	FHYLTFVPSAEDVYDCR,EPVELGQPNTLICHIDR,ETVWHLEEFGR	3
C1orf116	STTQASSHTPGEPGR,ETVSTGYTQPQPPPAGLPQNAR,SMPIPIPK	3
IGHA1	SAVQGPPDR,SAVQGPPDRDLCGCYSVSSVLPGCAEPWNHGK,MAGKPTHVNVSVVMAEVDGTCY	3
TMEM128	FLILPDAEAQLDR,FLILPDAEAQLDREGDAGPETSTAVEK,FLILPDAEAQLDREGDAGPETSTAVEKK	3
SULT1A1	ILEFVGHSLPEETVDFMVQHTSFK,SLPEETVDFMVQHTSFK,KTPMTNYTTVR	3
HDHD3	RLEGILEGLGLR,LAVISNFDRRLEGILEGLGLR,LEGILEGLGLR	3
PGLYRP2	EVAQHDVREGK,EVAQHDVR,WGAAPYQGRPK	3
STK31	IGCSLSEVCPHASSVLGNLDPNK,KMTLDLNDENDAGNLITFPK,MTLDLNDENDAGNLITFPK	3
MYH2	EVTERAENEEEINAELTAK,AENEEEINAELTAK,EVTERAENEEEINAELTAKK	3
FREM2	EGETQHVVEIEVIFDGVR,TDPPSADAGTDYVGISCNLDFAPGVNMQPVR,IIMATDLDSEDK	3
WDR1	FKFTVGDHSR,FTVGDHSR,LATGSDDNCAAFFEGPPFKFKFTVGDHSR	3
EFHB	ISILANTLINPQPITTFQQK,TVMQRGSLGVDSVSASQVTK,GMDTINTTFGTAVIK	3
IGHV3-38	NTLYLQMKSLRAEGTAVYYCAR,DNSKNTLYLQMK,NTLYLQMK	3
CKAP4	KPPPAPQQPPPPAPHPQQHPQQHPQNQAHGK,EAADTERLTLQALTEK,LTLQALTEK	3
PON1	SLDFNTLVDNLSVDPETGDLWVGCHPNGMK,GIETGSEDMEILPNGLAFISSGLKYPGIK,GIETGSEDMEILPNGLAFISSGLK	3
FBN2	GVTCEDVNECEVFPGICPNGR,SIHQPDPTAVEQISLESVDMDSPVNMK,IKGVTCEDVNECEVFPGICPNGR	3
OTC	LLLTNDPLEAAHGGNVLITDTWISMGREEEKK,LLLTNDPLEAAHGGNVLITDTWISMGREEEK,DLLTLRNFTGEEIK	3
ZG16	SSSYSGEYGSGGGKR,SSSYSGEYGSGGGK,SGSLIDAIGLHWDVYPTSCSR	3
EVPL	LNSEQSQALQHQQETGHSLK,FQEEADSVSQTLVK,NPPQQPLHVDSICDWDSGEVQLLRGER	3
ACACB	HNQVESIFLSAIDMYGHEFCPENLK,HNQVESIFLSAIDMYGHEFCPENLKK,TAQAIKDFNR	3
AK1	IGQPTLLLYVDAGPQTMTQR,EVQQGEEFERRIGQPTLLLYVDAGPQTMTQR,RIGQPTLLLYVDAGPQTMTQR	3
CLIC6	VGDSVEAGDPAGDGVEAEGPAGDSMDAEGPAGR,RVSGEPQESGDGSLSPQAEAIEVAAGESAGR,VSGEPQESGDGSLSPQAEAIEVAAGESAGR	3
FMO3	NNLPTAISDWLYMK,KSFPGLNHFK,GVFPPLLQK	3
GHDC	DKLDHCLQEASPCYK,LDHCLQEASPCYK,LDHCLQEASPHYK	3
CLIP1	EENSGLLQELEELRKQAEK,MSGDNPSQLTK,SEQELAEMIEEK	3
POTEF	CPEALFQPCFLGMESCGIHDTTFNSIMK,CPKALFQPCFLGMESCGIHETTFNSIMK,YPMEHGITNWDDMEK	3
ACAT2	AGHFDKEIVPVLVSTRR,EIVPVLVSTRR,RGLIEVKTDEFPR	3
PLXNB2	SSGGPGAGLCLFPLDEVHAK,LHVTLYDCSFGR,ITVLGSNLGVQAGDIQR	3
PSMD13	DVPGFLQQSQSSGPGQPAVWHR,MKDVPGFLQQSQSSGPGQPAVWHR,DVPGFLQQSQSSGPGQPAVWHRLEELYTK	3
HMCN1	SALIGCLSSGSPAPR,DGHLLNVDQNQNSYR,NSVSLTCEASGIPLPSTTWFK	3
AKAP9	ISSSSQTPQILVK,DKPELEVVLTEDALKSLENQTYFR,AVHNEGMQVLSLTESPYSDGEDHSIQQVSESWLEER	3
VPS8	KGTSEPVLDPQQTQAFDQLCR,LSSSAIPHLYSEALK,GTSEPVLDPQQTQAFDQLCR	3
TAPBPL	VAKNEVLWHPTLNLPLSPQGTVR,NEVLWHPTLNLPLSPQGTVR,AVDVVLDCFLVK	3
TINAG	EIMQNGPVQAIMQVHEDFFHYK,EKFWLAANSWGK,CSQHVCLVRPELIEQVNK	3
PRKCSH	YRSEALPTDLPTPSAPDLTEPK,EEQPPVPSSPTEEEEEEEEEEEAEEEEEEEDSEVQGEQPK,SEALPTDLPTPSAPDLTEPK	3
CPS1	VLGTSVESIMASEDR,AVNTLNEALEFTK,QAFITAQNHGYALDNALPAGWK	3
C4A	TLDIPGNSDPNMIPDGDFNSYVR,RGHVFLQTDQPIYNPGQR,GHVFLQTDQPIYNPGQR	3
RIN3	RDFHFVYRPLDGGGGGGGSPPCLVVR,DFHFVYRPLDGGGGGGGSPPCLVVR,APGFPLVSSLRPTAR	3
CAND2	VLAFLSLAEVGQVAGPGPQRELK,SPHSSTGVKVLAFLSLAEVGQVAGPGPQR,VLAFLSLAEVGQVAGPGPQR	3
AOC3	TIHDAFCVFEQNQGLPLRR,TIHDAFCVFEQNQGLPLR,HGGPLPYYR	3
CEBPZ	ASLIEEDEPAEKENSSKK,ASLIEEDEPAEK,ASLIEEDEPAEKENSSK	3
GLRX5	KLGIHSTLLDEK,LGIHSTLLDEKK,LGIHSTLLDEK	3
TRAP1	GVVDSEEIPLNLSR,DVGEWQHEEFYR,AMVGHLNELLVK	3
TGM3	AALGVQSINWQK,NWNGSVEILK,EEYVQEDAGILFVGSTNR	3
AP3B1	FIRQLIVPNEK,QLIVPNEK,KEQGVLTGMNETSVIIAAPQNFTPSVIFQK	3
HEXA	DFYVVEPLAFEGTPEQK,EDIPVDYMK,ISYGPDWKDFYVVEPLAFEGTPEQK	3
ARHGAP45	ECVLHDDLLEAR,AEEEQAGSAPGAGGTATK,LKECVLHDDLLEAR	3
ERICH3	EKQQHMVQGESETADVSPNNMQV,FRPTTAANGLEPLLTK,QQHMVQGESETADVSPNNMQV	3
DPP3	LEGSDVQLLEYK,LIVQPNTHLEGSDVQLLEYEASAAGLIR,KLIVQPNTHLEGSDVQLLEYEASAAGLIR	3
ITGA8	LPEGSIAIK,KMPYTDQPAKLPEGSIAIK,LPEGSVAIK	3
ASMTL	HDPIPAADTFEDLSDVEGGGSEPTQR,SVKHDPIPAADTFEDLSDVEGGGSEPTQR,FSSACDMGGCTGALAR	3
PNPT1	REVGTSDKEILTSR,EVGTSDKEILTSR,EILQIMDK	3
RIOX2	IGRPVHEFMLQPGDLLYFPR,LQFKDHIVLTVLPDQDQSDETQEK,DHIVLTVLPDQDQSDETQEK	3
OPLAH	SDGGLAPMDTFSGSR,YAGEFEHVFEASTAGITLQAPQLDINTVAAGGGSR,GGTFTDVFAQCPGGHVQVLK	3
IFITM2	EEQEVAMLGAPHNPAPPMSTVIHIR,MLKEEQEVAMLGAPHNPAPPTSTVIHIR,EEQEVAMLGAPHNPAPPTSTVIHIR	3
DPP7	APDPGFQERFFQQRLDHFNFQR,FFQQRLDHFNFQR,LDHFNFQR	3
CALCOCO2	QNPGLAYGNPYSGIQESSSASPLSIKK,GASIPFQFRPENEEDILVVTTQEEVEEIEQHNK,QNPGLAYGNPYSGIQESSSASPLSIK	3
CPOX	QWWFGGGCDLTPTYLNQEDAIHFHR,GIGGIFFDDLDSPSKEEVFCFVQSCAR,YFEVEEADGHK	3
KRT2	GGGFGGGSGFGGGSGFSGGGFGGGGFGGGR,WELLQQMNVDTRPINLEPIFQGYIDSLK,WELLQQMNVDTRPINLEPIFQGYIDSLKR	3
ADAR	RNTNSVPETAPAAIPETRR,NTNSVPETAPAAIPETR,RNTNSVPETAPAAIPETR	3
LRRK2	KTLINESLNFK,KNVSIEFPVIDR,TLINESLNFK	3
FHL5	DDYPFCMDCYNHLYANK,DLCEEQFMSGDDYPFCVDCYNHLYANK,DLCEEQFMSRDDYPFCMDCYNHLYANK	3
MUC12	QHPALPQHQASVQNLPSFTVAPDHQTK,SEESTASHSSQETTGTIVLPAR,SPDATLSPATTTSSGVSK	3
PIR	IEPHHTAVLGEGDSVQVENKNPK,IEPHHTAVLGEGDSVQVENKNPKR,IEPHHTAVLGEGDSVQAENKDPK	3
A2ML1	SHEYQLESWADSQTSSCLCADEAK,YATTAYVPSEEINLVVK,DVDDPMVSQGLWCLK	3
CYBA	KPSEEEAAAAAGGPPGGPQVNPIPVTDEVV,PSEEEAAAAAGGPPGGPQVNPIPVTDEVV,KKPSEEEAAAAAGGPPGGPQVNPIPVTDEVV	3
IGLV2-18	LMIYDVSNRPSGVPDR,LMIYDVSNR,LMIYDVSNRPSGVPDRFSGSK	3
LUZP1	VGDTITVAAWNHSASMEEEGEDCTLNVYR,NRPETVVSR,KTEDRFVPSSSK	3
SRP14	KTKAAAAAAAAAPAAAATAATTAATTAATAAQ,TKAAAAAAAAAPAAAATAATTAATTAATAAQ,AAAAAAAAAPAAAATAATTAATTAATAAQ	3
MYBBP1A	DPAEPMSPGEATQSGARPADR,KSEDGTPAEDGTPAATGGSQPPSLGR,SEDGTPAEDGTPAATGGSQPPSLGR	3
RPL8	AQLNVGNVLPVGTMPEGTIVCCLEEKPGDR,AQLNVGNVLPVGTMPEGTIVCCLEEK,AQLNVGNVLPVGTMPEGTIVCCLEEKPGDRGK	3
IGKV3-11	LLIYDASVR,ASQSVSGYLAWYQQR,ASQSVSGYLAWYQQRPGQAPR	3
LGALS8	VAVNGVHSLQYK,FQVDLQNGSSVKPR,SGTPQLSLPFAAR	3
IVL	QPELPEQQMGKLK,EQLLELPEQEEGHLK,QLELPEQQEGQLK	3
COL15A1	VIWHGSSPHGIR,DLMTDPSWPQK,SSQALAFESSAGIFVGNAGATGLER	3
MATN2	MVQQPTESEPVTINIQDLLSCSNFAVQHR,DVCQAIDHGCEHICVNSDNSYTCECLEGFR,MVQQPTVQHR	3
ICAM1	EVTVNVLSPR,VLEVDTQGTVVCSLDR,VTLNGVPAQPLGLR	3
CES1	LGTWGFFSTGDEHSPGNWGHLDQVAALR,FTPPQPAEPWNFVK,KGDVKPLAEQISITAGCK	3
NMI	EHLPDEFIKDEQNK,EHLPDEFIK,EHLPDEFIKDEQNKGLIDEITK	3
IFITM1	EEHEVAVLGAPPSTILPR,PLPLPQGLR,MHKEEHEVAVLGAPPSTILPR	3
KRT20	QIEELRNQIK,QIEELRNQIKDAQLQNAR,NQIKDAQLQNAR	3
STEAP4	KSDIIIIAIHR,SDIIIIAIHR,INQYPESNAEYLTHLVPGAHVVK	3
PGM2L1	DITTGYDSSQPNKK,AENTEGDLNSNLPHAPYHTGDPQLDTAIGQWLR,DITTGYDSSQPNK	3
MTMR6	AVMDAAVFLAK,TIEGSSPADNRYSEYTEEFSK,YSEYTEEFSK	3
PRAG1	DSAASHQTEPEAYER,QKPGSTPNLQQK,KFDEFQTGILLYELLHQPNPFEVR	3
ESYT2	RQDLEVEVRDEQHQCPLGNLK,DEQHQCPLGNLK,FQLGNSGPNSTIK	3
TNS3	QQQMVVAHHYSFAPDGEAR,DKPLWPVILSPTMEEGHGLDLTYITER,NQDPNPPPQPEELTSSLHTFK	3
AKR1A1	HIDCAAIYGSEPEIGEALKEDVGPGK,HIDCAAIYGSEPEIGEALK,HIDCAAIYGSEPEIGEALKEDVGPGKAVPR	3
WASHC4	KLGITPEGQSYLDQFR,AVETLSPDWEFDRVDNGSQK,LGITPEGQSYLDQFR	3
PDLIM1	TAASGVEASSR,TAASGVEASSRPLDHAQPPSSLVIDK,TAASGVEASSRPLDHAQPPSSLVIDKESEVYK	3
IGHV3-23	LSCAASGFTFSNYALSWVR,LSCAASGFTFSSYGMSWVR,DNSQNTVFLQMNSLR	3
NCOR2	RGKSQQQQQQQQQQQQQQQQQQPMPR,SILTSTTTVEHAPIWRPGTEQSSGSSGSSGGGGGSSSR,SQQQQQQQQQQQQQQQQQQPMPR	3
UMPS	GSDVIIVGR,RGSDVIIVGR,FIQENVFVAANHNASPLSIK	3
FMN1	SPDHSPTEQDDRTPGR,SPSVVLSEPSQESK,SNSKPADGPSDSKSPDHSPTEQDDR	3
SDR39U1	WNETFQKEVLGSRLETTQLLAK,WNETFQKEVLGSR,AIMLLEGQKVIPR	3
IGHV2-70D	IDWGDDQFYSTSLK,NQVVLTMTNMDPVDTVSYCCARI,ESGPALVKPTQTLTLTCTFSGFSLNTSAMR	3
HAAO	VMFVGGPNSR,VMFVGGPNTR,VMFVGGPNTRK	3
SYNC	QQDVAQFADFQEVLTTR,AEQSPSVEENLSIEDLELLEGR,SNPEESLRAEQSPSVEENLSIEDLELLEGR	3
PFAS	GAHVVAGTAGYCFGNLHIPGYNLPWEDLSFQYPGNFAR,SPVLHFYVRPSGHEGAASGHTR,RNGQGDAPPTPPPTPVDLELEWVLGK	3
AGXT2	GAYHGCSPYTLGLTNVGIYK,IAPSMCITKPEVDFALEVFR,REVDFAVEVFR	3
LRP1	GVGGAPPTVILLR,NPHCTSPEHK,QWECDGENDCHDQSDEAPKNPHCTSPEHK	3
ACAA1	GCFQAEIVPVTTTVQDDKGTKR,GCFQAEIVPVTTTVQDDK,GCFQAEIVPVTTTVQDDKGTK	3
PLA2G4C	WEWGTPHNFLYK,SENYSLTDFWAYMVVSK,IEPDEAPVVAVLGSGGGLR	3
TFRC	LDSTDFTSTIK,LSEKLDSTDFTSTIK,KLSEKLDSTDFTSTIK	3
PLXND1	GPLQPMAGTCPAPEIR,YTLNEEWLLR,EDLGHLCVWSDGCR	3
EMC1	NEVQKTSNSEDGSMGSFSEK,TSSSEDGSMGSFSEK,TSNSEDGSMGSFSEK	3
CAST	KAEPELDLR,TEESKAAAPAPVSEAVSR,AAAPAPVSEAVSR	3
VPS13C	WNYIASSECLPFWPENLSGK,GEPLHIVNSSNVTDEPLLK,LENVIVTDVDPK	3
IGLV1-51	LLIYENNKR,LLIYENNKRPSGIPDR,LLIYENNK	3
FABP1	TVVQLEGDNKLVTAFKNIK,VKTVVQLEGDNKLVTAFK,TVVQLEGDNKLVTAFK	3
HTT	DGDSNSTLEEHSEGK,LRDGDSNSTLEEHSEGK,VGALHGILYVLECDLLDDTAK	3
HLA-DPB1	EEYARFDSDVGEFR,ATPENYVHQLR,YIYNRQEYAR	3
CRIP1	PYCNHPCYVAMFGPK,TLTSGGHAEHEGKPYCNHPCYVAMFGPK,CGKTLTSGGHAEHEGKPYCNHPCYVAMFGPK	3
SEPTIN11	LTIVDTVGFGDQLNKDDSYKPIVEYIDAQFEAYLQEELK,LTIVDTVGFGDQLNK,LKLTIVDTVGFGDQLNK	3
PALM3	KAEESMGIGSEEKPGR,QRLEVIADK,AEESMGIGSEEKPGR	3
CST1	QQTVVGVNYFFDVEVGR,QQTVAGVNYFFDVEVGR,IILGGIYNADLNDEWVQR	3
KTN1	LQALANEQAAAAHQLEK,QTEDSLASERNRLTSK,AEVQKLQALANEQAAAAHQLEK	3
LHB	DHPLTCDHPQLSGLFL,STSDCGGPKDHPLTCDHPQLSGLFL,RSTSDCGGPKDHPLTCDHPQLSGLFL	3
DENND2B	TFEYEAEKNPK,RTFEYEAEKNPK,RTFEYEAEK	3
KANK3	SEGALQVLYGEVGSLDGTPQTR,ELELLHASLEHQR,QEEDMAVVQR	3
PIEZO1	ESDQHVVPTAPDTEADNCIVHELTGQSSLLR,DPGLEPGPDSPGGSSPLR,VGPTDGTPESQVELRPR	3
IGLV3-21	SVHWYQQKPGQAPVLVIYYDSDRPSGIPER,PGQAPVLVIYYDSDRPSGIPER,PGQAPVLVIYDDSDRPSGIPER	3
APOBR	IVEAEAQEDLEGLRGSQNEGAGR,QAQVLGTERTEEAAESQTAGR,QAQVLGTER	3
CAVIN3	ESALEPGPVPEAPAGGPVHAVTVVTLLEK,MRESALEPGPVPEAPAGGPVHAVTVVTLLEK,APEPLGPADQSELGPEQPEAEVGESSDEEPVESR	3
PDCD6IP	DLQQSIAREPSAPSIPTPAYQSLPAGGHAPTPPTPAPR,EPSAPSIPTPAYQSLPAGGHAPTPPTPAPR,TMQGSEVVSVLK	3
EIF3J	ETFGVNNTVYGIDAMNPSSRDDFTEFGK,ETFGVNNTVYGIDAMNPSSR,AAAASAAGDSDSWDADAFSVEDPVRK	3
SORD	VEGLLGCKPEVTIECTGAEASIQAGIYATR,KVEGLLGCKPEVTIECTGAEASIQAGIYATR,SGGTLVLVGLGSEMTTVPLLHAAIR	3
ADH1B	MVAVGICR,IKMVAVGICR,SIHTVLTF	3
UGT2B15	LEVYPTSLTKNDLEDSLLK,NDLEDSLLK,SSAIKLEVYPTSLTKNDLEDSLLK	3
DMKN	QVPGFGAADALGNR,ADQNYNYNQHAYPTAYGGK,VSDALGQGTR	3
CPT2	DGSTAIHFEHSWGDGVAVLR,ALEDVFDALEGKSIKS,ALEDVFDALEGK	3
HSD17B4	IDVVVNNAGILRDHSFAR,LSGDRNPLHIDPNFASLAGFDKPILHGLCTFGFSAR,TALDAFGRIDVVVNNAGILRDHSFAR	3
PAPLN	SYGGDSTGGTPR,SYGGDSTGGRPR,ARDEGSYMCSAYQGSQAVSR	3
CDH11	FPQSVYQISVSEAAVPGEEVGR,VTITLTDVNDNPPKFPQSVYQISVSEAAVPGEEVGR,VMITLTDVNDNPPK	3
OGFR	EGTPGSPSETPGPR,TPSETPGPSPAGPTR,DADAGDEDEESQEPR	3
MDN1	LVASELHTSLYSSMVGADR,FTFAATRPSSVLVEQLAVCVSK,ALRETLLAQPAAGQATIPEWCQGSAPSGLEGELLR	3
WASHC2C	LAAQESSEAEDMSIPR,RLAAQESSEAEDMSIPR,GLFDDEDEESDLFMEAPQDR	3
ACTN3	DQTLQEALAR,LVPSRDQTLQEELAR,RNGMMEPDDFR	3
TTC38	DGLEFMQHSETLWK,HSDHILLFNDAHFLMASLGAHDPQTTQELLTTLR,AEIKDGLEFMQHSETLWK	3
SLC44A2	GVAEVLRDGDCPAVLIPSKPLAR,QFCVPGFKNNKGVAEVLR,GVAEVLRDGDCPAVLIPSK	3
ELP2	TSDPALCPLIVSAAADSAVR,RTSDPALCPLIVSAAADSAVR,DGVLQQPMR	3
CYP1B1	QLGSAPPGPFAWPLIGNAAAVGQAAHLSFAR,FLDKDGLISK,DTVVFVNQWSVNHDPVK	3
TDRP	GRVLLDEPPEEEDGLRGGPPPAAAAQAQVQGASFR,GGPPPAAAAQAQVQGASFR,VLLDEPPEEEDGLRGGPPPAAAAQAQVQGASFR	3
ARVCF	AGPLGLGPGDGCFTLPGHR,DVIPMDALGPDGYSTVDQR,GGGPAATLSR	3
PIGR	GVAGSSVAVLCPYNRK,GVAGSSVAVLCPYNR,YLCGAHSDGQLQEGSPIQAWQLFINEESTIPR	3
POLR1A	FLEENADPSASEIR,LPEEVATPTTDEEEDSLIAIDR,FLEENADPSASEIREELEQYTTEIVQNNLLGSQGAHVK	3
CYBRD1	SDSELNNEVAARK,SDSELNNEVAAR,GSMPAYSGNNMDKSDSELNNEVAAR	3
GOLGA1	LEQNLSGEEHVQELLK,RLEQNLSGEEHVQELLK,RLEQNLSGEEHVQELLKEK	3
POSTN	LLQEDTPMR,FIEGGDGHLSEDEEIKR,FIEGGDGHLSEDEEIK	3
NEFH	SEKETVIVEEQTEK,HHQEEVGELLGQIQGSSAAQAQMQAETR,ETVIVEEQTEK	3
NACAD	EVPEAPPAACPEVSQAR,GLQAQEGTVSWAVEAAPQTSDR,GLQAQEGTVSWAVEAAPQTSDRGAYLSQR	3
ANKLE2	LSSFYYHEAGVTALSQDPQR,ILKPAEGNPTDEAGFSEDRDFGYSVGLNPPEEEAVTSK,FGNANVVNVLSSHHLIVK	3
IGHV1-69	ASGGTFSSYTISWVR,IIPILGIANYAQK,QAPGQGLEWMGR	3
GOLGA4	DLHQEAETYR,EKIESLTEVHR,QHEDQSMTGHLQEELEEK	3
RBP5	HWLEGELLYLELTAR,NMENYLQALNISLAVR,NYTVQFDVGVQFEEDLR	3
MUC16	DSSAMAVDAICTHRPDPEDLGLDR,KQLYWELSQLTHGIK,VDLLCTYLQPFSGPGLPIK	3
ALDH1B1	LLNLLADLVER,LLNLLADLVERDR,EAGFPPGVVNIITGYGPTAGAAIAQHMDVDK	3
NIPSNAP3B	LEKPPKEGVYELAVFQMEPGGPALWGDAFER,VVGVFHTEYGK,EGVYELAVFQMKPGGPGLWGDAFER	3
AFM	LKHELTDEELKSLFTNFANVVDK,HELTDEELKSLFTNFANVVDK,ETLLNHFLYEVAR	3
C4B	VQQLDCREPFLSCCQFAESLRK,RGHVFLQTDQPIYNPGQR,GHVFLQTDQPIYNPGQR	3
TGM4	DITYQYKYPEGSSEER,WTGTAPILQQYYNTK,RDITYQYKYPEGSSEER	3
CMYA5	EEIPTDSSLVTPVDRPVLTK,NKPAVEVASTAQGDFPSEK,CTLHLGIEPLDSVR	3
BCAS1	MLDAQVQTDPVSIGPVGKPK,GDGGITHSEEINGKDSSCHTSDSTEK,VEDQENEPEAETYK	3
GLRX3	AAGAAEAAVAAVEEVGSAGHFEELLR,HASSGSFLSSANEHLKEDLNLR,HASSGSFLSSANEHLK	3
IGHV4-39	LNSVTAADTALYYCAR,GLEWIGSIHYR,VTISVDTSKNQFSLR	3
ALDH1A2	RIVGSPFDPTTEQGPQIDKK,IVGSPFDPTTEQGPQIDK,IVGSPFDPTTEQGPQIDKK	3
FAM171B	AELSRSDLSLIQQQQQQQQQQQQQQQQK,SDLSLIQQQQQQQQQQQQQQQQK,AELSRSDLSLIQQQQQQQQQQQQQQQK	3
AKR1C3	MDSKQQCVK,VIFDIVDLYTTWEAMEK,RGDIFYTSK	3
LGALS2	ITGSIANGTDGFVINLGQGTDK,ITGSIANGTDGFVINLGQGTDKLNLHFNPR	2
TPPP	RLSLESEGAAEGAAASPELSALEEAFRR,LSLESEGAAEGAAASPELSALEEAFRR	2
CEP120	KDGPHGSVLEEGLDDYLTHLIEER,DGPHGSVLEEGLDDYLTHLIEER	2
UTRN	LVSELDDANLQVENVRDQALILMNSR,IAAHPSVQK	2
ITIH3	EHLVQAMPENLQEAR,ILEDMKEEDYLNFILFSGDVSTWK	2
ACSL5	ADIAVVICDTPQK,KPVPPSPENLSVICFTSGTTGDPK	2
DCAF8	VHDRSEEEEEEEEEQPR,SSCQIVQFMEGDKGGVVNCLEPHPHLPVLATSGLDHDVK	2
KIF13B	TAMVATVSPAANNYDETLSTLR,IIWDLREEVEK	2
SDCBP2	NGLLTNHYVCEVDGQNVIR,GSSAACNGLLTNHYVCEVDGQNVIGLK	2
CRNN	AHQTGQTVTGSGTQTQAGATQTVEQDSSHQTGR,WMQVSNPEAGETVLGGQAQTGASTESGR	2
GTF3C3	SQDKDVSEGETSDGVR,DVSEGETSDGVRK	2
MT1E	SCCSCCPVDCAK,KSCCSCCPVDCAK	2
ANXA8	ILVCLLQGSRDDVSSFVDPALALQDAQNLYAAGEK,DDVSSFVDPALALQDAQNLYAAGEK	2
AP5B1	ELESCKPGLLGGSLVLLR,VGAGLGGLFTDK	2
COL1A1	SGDRGETGPAGPTGPVGPVGAR,GETGPAGPTGPVGPVGAR	2
FCRL5	GSLPILYQFHHEDAALER,AATMPHSVISDSPR	2
SIGLEC1	CQLSMANHR,FAAITLTQAGAYHCQAQAPGSATTSLAVPISLHVSYAPR	2
MIA2	NLQTQQASLQSENTHFENENQK,NLQTQQASLQSENTHFENENQKLQQK	2
CEP131	GPLEELLHTLQLLEKEPDALPRPR,ANNAGGGLPAAGPGDR	2
COL14A1	TLTYFNYDQSGDFQTLTFEGPEIRK,TLTYFNYDQSGDFQTLTFEGPEIR	2
SUCLA2	SFQGPVLIGSSHGGVNIEDVAAETPEAIIKEPIDIEEGIK,SFQGPVLIGSSHGGVNIEDVAAETPEAIIK	2
DDRGK1	GRVSIAELAQASNSLITWGR,VSIAELAQASNSLITWGR	2
SOD3	DDDGTLHAACQVQPSATLDAAQPR,RDDDGTLHAACQVQPSATLDAAQPR	2
KANK1	DAAVGTLVQMR,EIELQQQTIEALK	2
EML1	CSNEAVFAVDFHPTDTNIIVTCGK,PQFLTCGHDK	2
ATG7	RDVEQLEQLIESHDVAFLLMDTR,DVEQLEQLIESHDVAFLLMDTR	2
MYO7A	GDFPTDCVYVMPTVTMPPR,SGQEFDVPIGAVVK	2
CCDC124	VLQEGSVEAR,RVLQEGSVEAR	2
MAP1S	TLACVCALLVWHPAGPGEK,VLFPGCTPPAYLLDGLVR	2
NUDT6	SVLSIQQQHTNPGAFGK,FIAPAASLGFR	2
COQ8B	VGQMLSIQDNSFISPQLQR,GAALKVGQMLSIQDNSFISPQLQR	2
WDR44	TPDIDVPKENITSDSLLTTSMASESTVK,ENITSDSLLTTSMASESTVK	2
CEL	AMTAYWTNFAK,LGAVYTEGGFVEGINK	2
MICAL3	QEDKDLEAAMLSK,ERQEDKDLEAAMLSK	2
GPRIN2	EVGAGGCCHALPATGILAFPK,AVATSPSLEAPAALHVFPEVTLGSSLEEAPSPVR	2
DSC3	VLNDGTVYTAR,GVDQEPLNLFYIER	2
GGT5	SPSSMVPSVLINK,VNVYHHLVETLKFAR	2
PPIAL4C	HTGSGILSMVNAGPNTNGSQFFICTAK,KHTGSGILSMVNAGPNTNGSQFFICTAK	2
PPIAL4E	HTGSGILSMVNAGPNTNGSQFFICTAK,KHTGSGILSMVNAGPNTNGSQFFICTAK	2
PPIAL4H	HTGSGILSMVNAGPNTNGSQFFICTAK,KHTGSGILSMVNAGPNTNGSQFFICTAK	2
PPIAL4F	HTGSGILSMVNAGPNTNGSQFFICTAK,KHTGSGILSMVNAGPNTNGSQFFICTAK	2
PAPSS1	DPAGMPHPQTGKDLYEPSHGAK,DPAGMPHPQTGK	2
ELP1	VFLENVETFIK,DPDGNKLDLVCDAMR	2
TUBAL3	SLFHPEQLLSRKEDAANNYAR,LDHKFDLMYSK	2
GSDMA	GHEVNLEALPK,ALETLQER	2
MTAP	IKNVDCILLAR,NVDCILLAR	2
CD163	GFGHIWLDSVSCQGHEPAVWQCK,GPDMLWQCPSSPWEK	2
NDUFC1	QHNEDILQYK,QHNEDILQYKR	2
TRARG1	TLSGPLDLEQNGQGLPFK,AHPVQSEFPSAQEPGSAASLDLPEMEILLTK	2
F5	LLSLGAGEFR,MRPWEDPPSDLLLLK	2
IGLV2-23	LMIYDVSKRPSGVSNR,LMIYEVSKRPSGVSNR	2
CARS2	LVGVVPGPVEEPADSDK,SSTTSTWELLDPR	2
PPA2	ALLMKNCNGGAINCTNVQISDSPFR,NCNGGAINCTNVQISDSPFR	2
SAA2	LTGHGAEDSLADQAANK,LTGHGAEDSLADQAANKWGR	2
ITGAM	LACESASSTEVSGVLK,QNTGTWESNANVK	2
IGKV2-30	SSQSLVHSDGNTYLNWFQQRPGQSPR,SSQSLVHSDGNTYLNWFQQR	2
IGKV2D-30	SSQSLVHSDGNTYLNWFQQRPGQSPR,SSQSLVHSDGNTYLNWFQQR	2
CALU	IDVDKDGFVTEGELK,LGMIVDKIDVDKDGFVTEGELK	2
GSPT1	GPAAPPPPAGGAANNHGAGSGAGGR,CPAAPPPPAGGAANNHGAGSGAGGR	2
CBR3	TMEEGAETPVYLALLPPDATEPQGQLVHDK,DSIRTMEEGAETPVYLALLPPDATEPQGQLVHDK	2
PSMD2	EWQELDDTEK,EWQELDDTEKVQR	2
KLKB1	ITQQMVCAGYK,LCNTGDNAVCTTK	2
DDC	GKEMVDYVANYMEGIEGR,EMVDYVANYMEGIEGR	2
IGLV6-57	PGSSPTTVIYEDNQRPSGVPDR,TVTISCTR	2
CTBP2	SSSFSHRSELLHGDLASLGAAAPPQTASPR,SSSFSHRSELLHGDLASLGAAALQPQPAAPPQTASPR	2
CGAS	GAPMDPNESPAAPEAALPK,ENHLSQFLEGEILSASK	2
COPRS	GAPPSPEAGFATADHSGQERETEK,GAPPSPEAGFATADHSGQER	2
BHMT	LMKEGLEAAQLK,EGLEAAQLK	2
MAN2B2	VTQEFLEYHVNR,DMYATHLASGMLGVR	2
PLVAP	SQLMMPVSRPMGPVPNPQPIDPASLEEFK,TKSQLMMPVSRPMGPVPNPQPIDPASLEEFK	2
DAB2	DISNDAFTALDPLGDK,DISNDAFTALDPLGDKEIK	2
CPN2	WLNVQLSPR,LTMSIEAR	2
OGDH	LLDTAFDLDIFK,LLDTAFDLDIFKNFS	2
FASTKD1	WIQHDHVYLDNMTAK,ITQQLTFLHFQR	2
PBXIP1	LQGLEADCVRGPDGVCLSGDRGPQGDK,GPDGVCLSGDRGPQGDK	2
LRG1	TLDLGKNQLETLPPDLLR,NALTGLPSGLFQASATLDTLVLK	2
CAPG	MQYAPNTQVEILPQGRESPIFK,MQYAPNTQVEILPQGR	2
CLEC3B	GGTLSTPQTGSENDALYEYLR,TFHEASEDCISRGGTLSTPQTGSENDALYEYLR	2
SACM1L	LEEQDEFEKIFK,LGVLHVGQKLEEQDEFEKIFK	2
HBB	MVHLTPVEKSAVTALWGKVNVDEVGGEALGR,MVHLTPKEKSAVTALWGK	2
IRAK4	MNDADSTSVETMYSVASQCLHEK,LAAMVDITTEELKQQFNQEIK	2
PHIP	RSGEAGISNTSR,SGEAGISNTSR	2
HGD	CPGSLPEGQNNPQVCPYNLYAEQLSGSSFTCPR,PFESIDEGHVTHNWDEVDPDPNQLR	2
BCL2L15	NVIAETIKGQTGAILQNTVESLSK,GQTGAILQNTVESLSK	2
SUN1	QVTSSGVSYGGTVSLQDAVTR,TISAVGEQLLPTVK	2
IGKV1-8	ITQSPSSLSASTGDR,MTQSPSSLSASTGDR	2
QPRT	QAADFALK,YGLLVGGAVSHR	2
C1RL	VQNHCQEPYYQATAAGALTCATPGTWK,WILTAAHTVYPK	2
FBLN2	GYHASDDGAK,GCIDMNECWASPGR	2
COQ5	AQQNLSWEEITKEYQNEEDSLGGSR,AQQNLSWEEITK	2
DDX58	AAGFEEIEQDLTQRFEEK,AAGFEEIEQDLTQR	2
WASH6P	EQEQVRATSQGGDLMSDLFNK,ATSQGGDLMSDLFNK	2
DNAJC11	NLDKNTMGYLQWR,NTMGYLQWR	2
MCUR1	MQQEIAFQQVMSQIANVKK,MQQEIAFQQVMSQIANVK	2
PCLO	IIEDDEKPVDLTAGRR,IIEDDEKPVDLTAGR	2
FAM20C	PSGEPGCSCAQPAAKVAAPGWAQVR,DGLHSVVDDDLDTEHR	2
ISG15	CDEPLNILVR,VPLASQGLGPGSTVLLVVDKCDEPLNILVR	2
TCEAL5	PASQAKPESQPPAAEK,PASQAKPESQPQAAEK	2
ODF3B	GTNGAPAYSIYGRPR,GTNGAPAYSIYGR	2
SAMD9	VELTEDKIDYTK,SLKVELTEDKIDYTK	2
SPTBN2	EANALAAGHPAQAAAINAR,TPEVQGRVPTLER	2
CUL2	MYIQAAIVR,SAVDEDRKMYIQAAIVR	2
CHD4	RKEEEEEDDDDDDSK,KEEEEEDDDDDDSKEPK	2
ORM2	NWGLSFYADKPETTKEQLGEFYEALNCLCIPR,EQLGEFYEALNCLCIPR	2
IL1RL1	FLPAEVADSGIYTCIVR,VIIEMDALSELDMLQAEALQDSLR	2
PNP	LTQAQIFDYSEIPNFPR,HRPQVAIICGSGLGGLTDKLTQAQIFDYSEIPNFPR	2
TANC1	IAAAPAGSR,EAGSDFGPETSSVLHLDHSADSPVSSLPTAEDTYR	2
AGRN	SGCTPCSCDPR,RAPVCGDDGVTYENDCVMGR	2
NCF2	QKLYEPVVIPVGR,LYEPVVIPVGR	2
VPS11	RDLHDQFQHQLR,DLHDQFQHQLR	2
PDCD6	AAYSYRPGPGPAAGAALPDQSFLWNVFQR,PGPGPAAGAALPDQSFLWNVFQR	2
FERMT2	KKLDDQSEDEALELEGPLITPGSGTAVLYIGPLK,KLDDQSEDEALELEGPLITPGSGTAVLYIGPLK	2
IGHMBP2	LLESVQQHSLDAVLAR,EAVSFALSQK	2
MYLK3	HVLSTSGLQSDAR,HVLSTSGLQSDAREPGEESQK	2
ACSM5	HCLTGGEALNR,NNDVINSSSYR	2
SH3BGR	AEEGGETEAQKEGSEDAGNLPEAQEK,EGSEDAGNLPEAQEK	2
APOH	EHSSLAFSK,CFKEHSSLAFSK	2
NRP1	SPGFPEKYPNSLECTYIVFAPK,YPNSLECTYIVFAPK	2
FRY	STGQLNMNPGTTSSNTATAER,VAEQRPGSILYGTHGPLPPLYSVSLALLSSELAR	2
DNAH7	AEWRFLLTGGIGLDNPYANPCTWLPQK,EFHNCQDALELSSFQNVIMR	2
CMC2	CLKNEYIENR,KCLKNEYIENR	2
STON1	CSTNPGNWVTFDDDPAVQSSQK,ACLGSLHELESEPVIQVTVGSAK	2
DOCK8	TLQLAVAINQEPPDPK,IQFMCGEDASNVMPVIFGK	2
THBS1	IPEAGGDNSVFDIFELTGAAR,LCNNPAPQFGGK	2
NARS2	CPEDVELCHR,ELTFGSSVEVQGQLIK	2
STK10	KFFDMELENLER,FFDMELENLER	2
FTSJ3	MDLPGVSIADEGETGMFSLCTIR,PLPNVVTLQEDITTER	2
ABCB1	NVHFNYPSR,NVHFNYPSRK	2
PRG4	RPALNYPVYGEMTQVR,VTTPDMSTTQHNK	2
CLYBL	AFGLQAVDLVYIDFR,ILPSSLMLPK	2
LPO	KILGAFMQIITFR,ILGAFMQIITFR	2
PSMB4	FQTATVTEK,SYNRFQTATVTEK	2
ATP4B	AQPHYSNPLVAVK,KAQPHYSNPLVAVK	2
DIS3	ENYLEATVWIHGDSEENK,ELKNGNLEVGVHIADVSHFIRPGNALDQESAR	2
MPC1	DYLMSTHFWGPVANWGIPIAAINDMK,DYLMSTHFWGPVANWGIPIAAINDMKK	2
VAV3	NYSGTPPPALHEGPSLHLQAGDTVELLK,TPIALATGIRPFPTEESINDENIYK	2
APOA4	TQVNTQAEQLRR,TQVNTQAEQLR	2
PDE6D	FFDNDLLVSTSR,FFDDNLLVSTSR	2
ENPP1	DQGDCCINYSSVCQGEK,SLCACSDDCKDQGDCCINYSSVCQGEK	2
ACAD11	EVTEFYVQNENSVDTWGKRLVIDK,EVTEFYVQNENSVDTWGK	2
EIF2AK3	KQWDLDVGSGCLVSSSLSKPEVFGNK,RMDPFSTKEHIEIIAPSPQR	2
ERLIN1	YQAVASNSK,KYQAVASNSK	2
PKP2	ENYLTVGLTVGQVRPLVPLQPVTQNR,AVSMLEADHMPPSR	2
HRC	HQGHRDEEEDEDVPTER,GHDGEDDEGEEEEEEEEEEEEEASTEYGHQAHR	2
PTPN18	GAPAGAGSGTQTGTGTGAR,RGAPAGAGSGTQTGTGTGAR	2
KRT15	SLLEGQDAR,AGLENSLAKTECR	2
WDR37	EFENLYIENIELRR,EFENLYIENIELR	2
COL28A1	ISGISFITIGLSTVVNEAK,GPTGVQGPR	2
DNAH2	LQPNLTDEEVLLLSMR,AYPSQKPLAAWTQDLAMR	2
EEPD1	AVVAEKPSNQLQK,VGSHDLTLVNLHLAALTLLGSENSSK	2
PSMB3	RFGIQAQLVTTDFQK,FGIQAQLVTTDFQK	2
IGKV2D-29	PGQSPQLLIYEVSNR,PGQSPQLLIYEVSSR	2
PPP2R3A	IETAFMDIEEQKANIYEMGK,SVDLDLLCGHYNNDGNSPSFGLLR	2
FLNC	AFGPGLEPTGCIVDKPAEFTIAAR,AGTNMTMVGVHGPK	2
PGM2	ASYFICHDQDTIK,ASYFICHDQDTIKK	2
PXK	SALENSEEHSAR,RSALENSEEHSAR	2
NAT2	TLTEEEVEEVLKNIFK,TLTEEEVEEVLK	2
LSM14A	VSRPESEQLRNDNK,VSRPESEQLR	2
PBLD	EMHAFQCSR,AFCGNPAAVCLLENELDEDMHQK	2
LHPP	GVLLDISGVLYDSGAGGGK,LGFDISEQEVTAPAPAACQILKER	2
CWF19L1	YVGNFGNSSGEVDTK,EDEETLAHR	2
HLA-DQA1	FDPQFALTNIAVTK,QFRFDPQFALTNIAVTK	2
GBP3	NFNLPQLCIWK,DKNFNLPQLCIWK	2
TACSTD2	AAGEVDIGDAAYYFERDIK,AAGEVDIGDAAYYFER	2
MEP1A	FYNSEGYGFGLTLYPNSR,QVIITILDQEPDVQNR	2
HSPBP1	LPLALPPASQGCSSGGGGGGGGGSSAGGSGNSRPPR,VLSQPMPPTAGEAEQAANQQER	2
TXNDC11	DLSVKYPEDLPITLPNLLR,YPEDLPITLPNLLR	2
CPNE1	FSVPVQHFCGGNPSTPIQVR,SDPLCILLQDVGGGSWAELGR	2
LRRC47	ADLATAPPHVTIVR,VVYPSKADLATAPPHVTIVR	2
HIBCH	GCAGVITLNRPK,KGCAGVITLNRPK	2
SGSH	DPHETQNLATDPHFAQLLEMLR,SRDPHETQNLATDPHFAQLLEMLR	2
PRH2	PQGPPQQGGHPCPPR,PQGPPQQGGHPPPPQGRPQGPPQQGGHPCPPR	2
FNDC3A	TLSTDSIQYHLQMQDK,TLSTDSIQYHLQMQDKNGR	2
AMACR	TADGEFMAVGAIEPHFYELLIK,SSLWEAPR	2
IGHV3-33	DNAQNSLYLQMNSLR,LSCAASGFTFSSSAKHWVR	2
ANKZF1	LLLEAGADPTVQDCR,LAAQLGAPTSLIPDSAIVNTR	2
HSD3B2	ACQNVSVVIHTACIIDVFGVTHR,RACQNVSVVIHTACIIDVFGVTHR	2
EPS15	AELTSQELQISTYEEELAK,EKDPEMFCDPFTSATTTTNK	2
SCFD1	VLIYDRFGQDIISPLLSVR,FGQDIISPLLSVR	2
LPP	REPGYTPPGAGNQNPPGMHPVTGPK,EPGYTPPGAGNQNPPGMHPVTGPK	2
CCDC91	EAMKDAVLKVVEEER,LLEVLDTEK	2
TBCC	QNQEVEKENSHFFVATFAR,ENSHFFVATFAR	2
SEC23B	IAGAIGPCISLNVK,GAIQFVTHYQQSSTQR	2
PROB1	GPGGENRDAEAQR,ARGPGGENRDAEAQR	2
CEP192	NLFLKPGEEHEVIVSFTPK,AARPPPDQLASEEPWTVLPEHLILVAPSPCDMAK	2
PMS2	EAVSSSQGPSDPTDR,APETDDSFSDVDCHSNQEDTGCK	2
SLC25A22	ILAAQGQVSAQGGAQPSVEAPAAPR,ILAAQGQVSAQGGAQPSVEAPAAPRPTATQLTR	2
SART3	AGPKAEGEEDEVK,AEGEEDEVK	2
CRACD	AKPPQESPSSASALAEWASIR,RQEILEEEGEGQEPPLEAER	2
EPCAM	AKPEGALHNNDGLYDPDCDESGLFK,RAKPEGALHNNDGLYDPDCDESGLFK	2
PAWR	KREDAITQQNTMQNEAVNLLDPGSSYLLQEPPR,REDAITQQNTMQNEAVNLLDPGSSYLLQEPPR	2
IGHV3OR15-7	ANSYTTKYAASVK,NTMYLQMSNLK	2
H6PD	LFGSPLSDYYAYSPVQER,ESLLVSAWSEELISK	2
NUBP1	LCASGAGATADTAIEEIK,LCASGAGATADTAIEEIKEK	2
GLO1	KATLELTHNWGTEDDATQSYHNGNSDPR,ATLELTHNWGTEDDATQSYHNGNSDPR	2
PTPN12	TVSLTPSPATQVETPDLVDHDNTSPLFR,IADGVNEINTENMISSIEPEK	2
RAB11FIP5	AAEPQGEPGGGGGGGGGGR,AAEPQGEPGGGGGGGGGGRGGSSVWLEPR	2
HGFAC	QGHVEQCECLGGR,VRQGHVEQCECLGGR	2
BIN2	DERFEQSANNFYQQQAEGHK,FEQSANNFYQQQAEGHK	2
SYPL2	IQFEMPLCDEESSSK,IQYEMPLCDEGSSSK	2
SARDH	AADWLFSADVSRPPGSTVYTCMLNHHGGTESDLTVSR,KAADWLFSADVSRPPGSTVYTCMLNHHGGTESDLTVSR	2
ITGAV	GVSSPDHIFLPIPNWEHKENPETEEDVGPVVQHIYELR,GVSSPDHIFLPIPNWEHK	2
USP36	LGSETCLPQHIR,TFVGEPQRLGSETCLPQHIR	2
TLN1	RLLSDLLPPSTGTFQEAQSR,LLSDLLPPSTGTFQEAQSR	2
WDR18	NYVSAWELQR,HVWSHHTLPITDLHCGFGGPLAR	2
IGHV3-13	AGDMAVYYCAR,GLEWVSAIGTAGDTYYPGSVK	2
FAM110C	TGDEGKAGNPETVPTTPGPAADPATPETPAPAAR,AGNPETVPTTPGPAADPATPETPAPAAR	2
CALML5	LISEVDGDGDGEISFQEFLTAAR,KLISEVDGDGDGEISFQEFLTAAR	2
CYP20A1	TLDPFETMLK,LTPVSAQFQDIEGK	2
FGB	HGTDDGVVWMNWKGSWYSMKK,HGTDDGVVWMNWKGSWYSMK	2
PIH1D1	AESGPEKPHLNLWLEAPDLLLAEIDLPK,LLGLELSEAEAIGADSAR	2
TRMT13	FCGEHAGAMEEEDAR,RFCGEHAGAMEEEDAR	2
CPB1	EIQVTELLNK,TYGREIQVTELLNK	2
GEMIN4	FLGQILTAFPALR,ALFREPDLVLR	2
CD6	EDAGVVCSEHQSWR,QLGCGWAVQALPGLHFMPGR	2
TP53BP1	VPETVSAATQTVK,SLVQESLSTNSSDLVAPSPDAFR	2
GMPPB	FVEKPQVFVSNKINAGMYILSPAVLR,INAGMYILSPAVLR	2
KRT79	QCQQLQTAIAEVEQR,KQCQQLQTAIAEVEQR	2
RETREG2	LSSPLHFVNTHFNGAGSPQDGVK,DLGEGEEGELAPPEDLLGHPQALSR	2
SMARCAD1	LDHGEESNESAESSNNWEK,VFAEDQDMQYASQSEVPNGK	2
IL7R	IDLTTIVKPEAPFDLSVIYR,KIDLTTIVKPEAPFDLSVIYR	2
LMBRD1	RCDAEAPEDQCTVTR,CDAEAPEDQCTVTR	2
PSMD9	QSGGSSQAGAVTVSDVQELMR,SDEEARQSGGSSQAGAVTVSDVQELMR	2
CST5	LKEEEFCSFQINEFPWEDKISILNYK,LKEEEFCSFQINEFPWEDK	2
MXRA5	LIVQLTVLEPMEKPIFHDPISEK,VWQTVSPVESR	2
PML	AQTLGAVVPPGDSVR,VVIQPEALFSIYSK	2
DLST	EAQNTCAMLTTYNEIDMSNIQEMR,LKEAQNTCAMLTTYNEIDMSNIQEMR	2
DENND4C	ESGMATAFIHALER,ESGMTTAFIHVLER	2
ARHGAP25	NSGEEEIDSLQSMVQELRK,NSGEEEIDSLQSMVQELR	2
WWOX	AKVETMTLDLALLR,VETMTLDLALLR	2
KLK1	ILPNDECEK,VVELPTQEPEVGSTCLASGWGSIEPENFSFPDDLQCVDLK	2
ZC3H13	DLGSVQGFEDTNK,MDKDLGSVQGFEDTNKSER	2
SCFD2	KALAQVFCEESGSSPLLQK,ALAQVFCEESGSSPLLQK	2
NUDCD1	LMHLTSEELNPHPDK,SFTFVQAGQDLEENMDEDVSEK	2
SNCG	KEDLRPSAPQQEGVASK,EDLRPSAPQQEGVASK	2
FGA	VELQDWAGNEAYAEYHFR,PGSSGPGSAGSWNSGSSGTGSTGNQNPGSPR	2
MCEE	NILGAQVSEVVPLPEHGVSVVFVNLGNTK,MELLHPLGLDSPIAGFLQK	2
SCRN3	IVNLFPQCTKDEIQIYQSK,DEIQIYQSK	2
ASPDH	RENPAEPGAVTGSATVTAFWR,ENPAEPGAVTGSATVTAFWR	2
LOXL1	HPFGFGQVPDNWREVAVGDSTGMALAR,EVAVGDSTGMALAR	2
AGL	FPSLPILSPALMDVSYR,HLSLGSVQLCGVGKFPSLPILSPALMDVSYR	2
TMCO4	VGAIEEFTFLPLTESR,TSSVQLHVAGLQPVLLQDR	2
PSG8	DLYHYITSYVVDSQR,DLYHYITSYVVDGQR	2
SLC16A1	DTEGGPKEEESPV,AAESPDQKDTEGGPKEEESPV	2
HPS4	GLMLSLLAEEPLLGDIAAIEEVYHSSLASLNGLEVHLK,DEAASTSSTYNFTYYDR	2
ASPSCR1	QGGPPGPTRPLTSSSAK,QGGPPGPTRPLTSSSAKLPK	2
PTGFRN	AVEVATVVIQPTVLR,VPGFADDPTELACQVVDTK	2
TBC1D1	GSESPRPNPPHAAPTGSQEPGR,AILQQLLLLR	2
LNPK	ECEPPSAGAAVSAR,ECEPPSAGAAVSARPGQEIR	2
DMAC1	LSQPFESYITAPPGTAAAPAKPATPATPGAPTSPAEHR,PATPATPGAPTSPAEHR	2
HEXD	LHVGCDEVYYLGEGEASRR,LQALLQDLSEVSAPR	2
CDH17	STHNLQVAALDANGIIVEGPVPITIEVK,HTDFEEREYVVLIR	2
CUL3	QLTLQHHMGSADLNATFYGPIK,QLTLQHHMGSADLNATFYGPIKK	2
IGKV2D-40	ASGVPDRFSDSGSGTDFTLK,FSDSGSGTDFTLK	2
TRIM22	LIKENQEAEKLEDDIR,ENQEAEKLEDDIR	2
C17orf58	EGQIQGAVHTQCI,AAEVAPAVR	2
MTHFD1	MDTESELDLISR,DVDGLTSINAGR	2
DEPTOR	LMEHGIIQHVSSK,TVNNLILTGPR	2
MACROD2	GQNDEENIQETSQVK,GQNDEENIQETSQVKK	2
APEX1	VSYGIGEEEHDQEGR,EAAGEGPALYEDPPDHK	2
KPRP	GHPAVCQPQGR,LRPEPSISLEPR	2
HTATIP2	FFGSLPDSWAR,KFFGSLPDSWAR	2
SLC4A2	TQPEPESLGPETPGFPEQEEDELHR,GAQAGTQVEEAEAVAVASGTAGGDDGGASGRPLPK	2
ECD	ESESVSKEEKEQNYDLTQVSESMK,EQNYDLTQVSESMK	2
EEA1	QILKQDFETLSQETK,QEEEKQILKQDFETLSQETK	2
PDE12	LSWAEAGSQTAAGAMER,TAVEKLSWAEAGSQTAAGAMER	2
CCDC187	QQIQAGLELAQAHK,SGMEPQVALPSPWPGEGR	2
AGMAT	IREESVMLR,QIQEAYEK	2
IGKV2-40	ASGVPDRFSDSGSGTDFTLK,FSDSGSGTDFTLK	2
CARMIL1	LGNDAVSQDSSSPALSSVER,KLGNDAVSQDSSSPALSSVER	2
HDLBP	VHIEFTEGEDKITLEGPTEDVSVAQEQIEGMVK,ITLEGPTEDVSVAQEQIEGMVK	2
FAT1	KPIEEKPSQPYSAR,GTVSEDDPPGGVIAILSTTDADSEEINR	2
NDUFB6	WLKDEELSPREPVLPPQK,DEELSPREPVLPPQK	2
INF2	ALEQQASTPPPPPPLLPGSSAEPPPPPPPPPLPSVGAK,ALEQQASTPPPPLLPGSSAEPPPPPPPPPLPSVGAK	2
DNAJC3	AEAYLIEQMYDEAIQDYETAQEHNENDQQIR,DRAEAYLIEQMYDEAIQDYETAQEHNENDQQIR	2
PLCD1	TFAEAAGSGETLSVNQLVTFLQHQQR,EEAAGPALALSLIEHYEPSETAK	2
GDA	NYTSMYDKNNLLTNK,NYTSMYDK	2
IGHV3-64D	GLEWVSGISWNSGSIGYADSVK,AEDMALYYCAK	2
SEPTIN14	MGFTNVGPNNQPVSFQEIFEAKR,MGFTNVGPNNQPVSFQEIFEAK	2
GCFC2	DIDLSCGSGSSK,VILEEHSACENEVSK	2
MICALL2	TDQALVGSLVSSTCGVCGK,QALSALEEAGAPAPGRPSPATAPVPSSQPK	2
SEH1L	SESGNWHCTASWK,VWDKSESGNWHCTASWK	2
SLAIN1	AASAAAAPHLLLLPPPPPAAPPPAGACSPLGPR,MSLPLGIYR	2
C2CD2	ALGEDQVAETSAMSDALKDILK,ALGEDQVAETSAMSDALK	2
ACAA2	QTVQVDEHARPQTTLEQLQK,GKQTVQVDEHARPQTTLEQLQK	2
GPC4	YLFAVTGNGLVNQGNNPEVQVDTSKPDILILR,YLFAVTGNGLVNQGNNPEVQVDTSK	2
NUMA1	HLTAQVCSLEAQVAHADQQLR,EVACLETLVR	2
PSMF1	QDALVCFLHWEVVTHGYCGLGVGDQPGPNDKK,QDALVCFLHWEVVTHGYCGLGVGDQPGPNDK	2
EHBP1L1	PQGSSWQGALLSTAQGAISR,HAGPVPVQVPLR	2
CRYBG3	GFTGNTEGSMLK,SSPSSVTNSSYDGESDSQHHLSCEPVFQTNR	2
DPP6	LPTVTAKEDEEED,IQDKLPTVTAKEDEEED	2
CLGN	LLSDTDDLILENFYDK,IPDPSAIKPEDWDESEPAQIEDSSVVKPAGWLDDEPK	2
NOL9	LLQAQAAGVDWR,LLQAQAAGVDWREGAR	2
FN1	GATYNIIVEALK,GATYNIIVEALKDQQR	2
PUDP	EVFPMAALMPGAEK,LKEVFPMAALMPGAEK	2
CERS4	NGTAGGPRPAPTDGPR,NGAAGGPRPAPTDGPQSR	2
LRRC1	LEELDLGNNEICNLPESIGALLHLK,RLEELDLGNNEICNLPESIGALLHLK	2
RTF2	AEVCHTCGAAFQEDDVIVLNGTK,AEVCHTCGAAFQEDDVIVLNGTKEDVDVLK	2
IGLV10-54	QTATLTCTGNSNNAGNQGAAWLQQHQGHPPK,QTATLTCTGNSNNVGNQGAAWLQQHQGHPPK	2
KRT18	STSFRGGMGSGGLATGIAAGLAGMGGIQNEK,GGMGSGGLATGIAAGLAGMGGIQNEK	2
ASCC3	IISHFSQDDFTALVQMTEK,TSIECLPELIHACGGK	2
ANXA3	DYPDFNPSVDAEAIQK,LTFDEYRNNSQK	2
ARHGAP18	SWLSSSQGVVLTAYHPSGKDQAVGNSHAK,DQAVGNSHAK	2
JCAD	NANSQEDAEELKATTR,NANSQEDAEELK	2
HEATR5A	LAQMVDDGAFTAGLAQVSFDKLK,LAQMVDDGAFTAGLAQVSFDK	2
JSRP1	LADSSSVPHDSQVAEGPSVDTRPK,DAVPAEAALQAR	2
NHLRC2	VSTIAGIGIQGTDK,VSTIAGIGIQGTDKEGGAK	2
ANXA2	SALSGHLETLILGLLKTPAQYDASELKASMK,SALSGHLETLILGLLK	2
ZYX	SPSSSQPLPQVPAPAQSQTQFLVQPQPQPK,PQVQIHVQSQTQPVSLANTQPR	2
BCL2L13	ESDTEVITVEK,LQEQHLSSPQGVQLDR	2
IGKV3D-11	ASQGVSSYLAWYQQKPGQAPR,ASQGVSSYLAWYQQK	2
XDH	ITYEELPAIITIEDAVKNNSFYGPELK,ITYEELPAIITIEDAVK	2
ETFB	QAIDDDCNQTGQMTAGFLDWPQGTFASQVMLEGDK,QAIDDDCNQTGQMTAGFLDWPQGTFASQVMLEGDKLKVER	2
PARP1	KGDEVDGVDEVVKK,IAPPEAPVTGYMFGKGIYFSDMVSK	2
KRT77	SLDLDSIINAVR,YQELQIMAGR	2
PNPLA2	MRAPADPAPAPADPASPQHQPAGPAPLLSTPAPEAR,APADPAPAPADPASPQHQPAGPAPLLSTPAPEAR	2
IGLV3-25	PYAYWYQQKPGQAPVLVIYK,ITCSADALPK	2
CD27	GESPVEPAEPCR,SNKGESPVEPAEPCR	2
AGT	TGCSLTGASVDSTLAFNTYVHFQGK,ADSQAQLLLSMVVGVFTAPGLHLK	2
PTPRN2	THTAQDRPPAEGDDRFSESILTYVAHTSALTYPPGPR,TQLHEDLLPR	2
FAM241A	EAAGTEWDPGASPR,GGDGGERDEDGDALAEREAAGTEWDPGASPR	2
LLGL2	TVEHGFPHQPSALGYSPSLHILAIGTR,VFLTDTDPNENLSAQGEDEWPPLRK	2
ZC3HC1	SWDSSSPVDHPEPEAASPTTR,TRSWDSSSPVDHPEPEAASPTTR	2
IMPACT	SQMTEPGPEVK,KTEEEDVECEDDLILACQPESSVK	2
ITGA7	QGCGEDKICQSNLQLVHAR,ICQSNLQLVHAR	2
ATG16L1	SVSSFPVPQDNVDAHPGSGK,RSVSSFPVPQDNVDAHPGSGK	2
CHDH	VLLLEAGPKDVR,LTEDPAERVLLLEAGPKDVR	2
PGM5	QMGVHGFGR,LYAESYERNPSGHDQEPQAVLSPLIAIALK	2
ANK1	EGQNVNMENLYTALQSIDRGEIVNMLEGSGR,EGQNVNMENLYTALQSIDR	2
UQCC3	NWMVGGEGGASGR,KNWMVGGEGGASGR	2
PON2	NTVEIFKFEEGENSLLHLK,FEEGENSLLHLK	2
PLEKHM2	LQSYFAACEDETPAIR,KLQSYFAACEDETPAIR	2
BCO2	FIAVNGATAHPHYDPDGTAYNMGNSFGPYGFSYK,AGEGLDQVR	2
CTU2	LFSVPSVFTPAIDTK,LFSVPSVFTPAIDTKAPEK	2
CAP1	ELSGLPSGPSAGSGPPPPPPGPPPPPVSTSSGSDESASR,SALFAQINQGESITHALK	2
H1-2	SETAPAAPAAAPPAEKVPVKK,SETAPAAPAAAPPAEKVPVK	2
XIAP	DSMPDESSQTSLQK,SLEVLVADLVNAQKDSMPDESSQTSLQK	2
PCM1	ALNVPPSLDCR,DASTSPPNRETIGSAQCK	2
PLCG2	DSSVFILGNTDRPDASAVYLR,FLIHEQQELWAQDLNK	2
BCS1L	DVQEFINNPK,DVQEFINNPKWYTDR	2
NUP210	FVCAPPSRLTLVPVYTSPQLDMSCPLLQQNK,NPLLDLAAYDQEGR	2
GHRL	ALAGWLRPEDGGQAEGAEDEMEVR,LSGVLYQQHSQALGK	2
EML4	ADSGVHLCVIDDSNEHMLTVWDWQR,ADSGVHLCVIDDSNEHMLTVWDWQK	2
DNAI2	AEEEFFDIIFTELK,AEEEFFDIIFTELKK	2
APOE	CLAVYQAGAR,LGADMEDVR	2
VCAN	IEDYNRMENVAK,TYGQVSGEAIK	2
IGLV3-1	PGQSPVLVIYQDTK,PGQSPVLVIYQDNK	2
SERPINB2	SLSSAINASTGDYLLESVNKLFGEK,SLSSAINASTGDYLLESVNK	2
CGN	TEEELKELQAER,TEEELKELQAEQQSQEVAGR	2
DCHS1	LPRPGPSFSTPSLALATLR,PGPSFSTPSLALATLR	2
COPG1	QVEEEDGSR,QVEEEDGSRDSPLFDFIESCLR	2
HADH	KFAENPKAGDEFVEK,FAENPKAGDEFVEK	2
SDHAF1	APTGEPGGVGSQPDDGDSPRNPHDSTGAPETRPDGR,APTGEPGGVGSQPDDGDSPR	2
ATAD3A	RATVEQEMELR,ATVEQEMELR	2
PPP6R2	TEQVIMFLK,IQPFDDEEDEDIWEDSDTR	2
DHX37	LASYQSCLLSSPGTMLK,TPLEDYSGECFQK	2
IRF2BP2	SPPGAAAPAAAKPPPLSAK,DILLQQQQQQLGHGGPEAAPR	2
EPRS1	LKTEKAPQDQVDIAVQELLQLK,APQDQVDIAVQELLQLK	2
IGHM	EVMQGTDEHVVCK,ESDWLSQSMFTCR	2
WDR62	PGIPGGTASLLEPTSGALGLFQGSPAR,PGIPGSTASLLEPTSGALGLFQGSPAR	2
CYP4F11	RTLPTQGIDDFLK,FNQENIKER	2
SERPINB5	KFPESETK,GVALSNVVHK	2
MRPS2	EPGDQGPAHPPGADMSR,LQGQKEPGDQGPAHPPGADMSR	2
KANK2	MPTQEPTHREPTR,SQEVVETMCPVPAAATSNVHTVK	2
CYB5R2	THPDQFDLWYTLDRPPIGWK,TLADHLGMIAGGTGITPMWQLIR	2
ARHGEF18	SAMSEIEGIQSLICRR,RLGSANGQAEDGGSSTGPPR	2
STAB1	TRPGELMVGEDDAR,VCVAIDECELDVR	2
DCN	LGLSFNSISAVDNGSLANMPHLR,LYLSKNQLEELPEKMPK	2
COL18A1	IFSFNGKDVLR,AAMPIVNLKDELLFPSWEALFSGSEGPLKPGAR	2
DUOX2	IPPGDLVFDPDQR,IPPGDLVFDPDQRGDVVLPFQR	2
SUMF2	DGEGPVREATVK,FLMGTNSPDSRDGEGPVR	2
TTI2	DLGDLIEATGFDR,DAVLKDLGDLIEATGFDR	2
KDM3B	LIHVMLMDNSTPQSEGGTLK,SEEPLKTDSSASNNNSELK	2
ACADL	TVAHLQTVQHQLAELK,YIGAIAMTEPGAGSDLQGIK	2
ANXA13	GLGTDESILIEVLCTR,TALALLDHPSEYAAR	2
COL6A6	VRENSCPVGAR,EGVTIFTLGIEGTSDTQLEK	2
LMTK3	QPLAPLAQPPR,SAPATSRPGSAPTPGAPGEADLR	2
SORL1	WESPYDSPDQDLLYAIAVK,TSVVIKWESPYDSPDQDLLYAIAVK	2
ERCC2	QMAQPFHREDQLGLSLLSLEQLESEETLQR,ETDAHLANPVLPNEVLQEAVPGSIR	2
SVEP1	TASEDVKPGSK,EVTFHCHEGYVLHGAPK	2
AARS1	GTDARPYTGK,VDDSSEDKTEFIVK	2
FNDC1	SQQSVSAEDEEEEDAGFFK,APEQQPPPPVATSQHHPGPQSR	2
PLA2G7	LKGDIDSNAAIDLSNKASLAFLQK,LKGDIDSNAAIDLSNK	2
NDUFV3	LEAEGEAMEDAAAPGNDRGGTQEPAPVPAEPFDNTTYK,LEAEGEAMEDAAAPGNDR	2
LY75	EAYVSCQNQGADLLSINSAAELTYLKDKEGIAK,TPDWYNPER	2
MAP2K2	ELEAIFGRPVVDR,KLEELELDEQQKR	2
GPSM1	TASGAAEGWDRGQASMAEVAAAR,DSLPIPVR	2
LBR	NTQEKFNLSQESSYIATQYSLRPR,FNLSQESSYIATQYSLRPR	2
TRAPPC10	YLPHHSAHSSQLDADSWIENDSLSVDKHGDNQPDSSSLK,RQESSSSLEMPSGVALEEGAHMLR	2
CASKIN2	LSSVSGPSPEPPPLDGSPGPK,RLSSVSGPSPEPPPLDGSPGPK	2
RGPD3	DGQYFEPVVPLPDLVEVSSGQENEQVVFSHR,EMLNSVMQELENYSEGGPLYK	2
PAK6	TALATGQLPGR,GSAVPVDGYISGLLNDIQK	2
RBFOX2	AEGAQPQQPPQLGPGAAAR,MAEGAQPQQPPQLGPGAAAR	2
RRP7A	LLSTCGLVQSIELQEKPDLAESPK,LLSTCGLIQSVELQEKPDLAESPK	2
GRSF1	GLQTGPVPPGRLAGPPAVATSAAAAAAASYPALR,LAGPPAVATSAAAAAAASYPALR	2
SPEN	LGEPAGESVENQEVQSK,VVAPVESHVPESDQAQGESPAANEGTTVQHPEAPQEEK	2
RFTN1	TTSEGSISTK,QPSSPSGEGDGGK	2
FAM114A1	SEIPLQEQNYPAVDSPPSGGGWAGWGSWGK,TIEEIYMSSIESLAEVTAR	2
BBS9	TPAPLQHLNTLLDGTYK,DKTPAPLQHLNTLLDGTYK	2
COMT	MVDFAGMKDK,MVDFAGMK	2
PDE5A	ADNSVPGTPTRK,ADNSVPGTPTR	2
GBE1	NTGENEGGIDKFSR,LFAYSSWEVLR	2
EFHD1	REEAEESGPQLAPLGVPAPEPKPEPEPPAR,LSEIDVALEGVR	2
HAL	GETISGGNFHGEYPAK,NIITTELNSATDNPMVFANRGETISGGNFHGEYPAK	2
TBCK	LKDVGGEAFYPLLEDDQSNLPHSNSNNELSAAAMLPLIIR,VDIPPLIR	2
SPECC1	CPTSITQESSFGSPTGNQLSSDIDEYKK,LIYLEHSPNSEGAASHTGDSR	2
IFIT2	KAEALIQQEHADQAEIR,VCSILASLHALADQYEEAEYYFQK	2
MRPL37	MILFAFGSAVAQAR,VFHFLVFQLNTTDLDSNEGVK	2
HLA-DMB	VLLTCWDPEENKMAPCEFGVLNNLANVLSQHLNQK,MAPCEFGVLNNLANVLSQHLNQK	2
CALD1	EAEGAPQMEAGK,EAEGAPQMEAGKR	2
PREX1	SFVHPKPGAAGTVGAGLIPISSELCYR,GSLAEMAGLQVGR	2
MRPL9	LPAEPITR,NLGVVVAPHTLKLPAEPITR	2
LSS	VVYALLNLYEHHHSAR,ILGVGPDDPDLVQAR	2
HYPK	EDLELIMTEMEIPR,KEDLELIMTEMEIPR	2
MAP1A	DKALEQKNTALEQK,YSAQADITDDSLDR	2
ANK2	TQTDSEAQESTATSDETK,TEGDSSATAIFPQTHK	2
TUT7	ISLKEENVCEENSPVDQSDFFYEFSK,EENVCEENSPVDQSDFFYEFSK	2
IQCG	EMNLEGTNLDKLPMDSTITK,QFFSHVIADTIK	2
DNAH5	MEVLEAFVITQSINMLR,SKLPAAIEQLIVPHLAK	2
ADO	DAASGAEAPMQPGFPENLSK,GASDRDAASGAEAPMQPGFPENLSK	2
DIDO1	RLAAETGEGEGEPLSR,LAAETGEGEGEPLSR	2
DAPL1	IQTLDALNDTLEK,IQTPDALNDALEK	2
ATP5MJ	NLWIPMKPYYTK,NVWIPMKPYYTK	2
TRIP11	REEMEQLFHDDQGSVTR,DKEFHSNQELER	2
ABCC2	ILEAAGGQILIDGVDIASIGLHDLR,IIEYGSPEELLQIPGPFYFMAK	2
MRPL30	LPQGLPTEENMSNTCLK,IKPLKLPQGLPTEENMSNTCLK	2
AOX1	DWAQTAFDESISLSAVGYFR,GLRGPLTLNSPLTPEK	2
KLK10	LDPEAYGAPCAR,LARPVVPGPR	2
VWA5A	VQSNCPLSPTK,LIIYAQLTGK	2
NQO2	ATDKDITDTLSNPEVFNYGVETHEAYK,VLIVYAHQEPR	2
ABHD10	DDVVPWHTSMQVADR,LLHGMKDDVVPWHTSMQVADR	2
SKIV2L	VFTTLVLCDKPLSQDPQNR,RPPGPASQSLWGNPTR	2
MUC5B	TTESPPSPGTTTLGHTR,AAQLPDMPLEELGQQVDCDHMR	2
ARHGEF28	SATSLESESDNNSCR,ELTVCSSSEEQK	2
SEPTIN4	IREEIVHFGIK,EEIVHFGIK	2
SPAG1	EEPGRPAGEVSTGCLASEK,MVIQEIENSEDEEGKDSGR	2
GPRIN1	ADPVPLESMDSASTGKTEPGLLGK,ADPVPLESMDSASTGK	2
PLCG1	AQREDELTFTK,EDELTFTK	2
COBLL1	SMSMDETDKSPCEAGR,ELTDKEAER	2
CLCA1	DMVTQASLYLFEATGKR,DMVTQASLYLFEATGK	2
HIVEP1	LIDSISNSHPLLPPELRPLGSQVQK,SNGPSAALVTASTPSALPTGEK	2
MYPN	ETGVHSLLIDTLTQR,QTRPDSLQER	2
COQ7	FNELMVMFR,KFNELMVMFR	2
ARSB	ELIHISDWLPTLMK,TISEGNPSPR	2
SERPINB8	ADFSGMSAEK,DGDIHQGFQSLLSEVNR	2
ABR	GGGGDSGDPGRPDPEAESPR,GDPGRPDPQAESPR	2
LSP1	QQHEGAQGALDSGEPPLCR,QQHEGAQGTLDSGEPPQCR	2
SPG7	VLQDNLDKLQALADALLEK,LTQSSAFYSQR	2
DYNC1H1	DPTVKFPPDLCSR,GNEIVLSAGSTLR	2
GOT2	NVFLPKPTWGNHTPIFR,TCSFDFTGAVEDISK	2
MYO1D	FQEALQTIFNR,RFQEALQTIFNR	2
SMC6	TAQILNLQQHLSTLEK,HALSYNQGQLK	2
TNRC6B	MEQEDFVMEGHGK,MVSALQQQQQQQR	2
MVK	VDLNLPNIGIK,LQPHSNGKVDLNLPNIGIK	2
NCF1	QGTLTEYCGTLMSLPTK,TSGSKMALSTGDVVEVVEK	2
NDUFB9	QLQEETPSGGPLTEALPPARK,QLQEETPSGGPLTEALPPAR	2
PLIN1	VVEYLLPADK,VVEYLLPADKEESAPAPGHQQAQK	2
ZC3HAV1	GYCNPGIQLCSVGSYTINFR,RGPDHEPAK	2
PRR4	HPPPPPFQNQQRPPQR,FPSVSLQEASSFFR	2
LRRC15	ELSLGIFGPMPNLR,LYLSNNHISQLPPSIFMQLPQLNR	2
MGAT1	RVHLAPPPTWEGYDPSWN,VHLAPPPTWEGYDPSWN	2
KLHDC7A	TAVGSNPDTPHFPR,AEAPQSCSCENPR	2
CDC42BPG	QQPAPAVPHQEQAPLLFPR,SNNIFQVGECR	2
SBSPON	LTGDCCFDYDR,TESLTPHCALENRPLTR	2
MYOT	IPSSMDSNYQQSSAGQPINAK,IPSSMDSNYQQSSAGQPINAKPSQTANAKPIPR	2
MYH14	IHEEAVQELR,KAPPRPGPVPEAAQPFLFTTR	2
DHRSX	LLAAEGSHVTANVVDPGVVNTDLYK,TPDEGAWTSIYAAVTPELEGVGGR	2
SENP8	DLIATLAK,RGEWKDLIATLAK	2
COL5A1	FGGGSDAGSKGPMVSAQESQAQAILQQAR,TVLEINTPKVEQVPIVDIMFNDFGEASQK	2
DDX18	STVLSNGEAAMQSSNSESKK,STVLSNGEAAMQSSNSESK	2
MRPS34	DSQIYAVDYETLTR,DSQIYAVDYETLTRPFSGR	2
TAGLN	LVNSLYPDGSKPLK,LVNSLYPDGSKPLKVPENPPSMVFK	2
TUBB8B	ELVLTQTGQCGNQIGAK,LHFFMPGFAPLTSQGSQQYR	2
PDE11A	VNLPQYPPTAIDYK,LLASTASSSSPASVMVAKEDRN	2
SYTL2	VHPSQMEISETVEK,TDFGDTEEEVKGPEK	2
CST4	EQTVGGVNYFFDVEVGR,SQPNLDTCAFHEQPELK	2
UBR4	RVALEELENKPR,VALEELENKPR	2
NT5C	DKTVVLGDLLIDNKDTVR,TVVLGDLLIDNKDTVR	2
MRPS31	IQFDEGYDNYPGQEKMDDLKK,EAPETDTSPSLWNVEFAK	2
ATF7IP	NKADNNIDAIEETLETDDTTICSDRPPENEK,ADNNIDAIEETLETDDTTICSDRPPENEK	2
D2HGDH	HLHLASPVQESPFYILIETSGSNAGHDAEK,LGHFLEHVLGSGLVTDGTMATDQR	2
RTN3	AEPSEATQSHSISSSSFGAEPSAPGGGGSPGACPALGTK,VALPDDHLK	2
SEC16B	NASPSGDEDSSDSPDSEETPR,FYIPHVPVSFGPGGQLVR	2
LPA	DKYILQGVTSWGLGCACPNKPGVYAR,YILQGVTSWGLGCACPNKPGVYAR	2
DPYSL2	AALAGGTTMIIDHVVPERGTSLLAAFDQWR,AALAGGTTMIIDHVVPEPGTSLLTAFDQWR	2
OXA1L	DNPPNIPSSSSSK,DNPPNIPSSSSSKPK	2
CAVIN2	VLIFQEENEIPASVFVKEPVSGAVEGK,EPVSGAVEGKEELPDENK	2
CISD3	KQPFCDGSHFFQCTGLSPLK,QPFCDGSHFFQCTGLSPLK	2
PERM1	FSVAGPGPNKPGSGEASAR,FSVAGPGPNKPGSGQASAR	2
KRI1	YVDEENSDRETSNHR,RYEEEEEEEEDEEEMEEEK	2
CRB2	GCATQPCHHGALCVPQGPDPNGFR,AEAPGSPAVVLPGR	2
ATP6V1E2	HMMAFIEQEANEKAEEINAK,AEEINAKAEEEFNIEKGR	2
CSPG4	DVNERPPQPQASVPLQLTR,DQPGEPATEFSCQELEAGSLVYVHR	2
BLVRA	MNTEPERK,MNTEPERKFGVVVVGVGR	2
FAM207A	ASPLLAIGQTLAR,DALPELLGLEAGIR	2
SETX	AGSHTAQNSDVFVPESDRSDYNCTGGTEVLANSNRK,AGSHTAQNSDVFVPESDRSDYNCTGGTEVLANSNR	2
ARPC1B	DRTQIAICPNNHEVHIYENSGAK,TQIAICPNNHEVHIYENSGAK	2
ATXN3	MLEANDGSGMLDEDEEDLQR,YIQQQKQQQQQQQQQQQQQQQQQR	2
NDUFA6	AGSGVRQVTSTASTFVKPIFSR,QVTSTASTFVKPIFSR	2
OPA1	KALPNSEDLVK,ALPNSEDLVK	2
MDM1	QAFMGEQEKLDVHEK,SQEAEQKDVIQER	2
SH2D4A	KQDEEINQIEGER,KKQDEEINQIEGER	2
SERPINF1	SSMSPTTNVLLSPLSVATALSALSLGAEQR,SSMSPTTNVLLSPLSVATALSALSLGAEQRTESIIHR	2
ACAN	EQQSHLSSIVTPEEQEFVNNNAQEYQWIGLNDR,CQPSGHWEEPR	2
DNAJB12	QYDQFGNDKSQAAR,KQYDQFGNDKSQAAR	2
RNASEH2A	LQDSDTEYGSGYPNDPK,LQDSDTDYGSGYPNDPK	2
P2RX7	LPLALHDTPPIPGQPEEIR,CVVHEGNQK	2
BTBD8	QSSNDLFQVNSTSDDEIPRK,QSSNDLFQVNSTSDDEIPR	2
FBP1	IYSLNEGYAKDFDPAVTEYIQR,GKIYSLNEGYAKDFDPAVTEYIQR	2
GOLGA5	IMQDQSEGNSLQNQALQTLQER,SRIMQDQSEGNSLQNQALQTLQER	2
TRIP10	HARPPDSPASAPPDSSSNSASQDTK,LGAGYGLLSEAELKVVPIIAK	2
AVIL	AEIGVIEGDK,GGRAEIGVIEGDK	2
PIDD1	GLPAAAAPVCPAASAAAAGGILASEHSR,GPSAAGGHPGPAASEPVLPPLPGPQR	2
EXOSC7	VLHASLQSVLHK,VLHASLQSVLHKEESLGPK	2
CAPSL	EEVEELFQR,GLNDYAVVMEKEEVEELFQR	2
SPATA18	QNADQQDTEAMPDYKK,EQWNSLKQNADQQDTEAMPDYKK	2
ARHGAP21	LSETPGTK,SQDLSLQEAETEQSDTLDNK	2
CHCHD6	RYEQEHSAIQDK,YEQEHSAIQDK	2
PAICS	VELFFKDDANNDPQWCEEQLIAAK,DDANNDPQWCEEQLIAAK	2
NPC1	SCATEEQYKGTER,DNGQAPFTITPVFSDFPVR	2
DDX60	GLHLNLGNTIMKDYEYLWNTVSK,HGDVHFDHFHPCAALTTDHIER	2
LSR	SVDALDDLTPPSTAESGSRSPTSNGGRR,NSSAGGQGSYVPLLR	2
KRT8	ASLEAAIADAEQHGELAIK,ASLEAAIADAEQHGELAIKDANAK	2
IQCE	KAVLDEAVVVLQAAFR,AVLDEAVVVLQAAFR	2
SELENBP1	GGPVQVLEDK,GGPVQVLEDKELK	2
STYXL2	SRNWEDVEESSK	1
PRDM2	LTPPAGISATEIAK	1
WNT6	GRAPPRPSGLPGTPGPR	1
MCM3	DSKEPFSSVEIQAALSK	1
ARHGAP28	INPQAEWVIKPQPSS	1
EGFR	ATGQVCHALCSPEGCWGPEPK	1
MYO1A	VLEELSMSSGELAFGK	1
MCM3AP	GASAEELLAQCLSSSLR	1
PRAP1	AWMETEDTLGR	1
PTPRC	TLLLDVPPGVEK	1
FASN	CVLLSNLSSTSHIPEVDPGSAELQK	1
GBP7	ASEIHMPGPVCLIENTK	1
SIGLEC10	LSCEAWNVHGAQSGSILQLPDKK	1
PRSS2	ITNNMFCVGFLER	1
EIF2AK4	MPLVEQSPEDSGGQDYVETVIPSNR	1
ATRX	EQSFTSLEVR	1
CCDC88B	EAPQGELVPEAR	1
PPP1R2B	DLHDDNEDEEMLETADGESMNTEESNQGSTPSDQQQNK	1
CRYZ	VLGTAGTEEGQK	1
C6orf47	RMDSLNWDQPISSTQESGR	1
PIP5K1C	AAPTQVLSMTAQPGPGHGK	1
HNRNPC	QAVEMKNKSEEEQSSSSVK	1
ANO1	ACPDSLGSPAPSHAYHR	1
APOL4	VQLLTSVGTSGLFLGVRVREEGAGMR	1
HMGXB4	VSGSSGELPLEDGVSHK	1
CRTC3	SNASEFQPSFHQADNVR	1
PKP3	GVGGAVPGAVLEPVAPAPSVR	1
PPFIA1	LHEIGHER	1
CFAP410	ELDAEGLEAVR	1
HYKK	ECINHGDLNNHNILIESSK	1
CCN3	CPPQCPGQCPATPPTCAPGVR	1
MYCT1	SSYTHSLNR	1
DCTN1	EQLDMAGAQVR	1
UHRF1BP1	SDASSDQGPASPQK	1
SALL1	LQNSEPSAPLAGLEK	1
SLCO1B3	IYVDIGYVDLSTIR	1
UBA1	CLQHQNRYDGQVAVFGSDLQEK	1
PLS1	HLMPMNPNDDSLFK	1
ZFP62	IHTGKKPYQCNECGK	1
RADIL	NGPSGLRGAAPEGDSAALAEESPPAPSSR	1
SCAF1	AARPPPAASATPTAQPLPQPPAPR	1
IGHV3-43	NSLYLQMNSLRTEDTTLYYCAK	1
GRIN2C	ALREAPLGLR	1
CGNL1	AAATSPDSGAK	1
MYBPC3	VYLFELHITDAQPAFTGGYR	1
ZXDC	VNLASRPEQGPSGPAAAPGPGVAPAGAVTISSQDLLVR	1
MRPL53	NFLQTVSSEK	1
ATG2B	GIVDGVILPTETR	1
ATP13A1	KVTPVSSIPVETHR	1
PRRG3	EAASSPQVVLGPSR	1
KRT34	EVEQWFATQTEKLNK	1
IGKV2D-28	SSQSLLHSNGYNYLNWYLQK	1
MAPT	EEVDEDRDVDESSPR	1
MAP1B	VSAEAEVALVSPEVTQEVVEEHCASPEDK	1
NEK7	ALRPDMGYNTLANFGIEK	1
NAT10	TLHEVSLQESIR	1
MRPL23	NVVYPLYQLGGPQLR	1
RTN4	KPAAGLSAAPVPTTPAAGAPLMDFGNDFVPPAPR	1
FRZB	NNYNYVIWAK	1
L1TD1	EADLTEEIEENLR	1
FAAH	GTNCVTSYLADCETQLSQATR	1
EPB41L5	SIIMCRVSLLDGTDVSVDLPK	1
PLIN5	AQDTLAQLQETLELIDHMQCGVTPTAPARPGK	1
FAM160B1	FFTGVMEPQLMQTSEMGILTSTALLHR	1
PSCA	AQVSNEDCLQVK	1
ARL2	EALELDSIR	1
IGHV3-15	LSCAASGFTFSNAWMNWVR	1
SYTL1	AGSLDTYVQCFVLPDDSR	1
SLC25A6	RYKGIVDCIVR	1
MCC	SSCSLSVAEVDR	1
EEF1AKNMT	MDVTQMEFPDASFQVVLDK	1
DHCR24	LGCQDAFPEVYNKICK	1
PLEKHG1	FVDADFSDNVCSGNTSHSLNSPR	1
REXO1	TLAASGSQPSNGPEPGGQQLK	1
TMED8	AAEGPGSWSHTAR	1
SCLY	VSGQTEVDDILAAVRPTTR	1
HSD17B7	LLELEEHIR	1
WDR41	TAHDSNVLHIAR	1
AMPD2	ASLQASTTAPEAR	1
LMOD1	QMPSGPTKPSEGPAK	1
SLIT3	SLTSLVLYGNKITEIAK	1
CACNA1A	AGGSGPPQQQQQQQAVARPGR	1
GATD3B	VVTTPAFMCETAVHYIHDGIGAMVR	1
GATD3A	VVTTPAFMCETAVHYIHDGIGAMVR	1
SLC7A6OS	LRSDAVESAAQKTSEDLER	1
PTGS1	ALGHGVDLGHIYGDNMER	1
POLE4	EEEVPAGEAAASQPQAPTSVPGAR	1
TYW3	QLQDAQILHSVAIDSGFR	1
RSPH9	NYGYIYVGTGEK	1
MYO1C	VLQALGSEPIQYAVPVVKYNR	1
SCN5A	DLGSEADFADDENSTAGESESHR	1
NLE1	HWVLSISWSPDGKK	1
TUBGCP2	ERAELAATAVGSSTTSINVPAAASK	1
PPP1R12B	LGQTPFDVADEGLVEHLQLLQK	1
JMJD4	GLGVEVPGVGQAPGR	1
FARSB	FELTMPCSSLEINIGPFL	1
MAT1A	YLDKDTVYHLQPSGR	1
MYO1G	IFLQTLDTHHR	1
ATP7B	DAAPQTFSVLIGNR	1
GPATCH1	EEERAPESSANQTVNK	1
CARD10	GDCSVRDPEDTAMPGR	1
RALGAPA2	VLYGPLEGCLAPSGR	1
DYNC2H1	SEGLPSDDLSIENALVIIQSR	1
PLSCR3	RGGAGPSAITS	1
LECT2	SQRPHQGVDVLCSAGSTVYAPFTGMIVGQEKPYQNK	1
ZSCAN5C	QDEDFLLPETTVTK	1
FARP2	HDEILTELEK	1
ARHGEF10L	EPAPADGAALEHSEEDGSIYEMADDPDVWVR	1
IGKV2D-24	FSGVPDRFSGSGATDFTLK	1
SDF2L1	NLHTHHFPSPLSNNQEVSAFGEDGEGDNLDLWTVR	1
HK3	MLPTYVGSSPHGTEQGDFVVLELGATGASLR	1
CLIP2	YSLIDPSSAPELLR	1
NDUFS2	MAPGEIKVDDAK	1
COX4I2	VNPVQGLASHWDYEK	1
ITGA9	SEDCAADLQLR	1
TM9SF1	WSETSVEHR	1
PTX3	LTSALDQLLQATR	1
C2orf72	AVFPPEPGAGKPGGAAAEGAGPGAAR	1
GGA2	NLLDLLSPQPAPCPLNYVSQK	1
SLFN11	EQDAEGQDYCTLTAFTLK	1
SLFN13	EQDAEGQDYCTLTAFTLK	1
KRT23	TFQALEIDLQAQYSTK	1
CNTNAP5	VAEILTGSNLNDGLWHLVSINAR	1
APPL1	LIAASSRPNQASSEGQFVVLSSSQSEESDLGGGGK	1
SUSD2	MQSLQPVVSCGWLAPSPNGQK	1
TBC1D10A	AILDAEPGPRPALQPSPSIHLPLDAPLPGSK	1
ICAM3	CQVEGGSPR	1
GPCPD1	SAGILILPIMSR	1
CASP7	ELEIMQILTR	1
GOLGA8N	NQTAEPLAPEPPAVPSEVELQHLR	1
IGLC7	ATLVCLVSDFYPGAVTVAWK	1
PTPRG	HQSPIDILDQHAR	1
CDKN1B	VPAQESQDGSGSRPAAPLIGAPANSEDTHLVDPK	1
PSPC1	TGSETPQAPVSGVGPVSGGPGGFGR	1
AKR1B10	ACNVLQSSHLEDYPFDAEY	1
MOCS1	GLNEDELLDFAALTEGHPLDVR	1
PPIG	QSSQDDELK	1
G6PD	LNSHMDALHLGSQANR	1
TUBA1C	KFQTNLVPYPR	1
FMNL1	FSESTAMGASR	1
SRP68	YANEVDSDAGAFK	1
EFHC1	NDWGDHYHWK	1
PREP	SNFLVVCYLHDVK	1
ME2	CLFASGSPFEPVK	1
IDH1	VTYLVHNFEEGGGIAMGMYNQDK	1
KLHL15	LDTFLLDNFVPLMSRPDFLSYLSFEKLMSYLDNDYLSR	1
ZNF24	QELPSALESHEVPGTLSMGVPQIFK	1
THNSL2	ETLCQWSTLSYPGLVK	1
HEBP2	SFNGFSSAQKNQEQLLTLASILR	1
ENPP2	VNSMQTVFVGYGPTFK	1
AGFG2	ELGGSSQAGNR	1
LYPLAL1	ILIGGFSMGGCMAMHLAYR	1
ELOA3CP	RPRMAPADSGPHR	1
NOP53	RPRMAPADSGPHR	1
DHRS4L2	QQNVDHVVATLQGEGLSVTGTVCHVGK	1
SLC16A7	SRESEPLSK	1
CEP57	VLDEHIQER	1
THSD4	CVSNIGDVVDNEECNMK	1
ZHX3	VMIPLSSIPTYSAAMDSNSFLK	1
TMPO	AMQADISEAAQILSSDPSR	1
UBE3A	AACSATAMEEDSEASSSR	1
ACSS3	VDDVINVSGHR	1
PPP1R21	EVLAQQVQQSLEK	1
SLCO2A1	FVFSLQTIPR	1
CUX1	LEQDLSIIQSIQRPDAEGATEHR	1
AKR7A2	LQCPQVDLFYLHTPDHGTPVEETLHACQR	1
ACADSB	CIKWMGGVGYTK	1
RBMXL2	GGPDDDGGYAADFDLRPSR	1
SON	QCTVLDTYPGVSEADAGETLSSTGPFALEPDATGTSK	1
SERINC2	LPWVCEEGAGIPTVLQGHINCGSLLGYR	1
MUC13	DSQMQNPYSSHSSMPRPDY	1
PITPNB	TILQNEYMKDDFFIK	1
HCFC1	ISVATGALEAAQGSKPQCQTR	1
DGAT1	ASSAAAPHTVSYPDNLNYR	1
TSKU	ESAARGPTIL	1
RBMXL3	SYGGPCGTAPVWGTPPSYGGGCR	1
EIF2S3	SCGSSTPDEFPTDIPGTKGNFR	1
TCEAL2	IGNEEQPPHEGKPEVACILEDK	1
ENPP3	HLANTDVPIPTHYFVVLTNCK	1
COL6A5	LINLGGENIR	1
P3H3	CVGEAATRPGR	1
SLC25A33	NSTSFFGLMAAAAISK	1
PDLIM7	GTIFCPPCYDVR	1
DMXL2	FGDTEADSPNAEEAAMQDHSTFK	1
LRRC34	AINLNRPILYGEQEESTVHVGR	1
GLYAT	ILSPSGGKPK	1
UGT2B4	IHHDQPVKPLER	1
WDR45B	GLCVLCPNSNNSLLAFPGTHTGR	1
DLL3	CGPGLRPCAPLEDECEAPPVCR	1
INMT	DYLATYYSFNGSPSPEAEMLK	1
COL3A1	GGTGPPGPEGGK	1
LRRC23	LDKEFYEEEERAEADEIR	1
AP3D1	LLESGDLSMSSVK	1
PRR16	VQANAPLIKPPAHTSAILTVLR	1
ZFR	LQSTGNKAEDTKGTECVK	1
PNPLA7	QVFYGEEEQLK	1
HAUS3	EFYVYFLKDEDYLKDTVENLETQSK	1
VEZT	TEYLCENALEGK	1
KCNJ9	VEEEGVGEGAGGEAGADK	1
NRXN1	YVCDCSGTGYIGR	1
F13B	IQENMHYGCASGYK	1
IGHD	EVNTSGFAPARPPPQPGSTTFWAWSVLR	1
HERPUD1	VYPERPHPEDQR	1
PALD1	QVQGGLTVFGMGQPSLLGFR	1
GLYATL1B	VYGSLFHINHGDPFNMEVLVDSWPEYQMVIIRPQK	1
KDF1	STMECPPALIVHPPAGGMASGSSQPWAAASATPMLSSK	1
GLB1	TTLPQDCSNPAPLSSPFNGVHDR	1
CAPZA1	ADFDDRVSNEEK	1
CTRL	LSGVGNVTPAR	1
ELF1	GGATSVLKPGNSK	1
SUN2	FTYDQDSEPIQTFHFQAPTMATYQVVELR	1
RPS27AP5	TITLEVELSDTIDNVK	1
NSUN2	AGEPNSPDAEEANSPDVTAGCDQAGVHPPR	1
ODAD2	TSHENMLIPVVGTLQECASEENYQAAIK	1
GIPC1	SAGGRPGSGPQLGSGR	1
POMT1	ITQGQPLEVAFGSQITLR	1
PCSK5	MEWNGMKWNGMEWNGMEWNGMEWK	1
MTSS1	DAPQGEDMLNAIR	1
ALDH1A3	LECGGSAVEDK	1
MIDEAS	EAAAAAAATHQQALR	1
GYS1	KLYESLLVGSLPDVNK	1
ERF	SGGSAGGLAEGAGVLAPPPPPPQIK	1
CEP55	YSTTALLEQLEETTR	1
APOBEC2	YNVTWYVSSSPCAACADRITK	1
EIF5B	VEGNTVHIEVK	1
FCGR2A	LEPPWINVLQEDSVTLTCWGAR	1
IL12A	QIFLDQNMLAVIDELMQALNFNSETMPQK	1
SUCLG2	LEGANVQEAQK	1
IRAK2	DLLLSEIPSSTASLCSR	1
CWC27	GDAADLVDDGEDESAEHDEYIDGDEK	1
SCARF2	AATDLPGPETPR	1
NOLC1	AALPLPAK	1
SFTPC	IAPESIPSLEALNR	1
SLC4A4	LIVPSQFKPTSPNR	1
DMRT2	CGPISDTLLYQQCLLNATTSVQALKPGASWDLKGPR	1
GPD2	TDPQTGKVHVSGAR	1
POM121C	STPPSPPTHR	1
CTSS	SNPNWILPDSVDWR	1
ARHGEF16	YFHPYIAYCSNEVYQQR	1
SI	TLFDTSIGPLVYSDQYLQISAR	1
THUMPD1	NNQQVPDNTEELGQTK	1
TRAF1	ALCCAGCLSENLR	1
ITIH1	ANLSSQALR	1
AFDN	GHAEQGDPGAPEQTGPQR	1
GALNT2	SGGLSVEMCGPALSQQWK	1
DLG1	VNDCILQVNEVDVR	1
ADH7	FPVIVGHEATGIVESIGEAVTTVKPGDK	1
SERPINA7	GWVDFFVPK	1
FOLR3	RHFIQDSCLECSPNLGPWIR	1
PLOD1	TLEKHADKEDLVILFTDSYDVLFASGPR	1
DDX51	NVIEDLVPIEDIPDVHPDLQK	1
ALDH3A1	LIQEQEQQLVGALAADLHK	1
RNF113B	YCLCEDENHEVGSEEEEIPFR	1
CHL1	THPVEVFEPGAEHIVR	1
CWC22	YTSDKDVPSEQNNYSR	1
NPIPB5	YQDTASTLSGSQDTFR	1
TARS3	LRDEQLNSPYSCQAEGPCLTR	1
LDHC	LLEDDENSQCK	1
GRIPAP1	EAGKFSAVSEGQGDPPGGPAPTVLAPMPLAEVELK	1
SLC14A1	ALGYVTGDMKK	1
LONP1	VLFICTANITDTIPEPLRDR	1
ADGRE5	GPFTYISPSNTELTLMIQEQGDK	1
AIMP1	QIAFPSGTPLHANSMVSENVIQSTAVTTVSSGTK	1
ABO	DHVGVEILTPLFGTLHPSFYGSSR	1
IGKJ4	VTFGGGTK	1
SGCD	EIQSQPGNALYFK	1
ACO1	EPLGVNAQGQQVFLK	1
PTPRJ	YTYDDFKK	1
ASAH2	NSVQNQNHQTFLTVEK	1
TUBA3E	AFVHWYVGKGMEEGEFSEAR	1
B3GNTL1	LDLTGGTFEDNLR	1
STAT2	IEEIMPNGDPLLAGHNTVDEVYVSR	1
SAMD15	EYYAIGSLR	1
DDX1	KAQTSFLHLGYLPNQLFR	1
FMR1NB	ENQVVKPCNELQDLSESECLR	1
PRR15	SSEEAGFPGDPHEDKQ	1
REPIN1	LPLPCPECGHR	1
R3HDM2	HSDLAALYTIVAVFPSPLAAQNASLHLNNSVSR	1
RAB3IL1	ESPGALVETSAGEEAR	1
F2	NPDSSTMGPWCYTTDPTVR	1
GCAT	GILEGELEGICGAGTWK	1
TBXAS1	EAAEDCEVLGQR	1
PEX2	LLGIHSVFCKPQNIR	1
NANS	ALDRPYTSK	1
CUL9	LDNLFLEQEDEEEK	1
TNRC6A	VLNSQSESSALTNQQPQK	1
GTPBP6	GSPDVTCVFLNVER	1
GLI4	IHTGEKPYECADCGK	1
RPS6KA1	EITPPFKPAVAQPDDTFYFDTEFTSR	1
ANO10	VTLSALDTSESSFTPLVVIELAQDVKEQTK	1
DLAT	QTIPHYYLSINVNMGEVLLVR	1
LYAR	EQNQRPLHPVANPHAEISTK	1
PGD	FQDTNGKHLLPK	1
USH1C	IVTDYTLAEADAALQK	1
PALMD	EKWLLDGISSGKQQEEMK	1
SHF	ETATQPLPLYDTPYEPEEDGATPEGEGAPWPR	1
PITPNM3	LDEHQGEGTTPCTSSILQEK	1
CTDP1	IGSVLAVFEAAASAQSAGASQSR	1
CNNM1	APTTQGTPQTPKDDPAITLLNNR	1
GCKR	TNHIQALAHSTVGQTLPIPLK	1
STARD7	EQPWEMVMDK	1
ATXN2	SLKPQQQQQQQQQQQQQQQQQQQQQQPPPAAANVR	1
DKK3	SLTEEMALGEPAAAAAALLGGEEI	1
PLD2	TPIYPYLLPK	1
ABCD4	SQDCEILGESK	1
SPTLC3	DNWNRPICSAPGPLFDVMER	1
KIZ	VAVQEGINSGTAMSR	1
PKD1	VLTTGPTPSSFPR	1
CD33	EGAIISGDSPVATNKLDQEVQEETQGR	1
AHCTF1	DDAQSVETVGKPK	1
ADAMTSL4	EACDVGPCTTAWFHSDWSSK	1
POR	EPVGENGGR	1
FILIP1L	DSPSESDVILLCPK	1
WNK2	SEVCGGELALPPVPK	1
QRSL1	DSTTVHEPISKPFMLPSLADVSK	1
PDZK1	AGVLADDHLIEVNGENVEDASHEK	1
ITGAE	TCSLSYVAGAPQYK	1
QSOX2	VAALDCMEEENQAVCHDYDIHFYPTFR	1
WDR4	SQENKGEDAPLDQGSGAILASTFSNSGSYFALTDDSKR	1
TEFM	QFLFDSLLK	1
ABCC4	MLPVYQEVKPNPLQDANICSR	1
EPHX2	GGPEGATTWLMK	1
KRT32	ADLEAQVEYLK	1
LAMP3	DEESYYISEVGAYLTVSDPETVYQGIK	1
GPR158	KEEVWDSFKV	1
BNIP2	ASSGDIGSLDYQEFVVDIESR	1
PIK3AP1	EWQLNQKR	1
F12	LCHCPVGYTGPFCDVDTK	1
ATP4A	NIAFFSTMCLEGTAQGLVVNTGDR	1
ENOSF1	TLVSCIDFR	1
LAMB3	SFSGLLTMYQR	1
PIGQ	AFFPTCCVSADSGLLVGR	1
NPNT	CQCPSPGLHLAPDGR	1
ISM2	TCDLPSCPGTEDKDTLGLPSEEWELLAR	1
TRMT1L	EKSNDILEEGEKNLGNIK	1
GFM1	GIIDLIEER	1
RGMA	AAAGLPLVPR	1
PTPN21	FQDVLPYDDAR	1
OTUD7A	DAATAAAAAAAAAATAK	1
MRPL41	DFKDGTFDPDNLEEYGFEPTQEGK	1
LRPAP1	LIHNLNVILAK	1
STAU1	VTFFEPGSGNENGTSNKEDEFR	1
CWH43	EGHNYENNHNFHMNTPK	1
UQCRC2	ANYHGGEIR	1
PPID	MSNWQGAIDSCLEALEIDPSNTK	1
GDF15	ARNGDDCPLGPGR	1
ZNF773	AEEAPEQSASVEVPSSNVQQHQK	1
CAPN9	AQFDKVEICNLTPDALK	1
DENND5B	SQGAANTTSGENFDQSPLKR	1
PARVB	NAINSPMSPALADVHPEDTQLEENEER	1
SPEG	GTQDSSAVPSAAHQEAPVTSGPAR	1
IGHV2-26	ALEWLAHISSNDEK	1
ACAD9	DSLGQTVDLGLTGNHGVVHPSLADSANKFEENTYCFGR	1
WDR91	NASLSQSLR	1
PANX1	AIAHLATEYVFSDFLLKEPTEPK	1
LMAN1	NSLSETVR	1
NUP133	SSFYSLTSSNVSK	1
AKAP3	AQLGNESSVDEVSFYANR	1
DHX57	TTQIPQFILDDSLSGPPEK	1
TUBG2	KEDVFKDNFDEMDR	1
UBA6	EIFISNITQTNPGIVTCLENHPHK	1
CD207	FWIPGEPNDAGNNEHCGNIK	1
OBP2A	GLSEEDIFTPLQTGSCVLEH	1
IQSEC1	YCICNSGVVR	1
SLC12A8	SLQSPQEQIILAPSLAK	1
STX17	TVIPTDLER	1
MCCC1	QYNIVGLPTNIDFLLNLSGHPEFEAGNVHTDFIPQHHK	1
DNAH17	DINVEQMDVDCK	1
CRTC1	PAGISPLSLSTEAR	1
CLC	GRPLVCFLNEPYLQVDFHTEMK	1
NAA25	GLETHIIALK	1
TMA16	LQWFQNHLDPPK	1
CPA3	AIFMDCGIHAR	1
NLRP6	LLIAPESAAPEEALGPAEEPEPGR	1
APOL1	SKLEDNIRR	1
TBC1D12	GVGAGGPEEGAPPATSAQR	1
MYBPHL	FTQPLANCTTVTGYNTQLFCCVR	1
NEK1	EANHSEGQEGSEETDMR	1
MBD1	LLPSVWSESEDGAGSPAPYR	1
MMS19	HPAGQQLDEFLQLAVDKVEAGLDSGPCR	1
SHROOM3	GQEEMLLLFHHLTPR	1
IFIH1	ADESTYVLVAHSGSGVIER	1
PODXL	GGSSGNPTTTIESPK	1
TRUB1	ATDTLDSTGK	1
MAP7D1	RRPESSPVQK	1
GRHL2	AENFTPVFMAPPVHYPR	1
NOTCH2NLC	MWICPGGGGGGGGGGGGGGGGGGDR	1
ODR4	GNTQATSHCFDVR	1
PNPLA6	ETPGRPPDPTGAPLPGPTGDPVKPTSLETPSPPLLSR	1
apol1	SKLEDNIRR	1
ATP9B	DKQVNSQLYSK	1
CNPY1	ALMDEIEHDITK	1
FOXJ3	EDALPTRPK	1
MYOZ3	FNHTAIPK	1
COPE	APPAPGPASGGCGEVDELFDVK	1
SELP	AVQCQHLEAPNEGTMDCVHPLTAFAYGSSCK	1
PPP1R13L	LQNAFWEHGANR	1
SYNPO	SSPGLYTSPGQDSLQPTAMSPPYGGDISPVSPSR	1
NTAN1	KHPSPANTLFPGNK	1
MUC17	SSPTTSEGTSMPTSTPSEGSTR	1
DMBT1	GSWGTVCDESWDTNDANVVCR	1
SLC25A26	LQSPQGFNK	1
IGKV1-37	LLIYSASSLQSGVPSR	1
TBX3	ITTTTSEEPCR	1
PLEKHO2	VSWENPSPQEAPAAESAESSQAPCSETSEAAPR	1
TRAF3IP3	FLENEHQELQAK	1
ZNF326	SMDSYLNQSYGMNNHSGGGGGSR	1
YBX2	GGGAGGGGGAASGPAAGTPSAPGPR	1
SH3PXD2B	ASSDMSASAGYEEISDPNMEEK	1
ARHGEF17	ASCSSSSSIAASYPVSR	1
ATP5PO	SLNDITAR	1
LYZ	YWCNDGKNPGAVNACHLSCSALLQDNIADAVACAK	1
MRPL45	TVMIPGPQLKPEEEYEEAQVEAQKPQLA	1
GPX8	FWRPEEPIEVIRPDIAALVR	1
GATM	HGGHYFPK	1
VSIG10L	EVLLHPLVAETQLGEAEVALEASGCPPPSR	1
ERMP1	EAGAQEPLVDGCSGGGR	1
SMC5	VAALNIQVGNLCEFLPQDKVGEFAK	1
PSG7	DLYHYVTSYVVDGQIIK	1
RNF168	ASGQESEEVADNYQPVR	1
GYG2	ASPGHTLCR	1
NSFL1C	ASSSILINESEPTTNIQIR	1
AQP9	AEQSEDKPEK	1
CHD1L	KMYELAGK	1
ATP2B4	DALTQINIHYGGVQNLCSR	1
GPN2	ANGYCFGAQEQR	1
KIDINS220	SSESSPNHSLHNEVADDSHLEK	1
UGT1A6	GFPCSLEHAFSSSPDPVSYIPR	1
ARHGAP6	WQGSPAELESDTQGAR	1
RIPK2	KQPFEDVTNPLQIMYSVSQGHRPVINEESLPYDTPHR	1
TCOF1	SAHTLVGPTR	1
SIL1	MFAKEEAELTQEMSPEK	1
PCF11	LHVSQIPTMAVK	1
PLG	CSGTEASVVAPPPVVLLPNVETPSEEDCMFGNGK	1
KIF16B	HSTLGTEIEEQR	1
NTS	MTLLNVCSIVNNLNSPAEETGEVHEEELVAR	1
ACOT11	DLLANCAIQDDLESR	1
AKR1E2	LNYLDLYLIHWPMGFKPR	1
DSC1	AASSQTPTMCTTTVTIK	1
ABCG8	MPGAVQQFK	1
GLDC	VFEDGTLGISLDETVNEK	1
LCP1	VNDDIIVNWVNETLREAEK	1
RIF1	AATMENAVLLETNTVEEK	1
TRIP6	EEAAGISGPAGR	1
SPAG7	RGEEWNPQKAEEK	1
BRSK2	QDAGVLGLR	1
RCC1L	GEVYSCGWGADGQTGLGHYDITSSPTK	1
SIRT5	FHFQGPCGTTLPEALACHGNETVS	1
TBL3	ALLPKNTAPDNGPILLQAQTTQR	1
INSL3	RPAAGGDRELLQWLER	1
THG1L	LQGTLAADKNEILFSEFNINYNNEPPMYR	1
SLC27A3	ALAAAAADPEGPEAGCSLAWR	1
MLC1	LQGASWDTQSGPQER	1
CCT5	VAIVHLDK	1
DPCD	HQLPLDDASLSFAHANCTLIISYQKPK	1
PDLIM2	SRPPGCYTCADCGLNLK	1
CHMP1A	CDLVSLQPLPPGFK	1
NAAA	NLDYPFGNILR	1
SLC18A1	NNCLQGTGFLEEETTR	1
BAZ2B	INENIAAASSTLFSSPVNLSTSGR	1
SCARF1	EAEESTGPDEAEAPESFPAAASPGDSATGHR	1
DDX20	LQTEAQEDDWYDCHRETR	1
EIF3A	GMDDDWGPR	1
ADH1A	VCLVGCGFSTGYGSAVNVAK	1
GLCE	WDYHTTHINQLQLLSTIDESPIFK	1
RABEPK	YQWDLDTCK	1
SURF6	KAEEAMEAQEVVEATPEGACTEPR	1
ALG8	SYCFTASKPDGSIR	1
IRAG1	SSPGDSPSAVSSNLSPSASPTSSR	1
COL7A1	ELETPLAVPGLR	1
FABP6	ESNIQTIGGK	1
ZC3H3	GSLEEYEDTPWSDQRPR	1
LTA4H	DDDLNSFNATDLK	1
TSPYL6	EAGPGPGPLNVGLHLNPLESIQLELDSVNAEADR	1
CYP11A1	HQAQGDMATMLQLVLLLK	1
CRAT	SPMVPLPMPK	1
ZG16B	YFSTTEDYNHEITGLR	1
RINT1	SDINVTVLIGCK	1
ZFYVE16	EQQNDTSSELQNR	1
PPIL3	TYRPLNEVHIK	1
RESF1	MTNTTYSEPAQNSK	1
HS1BP3	LSPQDPSEDVSSMDPLK	1
GSTA2	ALIDMYIEGIADLGEMILLLPFTQPEEQDAK	1
TBL2	LALSPNAQILALASGSSIHLYNTR	1
BST1	HFMPLSDVLYGR	1
NADK	TAVHNGLGEK	1
CYP27A1	DFAHMLLLK	1
ALB	AAFTECCQAADKAVCLLPK	1
RABGGTA	AAYLDDLR	1
ACLY	HLLVHAPDDKK	1
MRPL50	VRDVFDFYNVPIQDR	1
RPH3A	HPARAPAQGDSEDR	1
LPCAT1	TYGAQEDGSVGEGDLSCILK	1
CAPN7	TSYETTDKVLQNK	1
LAMC2	CIHNTDGIYCDQCK	1
MRPS17	VIDPVTGKPCAGTTYLESPLTSETTQLSK	1
AGXT	DIVSYVMDHFDIEIMGGLGPSTGK	1
USP47	EGSVGSTSDYVSQSYSYSSILNK	1
CFAP74	VVGVAIDLPVWVPKPSVDLK	1
PIKFYVE	FYMQIFQLSNEQTKTLMFFEGCPQHLGCTIK	1
ACSF3	YGMTEIGMALSGPLTTAMR	1
SNX30	TRPLEFAAMGDYLDTFALK	1
CEP70	IGELEDESLNR	1
ITGA6	DSMFGITVK	1
WDR36	VGVTALQQAPAVDVVAVGLMSGQVIIHNIK	1
PGGHG	VSIACLAPGSGPITLLLR	1
NCAPG2	EASDPFSLNELLDELSGK	1
SGCG	LYLSVAGVSTTCQEHSHICL	1
ZNF830	EASQGSSASSAPQSVK	1
COL23A1	GADGAAGPR	1
NTN4	ALSPPHDTENPYSAK	1
WDR17	FGGGIGVPTKEER	1
RELA	ELSEPMEFQYLPNTDDRHR	1
DCP1B	CDPSTPVPASSAALNR	1
POLRMT	QYWEALGAPEALR	1
MAGEA10	AEILESVIK	1
CLDN23	YYSDGQHRPSPAQHR	1
EXOC4	TLSTSDDVKDRENEK	1
EFL1	LAAAQGQAPLEPTQDGSAIETCPKGDEPR	1
RRAD	DLQAALTPGALTAAAAGTGTPGPR	1
TRIM25	LQELTPSSGDPGEHDPASTHK	1
RDH13	DIRGETLNHHVK	1
FEZ2	SLLDQENCNASPEPGAEAGAGAGGGADGFPALACSLEEK	1
C10orf71	CMANKVMEDPGQGSSMAR	1
DMAC2	LGAAVAPEGSQK	1
SCRN1	CICNQLSLTTK	1
ROCK2	ENLLLSDSPSCRENDSIQSR	1
WDR33	GMQGAPPQGSMLGPPQELR	1
OTULIN	YNTEEFITVYPTDPPKNWPVVTLIAEDDR	1
CLTCL1	AHMGVFTELAILYSK	1
ALCAM	SSNTYTLMDVR	1
PTBP1	WEVISLGLPFGK	1
LRBA	FVCNPLGSTHPEATLK	1
EP300	MEVDQPEPADTQPEDVSESK	1
LIMD1	VSPGLPSPNLENGAPALGPVQPR	1
FIZ1	VSHGEGGGEEAAAAAR	1
COL10A1	YQTPTGIK	1
COL4A2	IAIQPGTVGPQGR	1
PFKM	LQAAYNLVK	1
NIPSNAP3A	YDNFAHRTEVQK	1
SLC4A1AP	SLQEEQSRPTTAVSSPGGPAR	1
CACNA1S	CQEEYYGYRPK	1
FRK	SLQAEPWFFGAIR	1
FUCA2	VNGEAIYETYTWR	1
SEC23IP	LTLDESYDLVVENEEVLTLQETLEALSLSEYFSTFEK	1
TMEM177	SLLGKEGEKLYTPSGNIVPR	1
SERPINA10	NLELGLSQGSFAFIHK	1
TKT	LGQSDPAPLQHQMEIYQK	1
CD200	EQLYTTASLK	1
OBSL1	HQDSGALVGFSCPGVQDSAALTIQESPVHILSPQDK	1
GORASP2	VGDFTPVSEK	1
PKHD1L1	IAYHSANANSHFSSPTQR	1
ATL3	ESGHSNWLADPEEPLTGFSWR	1
DES	DGEVISEATQQQHEVL	1
C8G	GAVNVVVAETDYQSFAVLYLER	1
HSPB6	YRLPPGVDPAAVTSALTPEGVLSIQAAPASAQAPPPAAAK	1
ECHS1	IFEEDPAVGAIVLTGGDK	1
SPATA7	AAVDCSVPVSMSTSIK	1
KDM5A	AQEAMTDETPDSSK	1
ADAM28	DNPMSTPK	1
B9D2	YVAQAGLDLELLRSNRPPTSASQSAR	1
NPTX1	CESQSTLDPGADEAR	1
AHDC1	AASYGLTPATSDCR	1
MAGEB10	DVSQSSLDGASNNPHGLQEAQSTSTSATAASHTR	1
CCDC154	RPGGVPEKPHSR	1
TOPORS	EEGEAPSPAPASEGR	1
CLMN	SSESDHFSCVQLR	1
WARS2	KAVTDFTSEVTYDPPGR	1
srpk1a	LCFVALDFEQEMATVASSSSLEK	1
FIG4	HLPLPYDEVICAANLK	1
RDH5	VLASCLTPSGAEALQR	1
CAMK1D	MEGKGDVMSTACGTPGYVGK	1
ACOX2	DSVQHLQTLTQSGADEHEAWNQTTVIHLQAAK	1
KLK13	VEAAEQVR	1
CELA3B	LQQALLPVVDYEHCSR	1
NUP153	KPAFNLSAFGTLSPSLGNSSVLK	1
CAMKK2	DRPLEADGQEVPLDSSGSQAR	1
PTK2B	SLDPMVYMNDTSPLTPEK	1
NT5C3B	NSSVCENCGYFQQLEGK	1
ADAMTSL1	TSPLGTQLVLGPGNSALLGCPIK	1
COL12A1	IGVLITDGKSQDNVEAPSKK	1
DDT	ELALGQNR	1
PRL	AINSCHTSFLATPEDKEQAQQMNQKDFLSLIVSILR	1
CDKN2AIP	ASEAEAPDKHGSSFVSLLK	1
MEDAG	LQPGAFQLSGDQLVVAGPGEPAAAR	1
THEM5	NLIPVGSLVVMDVEVDKIEDQK	1
KLK3	LSEPAEITDAVK	1
MYO18B	RDQSIVALGR	1
CFAP46	MSGDEAVNQGEASQTLK	1
RPL10	YIPNRGPLDK	1
ACAP1	EAEAAQGQTGDETYLDIFR	1
PRRC2A	GSEGKPSLTLPASAPAPEEALTTVTVAPAPR	1
DOCK5	SQVIAEKEPEPDLMSPTR	1
PYGL	WIDTQVILALPYDTPVPGYMNNTVNTMR	1
ZFP36L2	EPSGGGSTALLNK	1
ABCB10	LYNPASGTISLDGHDIR	1
EMD	EDLLYQSKGYNDDYYEESYFTTR	1
TJP1	EAVQQQQNQLVWVSEGK	1
SPINDOC	TPPPRPSPLQAGSDGCEEPK	1
CD200R1	ASQALQSEVDTDLHTL	1
ZZEF1	AVHEEVRPVDFK	1
HERC1	IPQDTTQTNVTSAEGWWDQESNCQDGYRK	1
PHACTR4	TFQVVPEIEFPPSLDIHQEIPQQEDQKK	1
NCAN	QDLSILVAK	1
PRKG1	GTVSVTREDSPSEDPVFLR	1
RGPD1	QTLPVTLR	1
KLHDC4	TQTVEVPCPPPSPR	1
CCDC105	DTLNFCFKERLQAVDLTNQPLDK	1
C6	SVLRPSQFGGQPCTEPLVAFQPCIPSK	1
DHFR2	ELKEAPQGAHFLAR	1
DCC	VVVLPSGALQISGLQPGDIGIYR	1
NPHP4	VGEEEILIYINDHENKNEEAFCVK	1
CYS1	RSPESLPAGPGAAALEGGTLR	1
FBLN1	AAQAQGQSCEYSLMVGYQCGQVFRACCVK	1
MROH1	LASTLLDAITDKDPLVQEQVCSALCSLGEVRPVETLR	1
LRIG1	AEAPYLLVSNGHLPK	1
CYP4F3	LVHDFTDDVIQER	1
IGHV1-58	ASGFTFTSSAMQWVR	1
TDRKH	AVPNMLKDMATETDASLSTLLTETK	1
DNAAF5	LFSILSTALLR	1
STOM	NSTIVFPLPIDTLQGIIGAK	1
TTBK2	TLNNKFFSFIDKVR	1
GINM1	DVTEIDILIK	1
DNAH11	NMSFTSGNMK	1
AKR1C2	LAIEAGYHHIDSAHVYNNEEQVGLAIR	1
IGLV3-22	DGERPSGIPER	1
FAM13A	AIKPSIEATLESIQR	1
DPYSL4	AVGKDNFALIPEGTNGVEER	1
TASOR2	NAHVPIQTEGVNTADEPTTFKK	1
ARMT1	CGTDWEEYIK	1
MMS22L	SLDYLGEVLK	1
UROS	IGLVTEGETCGNAEK	1
MYLK2	GGGPAEDSAGPPAALPQQTATPETSVK	1
EPB41	ISLLDDTVYECVVEK	1
OR52E2	VVSVIDLGVFVR	1
PGP	TILTLTGVSTLGNVKNNQESDCVSK	1
DENND3	EDSQTAGANCGTLGK	1
CHIA	NGATQGWDAPQEVPYAYQGNVWVGYDNVK	1
MOGS	FISGHTSELGNFR	1
KRT78	FGEWSGGPGLSLCPPGGIQEVTINQNPLTPLK	1
BCHE	VLEMTGNIDETEWEWK	1
AZU1	CQVAGWGSQHSGGR	1
CCAR2	NSQATASTSLLGPPPGLLTPPVATELSQNAR	1
EEF1B2	YGPADVEDTTR	1
ACTBL2	VAPDEHPILLTEAPPNPK	1
ACOT9	SLEICHPQQR	1
PTGR1	TSELPPLK	1
TMPRSS11E	QAQVTLIDATTCNEPQAYDDAITPR	1
RNF130	SALGNLAGDNSLGLEPLR	1
CYFIP1	SGNGEGTPVEHVR	1
TMEM70	EEFILYMEEASEEK	1
DCTN2	LTAVLLAK	1
QSOX1	NNEEYLALIFEKGGSYLAR	1
USP24	NTFQLLHEILVIEDPIQAER	1
FNIP1	ELLGISDECR	1
SUSD5	LFVLESQNGSQGLQLEAAR	1
ZFYVE26	HFLEQILFPSSPR	1
HORMAD1	DKDVEDEQEHYISDDLDIETK	1
PPP6R3	DAEECPETAEVK	1
NXPE4	HCYPLIGSMTYSVK	1
POLR1B	IVMEEGCLTQK	1
SHMT1	EEVESFASFFPLPGLPDF	1
GNAS	VPSLGYGSPAAGAASADTAAR	1
NUGGC	DVFGQEPHPVEDDLYKEPTR	1
GNL3	NSLEFFTMLAQR	1
HNF4G	SMIYKDILLLGNNYVIHR	1
TRAPPC5	VFSVAELQAR	1
SH3RF2	ASQPEAASLGPEMTILFAHR	1
LEMD2	GLVYPARPAQLR	1
CMA1	GDSGGALLCAGVAQGIVSYGR	1
WDR81	DRLVAGEDDLEQATEALDSISLAGK	1
MYH1	TPGAVEHELVLHQLR	1
ZNF793	DPLSAVNAGNRLVRSHTSMYIEK	1
KYNU	GCQLTITFSVPNEDVFQELEKR	1
HNMT	VQAQYPGVYINNEVVEPSAEQIAK	1
PCCA	MADALDNYVVR	1
EXOC2	GSSFQSGRDNTWR	1
MMP24OS	HPPQPQPQPQPQPQPQPEPEPSPWGPLDDVR	1
CPVL	QVGDFHQVIIR	1
UAP1L1	TLYQLQAQR	1
LRP4	NTIAVGVDPQEGK	1
GSTZ1	IDGITIHQSLAIIEYLEETRPTPR	1
KRT3	GGGGGIGGGFGGGSSGFSGGSSGFSGGSGFGSISGAR	1
RAVER1	GSGLRGPLSRFYSGSPTSYFTSGLQAGLK	1
NIPA1	GTAAAAAAAAAAAAGEGAR	1
ALOX12	LVLPSGMEELR	1
SQOR	ALQNFKEGNAIFTFPNTPVK	1
ADAMDEC1	ECTSLCCEALTCK	1
CYP4A22	VWPNPEVFDPSR	1
CYP4A11	VWPNPEVFDPSR	1
PWP2	GNLNFTCNGNSVISPVGNR	1
Pwp2	GNLNFTCNGNSVISPVGNR	1
RAB11FIP1	AELQTESLTPVPNSGSSVLGSLFK	1
CEP85	ETEFSSAGHSLQDK	1
CPN1	YGDPNHHLPLPDNWK	1
SRRM2	SSTGPEPPAPTLLLAER	1
IGF2R	SVISFVCRPEAGPTNRPMLISLDK	1
MSLN	QLLGFPCVEVSGLSTER	1
LVRN	LQFIDDAFSLSK	1
EHD4	SISIIDSPGILSGEK	1
APBA3	ESGIDPSQVGVHPSPGAR	1
RIBC2	GDLLSENPQQAASSLGPHR	1
THNSL1	SWYSTHSIVGDK	1
SKA3	ILYDLHSEVQTLKDDINILLDK	1
THBS3	SHCGPNPCFR	1
VIM	LHEEEIQELQAQIREQHVQIDVDVSKPDLTAALR	1
TSC1	LMLLNTPGQLPQTLSSPSTR	1
IGHV4-28	GLAWIGYIYYSGSTYYNPSLK	1
POM121	ETVLNALK	1
FAM90A26	ILGATLLK	1
KRT31	QLERDNVELENLIR	1
KCNJ5	LFLVSPLIISHEINEK	1
CRYBG2	EVVQGSSAPAASSPTWK	1
ALDH18A1	LIDIFYPGDQQSVTFGIK	1
MFGE8	CVEPLGMENGNIANSQIAASSVR	1
AP3S1	SETGLAGAPAR	1
NSUN5	TCSNDVVDYFKR	1
PLEKHA1	HAFRPTNAAAATSHSTASR	1
MRM3	VVFPSEEVVEQK	1
CALHM6	STEGDTVIPVLGFVDSSGIK	1
C18orf21	SNPATPASK	1
CEACAM6	SDPVTLNVLYGPDGPTISPSK	1
TYSND1	AGSEVLAAAGAVFLPGDSCR	1
NAXD	AYSPELIVHPVLDSPNAVHEVEEWLPR	1
DLC1	STCNVVHDEFLDIPCTNR	1
LRRC6	DHLQAPDIEEHNTK	1
SFTPD	TAGFVKPFTEAQLLCTQAGGQLATPR	1
RAD51D	TQDEEEQAEALQR	1
MOCS2	SKDVINFAAEK	1
NEBL	GKPVLEFVETPSYQASK	1
TMEM214	HLSQSSLLLEHLLSSWQQIPK	1
CRISP3	TPNSVVGHYTQVVWYSSYLVGCGNAYCPNQK	1
PELO	EQFCDYMFQQAVK	1
ZAN	KLPPSTAIK	1
SERPINI2	ACAGMISTWVERK	1
ACSBG1	CTLDPDTSDQTDNLTEQAVEFCQR	1
SHMT2	GWTGQESLLDSDPEMWELLQR	1
ANXA4	ISQTYQQQYGRR	1
ACTG1	YPVEHGIVTNWDDMEK	1
CD55	IFLCCPGWFQTPGHK	1
ZSCAN18	RPHPEDGDEQSLEGVSSSGDSAGLEAGQGPGADEPGLSR	1
CINP	WETLNDAGFTTANNIAK	1
CPZ	FPPEEALYTLWQHNK	1
NACA	VLPKPESASVSAAPTPPVSLPLAPSPVPTLPPK	1
SHROOM2	CLFDSLQPER	1
SLFN5	NGYSLKDIAVLFTK	1
C5	EESSSGSSHAVMDISLPTGISANEDDLK	1
LTBP1	QECCCTSGAGWGDNCEIFPCPVLGTAEFTEMCPK	1
MMRN2	AEAEDTSKDPVGR	1
COMMD3	GFQMLADPGSFDSNAFTLLLR	1
HMGN1	VSSTEGAAKEEPK	1
AKR1C4	YVVMDFVMDHPDYPFSDEY	1
LIPC	LSPDDASFVDAIHTFTR	1
LRWD1	QPPLLLAALQAPTQILK	1
DDX31	SEYSSGMEADVAK	1
IGHV1-3	SEDMAVYYCAR	1
FAM160A2	GPGSPSVDSSSVMTVPRPSTPSR	1
IRS1	VGNTVPFGAGAAVGGGGGSSSSSENVK	1
UGT1A8	GIGCHYLEEGAQCPAPLSYVPR	1
POTEM	MVAEAGSMPAAFSVK	1
POTEH	MVAEAGSMPAAFSVK	1
CASR	NAMAHGNSTHQNSLEAQK	1
GSTM3	MAQWGNKPIC	1
REG1B	ESSTDDSNIWIGLHDPK	1
ZNF22	SFGQSSTLFQHQK	1
PLPP7	GPYEMSPSLLDYLTMDIYAFPAGHASR	1
CLEC4M	NWHNSVTACQEVR	1
TSTD2	HVATQHADEIYHQTDSILK	1
B3GLCT	LQHLLSCYDSGKPVFLGER	1
NEK5	SWLTTTSASQDIEK	1
JPH2	TKAEAAEQAALAANQESNIAR	1
PCDHGC3	KTGEMFVNDRLDR	1
GMPR	AFGAGADFVMLGGMFSGHTECAGEVIER	1
HP1BP3	GKASGSFVVVQK	1
PPP1R3G	SFLDVPAELQPEPLEPQQPEAQSGASEPGSGDAK	1
FERMT1	DKNNKEPTIEDILNLESSPTASGSSVSPGLYSK	1
SALL2	RGEESPGHFLVAATGTAAGGGGGLILASPK	1
PPIC	VIDGMTVVHSIELQATDGHDRPLTSCSIINSGK	1
TRMU	HVVCSLSGGVDSAVAALLLR	1
GEMIN5	SSSSYHTWNTGTEGSFVER	1
AOC1	SSFGLQVLNVHFGGER	1
CETN3	SLALRSELLVDKTK	1
WDR47	VLPFNAETCNATVSGPDLEFSMHDGTIR	1
ELAC2	SSDSELNENEPHLPHGVSQR	1
PEAK1	LENLLLVHYQPGGTAQGFGPAEPTPTSSYPTR	1
H3-2	FQSSAVTALALQEASEAYLVGLFEDTNLCAIHAK	1
TACC3	ALNSASTSLPTSCPGSEPVPTHQQEQPALELK	1
CCL14	IMDYYETNSQCSEPGIVFITK	1
NPEPPS	AFFQSHPAPSAER	1
PLIN2	SQQTIPQLHSTVHLIEFAR	1
GALNT4	FNSVTELCAEIPEQK	1
GSDME	NTVLQQVLEGR	1
KIAA2012	LQEQQRQEEEER	1
NPIPB13	TPAMIISR	1
AHSG	KTHTVVQPSVGAAAGPVVPPCPGR	1
TRIM32	IIDTAGLSEAVGLIMCR	1
RRS1	QMREENQEEAAKR	1
APLP2	GSGVGEQNGGLIGAEEK	1
KIAA0040	ISAFFSSVWDTILTK	1
TTC22	LVSNSWAQAVLPPPPK	1
SYNE3	ANLQEEEGSHEDFSQLLR	1
BIN1	VQAQHDYMATDTDELQLK	1
COG3	VSDLAATAYK	1
C2orf69	QCLQLSTVPGAEPQR	1
PCMTD1	MEEDIKEEEEK	1
SREBF2	GDFAAAAANLQTCLAVLGR	1
SHANK2	SMTSELEELDKPEEIVPASKPSR	1
ABHD16A	LVEECDGRR	1
MPC2	LLNKVELMLPEK	1
ALG2	ERDPVPKPSVLFLHPDLGVGGAER	1
ITIH2	ICPSCRETAVDGELVVLYDVK	1
WNK1	TLSPEIITVTSAVGPVSMAAPTAITEAGTQPQKGVSQVK	1
IGHV1OR21-1	DTSMSTAYMEISSLR	1
THEMIS2	WLDLTVVEAK	1
PNLIPRP2	LLPWSPEHIDTR	1
VMAC	AELLQDICHR	1
SETD6	QSVQAGELLFVVPR	1
KCTD3	AGGHCGSVPAAAAGSGEIVQLNVGGTR	1
GAMT	MEVMALVPPADCR	1
PDHA1	GPILLELQTYR	1
ALG12	LHQLVPPQTDVLLHVDVAAAQTGVSR	1
CD5	LSAYPALEGVLHR	1
MX2	NTKLELQDPGQVEK	1
MAST2	SGLITSQYFYELQENLEK	1
MTDH	AEPSAWSQDTGDANTNGK	1
NCAM2	AVDGFTFTEGDKSPDGR	1
ALDH16A1	GATACDLVQR	1
UCHL1	MQLKPMEINPEMLNKVLYR	1
GRK5	EIFSACAQSVHEYLR	1
ACOX1	HQSEMKPGEPEPQILDFQTQQYK	1
IGHV5-51	ASDTAMYYCVR	1
RAD23A	SPSEESAPATSPESVSGSVPSSGSSGR	1
KRT1	GSYGSGGGSYGSGGGGGGHGSYGSGSSSGGYR	1
CLEC1B	NYLQDENENR	1
TMEM231	ALYEVFSHPVER	1
ADAM12	ADEVVSASVR	1
TARS1	FENEEAQAVYWHSSAHIMGEAMER	1
LRRC17	SEQLCNEEK	1
ADHFE1	LAPRPQSEEDLAALFEASMK	1
RUNDC1	GCPHVLGYEGPGDPASDEGDGLPGDRPR	1
TOPBP1	GYMLSEEPYIHANYQPVEIPVSHQPESK	1
TEKT1	ENTIYINEVLCMQMR	1
ATXN7	QVSSLSSSPSTPSGLSSVPSSPMSR	1
TRMT5	EQLMQLLGLSK	1
NAT9	LTASEPLTLEQEYAMQR	1
MMP3	YLENYYDLEK	1
EHD2	FGAFHSLALEDADFDGKPMVLVAGQYSTGK	1
GNB1L	ALAVWSLDGQQALQVR	1
COL1A2	GHNGLQGLPGIAGHHGDQGAPGSMGPAGPR	1
CSH1	YSFLHNSQTSFCFSDSIPTPSNMEETQQK	1
LDAH	QVPELPVIR	1
FAM186A	MIQVFNQLK	1
SP100	TSLNEQTYTR	1
GSR	RDAYVSCLNAIYQNNLTK	1
CLOCK	ELGIEESIPETAADK	1
SEC16A	QSGPGAPNLDCFYQQVTK	1
TJAP1	ELEIGQNCLELELGQSR	1
MSRB2	GQAGGGGPGTGPGLGEAGSLATCGLPLAK	1
MOCOS	LRPVSTPGK	1
ANXA8L1	VYEEDYGSSLEEDIQADTSGYLER	1
MCM5	NTLSNIAMRPGLEGYALPR	1
CROCC	QALLQAQLEEQLQDK	1
PEBP4	HWLVTDIKGADLKEGK	1
ARL15	SVQELKKYFELEPLAR	1
PYCR3	HVGSSETNLLQHLLEACGR	1
ZNF318	ELSEGIVDEGASTSIGPHSIDDSNLNHGNR	1
SIGLEC9	DEAEFTCR	1
DROSHA	SYGLLVVPEPAGCTPELPGEIIK	1
VASN	LQDNELQALPPLRLPR	1
UTP14A	ASSEGTIPQAQR	1
NCEH1	VVSPFPLCQPAGEPSR	1
KIF3B	AFFDEEKDHWK	1
C3orf33	ENSALFCYLLVNK	1
CASP1	DSVGVSGNLSLPTTEEFEDDAIR	1
MAP7	ALREWEEAER	1
KRT82	ELDVDSIIAEIK	1
SEC14L4	LFPMAFNLVK	1
TIMM44	ILDVDNVDLAMGK	1
FBXW8	AKEHMLQTNWK	1
NCAPD2	SIDPGLKEDTLEFLIK	1
PRR33	QSLEPEVPAPTEQEVPAPTEQEVPALTAPR	1
NPEPL1	ASEDPLLNLVSPLGCEVDVEEGDVGRDSK	1
PARP9	SPAINLMGFNVEEMCEAHAWIQR	1
GYS2	SDITVVVFFIMPAK	1
UGT2B10	GHEVTVLASSASILFDPNYSSTLK	1
CENPVL3	SVVIEEVGGGDPGEEAAK	1
SGPL1	AFEPYLEILELYSTK	1
RFC1	GYMTKFPTFPSWLGK	1
IGLJ6	VILQCNVFGSGTK	1
IGLC2	AGVETTIPSK	1
DHRS1	CVVALAIDPNILSLSGK	1
RYR1	AEGLGMVNEDGTGEK	1
FLVCR1	AGTFPVNGPPRDSLAAASGVLGGPQTPLAPEEETQAR	1
SPOUT1	TEEAILISLAALQPGLTQAGAR	1
METTL7B	FVVAHGEDMR	1
PJA2	QTEHSPEDAACGPGHICSER	1
CLIC1	MAEQPQVELFVK	1
PACSIN1	KAEGVALTNATGVVESTSQAGDR	1
ITGAX	VDSAGFGDSVVQYANSR	1
EXOSC5	MEEEMHTDAK	1
HNRNPH3	YIELFLNSTPGGGSGMGGSGMGAYGR	1
HPGD	GIHFQDYDTTPFAK	1
HOMER3	AAQLLDVR	1
RHOT2	VVGACGVGK	1
ACOT2	GLAPGQPVTLR	1
COQ6	DLGSMSHLTGYETER	1
SLU7	HQWGEEEPNSQTEK	1
BTBD11	SCSGPASGSGSGPGPSSGPGAAPAADKER	1
CYP2C8	GTTIMALLTSVLHDDR	1
UNC13A	KGEVPPEEQGPSIK	1
PACSIN3	AYAQQLADWVR	1
PLCB3	HRPSAGGPDSAGHK	1
BPI	VTNSVSSK	1
RASAL1	GLAGHFLDYLTR	1
EIF3K	YGWSANESGQIFICSQEESIKPK	1
RNH1	ELTVSNNDINEAGVHVLCQGLK	1
IGLV1-47	VTISCSGSSSNIGSK	1
ADAD2	PWRPLPAQAQSAWEPAPAPATYR	1
FGD5	ANNSMEQGENLQK	1
PECAM1	TTAEYQLLVEGVPSPR	1
ADAMTSL3	DLPGFPLVR	1
CLCN2	NLGESPTGSADSAGIALR	1
C2CD4B	AESLVGGAPGPR	1
ASNS	DEPLHALYDNVEK	1
CC2D1A	IREPLTAQQLEMTTER	1
DHRS4	TLAIELASR	1
ZFPM1	AAPQNGGSSEPPAAPR	1
UNC45A	LTITSPEMTFPGER	1
ABCB11	ILNDLNMAIKPGEMTALVGPSGAGK	1
COX10	LQVYDLPGILAQLSK	1
GAS6	TCQDIDECADSEACEARCK	1
FUT6	DLAGYLQELDKDHAR	1
SAMM50	FYLGGPTSVR	1
COMMD5	SAVGTATPYLHHPGDSHSGR	1
TTR	YTIAALLSPYSYSTTAVITNPKE	1
TNN	NTEDSLLVSWEPSSQVNHYLLSYYPLGK	1
FKBP4	FEIGEGEKLDLPYGLER	1
TXLNB	ETQPEIGSSQESGDAALK	1
PMF1	CFYQLQPAMTQR	1
CLEC18B	LETTNEVTDSDFETR	1
CLEC18A	LETTNEVTDSDFETR	1
DDX60L	SDNPVVPSLFK	1
CFHR5	EECHVPILEANVDAQPK	1
LRCH1	VLPQELVDLPLVK	1
COG1	ELLVSALQELQSSTSNSPSNK	1
SPATC1L	LAAAAQLPVRALQGGRQAPLR	1
HNF1A	EALLQALGEPGPYLLAGEGPLDKGESCGGGR	1
KLHL41	TGAGEVNGDVGDEDLRPGYLNDIPR	1
DENND2A	FQNDHLSVLK	1
CSMD1	LAFEEFQLER	1
DHTKD1	HAMVVCQETDDTYIPLNHMDPNQK	1
PI16	AQVSPPASDMLHMR	1
NEIL2	EAFGTEDGLQR	1
DGKG	QAPAEDQVAASPLEPPVPR	1
MAST4	ASEGAMSDGPVPAEHR	1
GKN2	QALDNMFSNK	1
PRNP	HMAGAAAAGAVVGGLGGYVLGSAMSR	1
KCNMB1	DQNQQCSYIPGSLDNYQTAR	1
SEPTIN1	RGVEIEEGVVK	1
LZTFL1	SLEENLATAKHNLLR	1
C17orf97	GFHPDPEALKGFHPNPEALK	1
ZNF579	GPEGGEGAECGGASEGGEGGQNGGDAAPARPPAGEPR	1
CTSD	YSQVVPAVTEGPIPEVLK	1
XYLB	ASGFEFSQVLALSGAGQQHGSIYWK	1
SCN7A	THNEDHEEEDLKPNPDLEVGK	1
MYOF	SKTTEIIHSTLNPTWDQTIIFDEVEIFGEPQTVLQNPPK	1
TPR	TSTNNVEQYQAMVTSLEESLNK	1
HADHA	MVGVPASLDMMLTGR	1
GSDMB	ELHMEDSDKPLLSSLFNAAGVLVEAR	1
ADGRF5	FSQALQSGDSPPLSFSQTNVQMSSTVIK	1
DOCK10	VSTFVVSTVNTQNPHVNAFFQECQK	1
GBA	VGLVASQKNNLDAVALMHPDGSAVVVVLNR	1
CRYBG1	DTCVQSPISSFPR	1
HSPA1B	CQEVVSWLDANTLAEKDEFEHK	1
MSH6	AAAAPEASPSPGGDAAWSEAGPGPRPLAR	1
EEF2K	YSSSGSAANSFHFK	1
UFD1	FQPQSADFLDITNPK	1
LIMCH1	SPVTTPFK	1
NUP205	LLHLLVDDMPVKPYSDGEGGIEDENR	1
SPANXC	SVPCESNEVNETMPETPTGDSDPQPAPK	1
DUS3L	FAGAHLGPEGQNLVQEELAAR	1
ABCC8	HVNALISPGQK	1
MASP1	KNEINLESELKSEQVTE	1
CAPN5	QPSNLPGTVAVHIISSTSLMAV	1
USP34	KLESQAGICLGDSQGTSER	1
ZSCAN2	LQGHTPGEDHGEVVSQDR	1
UQCRC1	HLGGIPWTYAEDAVPTLTPCHFTGSEIR	1
CFI	HPTIQGFASVAQEETEILTADMDAER	1
MTUS1	QINDLKSQNDALNEK	1
LGALS3	IHVLVEPDHFK	1
SLC6A17	AVEEELDTEDRPAWNSK	1
UGT2A2	AFITHGGTNGIYEAIYHGVPMVGIPIFADQPDNIAHMK	1
UGT2A1	AFITHGGTNGIYEAIYHGVPMVGIPIFADQPDNIAHMK	1
SLC4A1	VYVELQELVMDEKNQDLR	1
CFAP52	ETLIATCHFDAVK	1
SBF2	SQNSPEAAPTSSLESSSSIEQEK	1
PPP1R9A	ELAGGNFTSPDASASSCGK	1
ZNF598	VGSEKPGTTLPQPPPTTCPPGALQAPEAPASR	1
FAM160B2	SMPVFLDPADIAALEGISWR	1
MGA	ISQLEKELIEDLKSLR	1
C12orf29	HNDLLSWFEDCK	1
CTSG	NVSPVALPR	1
SLC5A6	LLSLFPLSCQK	1
INPP5D	DNTELPYHGK	1
LRPPRC	NNNIDAAIEDIENMLTSENK	1
ALDH9A1	VVAKLQAGTCFINNYNVSPVELPFGGYKK	1
TCIRG1	RFVVDVWR	1
TBC1D9B	AGGDTHLGTAPQESQVVVEGGSGEGQGSPSQLLSDDETK	1
RUSF1	ADDAGMETPLCSEQFGSGEAR	1
TRIM33	TEPADMNESCK	1
DDTL	SHSAHFFEFLTKELALALGQDR	1
SLC52A3	LREENDLGPAGMVDSSQGQGYLEEK	1
ANKRD22	NPSLIPLLLEAR	1
MINDY1	GPGAEGGSGSPEK	1
ZMYM5	HEESEMHINNSVK	1
CCDC69	NEEALQVPR	1
GTPBP10	GKDWEIPVPVGISVTDENGK	1
HSP90B1	VEEEPEEEPEETAEDTTEDTEQDEDEEMDVGTDEEETAK	1
ZCCHC4	YVSLENQHCEHCNSCTSK	1
SKAP2	IYQFTASSPK	1
CHST3	LSAELGLQQPAWLR	1
SERPINA5	SSEEELHR	1
KRT24	QTMQSLNDR	1
METTL2B	ISDLKICADEFPGSSATYR	1
VPS33B	DMAYVFSGAYVPLSCR	1
MT1F	MDPNCSCASGVSCTCAGSCK	1
RAB6C	DSAAAVVVYDITDVNSFQQTTK	1
PLEK	DAWVRDINK	1
GRWD1	QEPFLLSGGDDGALK	1
H3C14	YRPGTVALEIR	1
MICALL1	VEQMPQASPGLALR	1
PPP1R32	QPTGFSLNNPMYVR	1
BOLA2B	DLEAEHVEVEDTTLSR	1
JMJD1C	IHEDEVDDMEEN	1
VAV2	MVAVQNYHGNPAPPGKPVLTFQTGDVLELLR	1
IDUA	LGGPGNSFHTPPR	1
AP5Z1	QLSLVASVLLAQGDRNKEVR	1
MTA1	SYEQHNGVDGLANHGQTR	1
DSG2	DMAGAQAAAVALNEEFLK	1
PARP10	LQGSELSLVPHYDVLEPEELAENTSGGDHPSTQGPR	1
CDK13	GNAETSASASQTNHVK	1
PMP2	KGDITTIR	1
PIP4K2A	IYIDDNSK	1
RYR2	GKGEHFPYER	1
CTAGE6	EQLGATLSGLIEEK	1
CDC42BPA	GCQTITSGK	1
LYRM4	AQVLALYR	1
CTAGE15	EQLGATLSGLIEEK	1
AGAP9	WEMAEDMEK	1
CBWD2	IPVTVITGYLGAGK	1
USE1	QSAAELDLVLQR	1
HPR	WKAPKSPVGVQPILNEHTFCAGMSK	1
ARSL	LAGSEVPQDR	1
RSL1D1	MEDSASASLSFAAATGTSTSTPAAPTARK	1
GPC6	DESMTAGTSNEEECWNGHSK	1
LCLAT1	YPVDTLPTSK	1
CYP8B1	QGISNWLGNMLQFLR	1
CROT	WCQSMQDPSLNLR	1
EIF2A	NTVLATWQPYSTSK	1
SULT1A2	KTPMTNYTTVR	1
ACOT4	YCADACGELDLER	1
TEKT2	VLCNETNNQTIWDEHDNR	1
TSFM	TNLEDIGR	1
LRP3	AVPTAPTR	1
IST1	GGSGGFTAPVGGPDGTVPMPMPMPMPSANTPFSYPLPK	1
DBH	AFYYPEEAGLSFGGPGSSR	1
EFNA1	ITHSPQAHVNPQEK	1
UGT2B11	LYKWISQNDLLGHPK	1
IGHV1-2	QAPGQGLEWMGR	1
HAGH	PGGSEPPAAFTGDTLFVAGCGK	1
TUSC1	LPGEGGDGTPAEAR	1
DLG5	IASSYYPEGDGDSSHLLAK	1
TRIM9	GATIGVLLDFNRK	1
ABCA6	NISFCVQEGEILGLLGPSGAGK	1
SMTNL1	APAEDGMSAELQGEAIGLDEVK	1
CALB2	QHVGSSTEFMEAWR	1
MOGAT2	VEFAPLFVPWER	1
SEMA4B	GYQSLSDSPPGAR	1
ZFYVE19	VLQQLTEEAALDEASGFNIPAEQASRPWTQPR	1
PRODH2	EQELLSQELWQR	1
CRACR2A	GDEDLGDMGKDEEAQFR	1
FGL2	GKCEEAEECPYQVSLPPLTIQLPK	1
HBS1L	KLSLANLIHDMSR	1
PZP	GEESYCICGSER	1
KLF16	GRPGPEGAGPTAGLDVR	1
GGA3	LHTLQEVNNNVR	1
VARS1	GALINVPSPFLGLPR	1
NIN	VSQMNSLEEELETIHLENEGLK	1
POMGNT1	NHFLVVGVPASPYSVK	1
SPATA20	TLLNTGLEK	1
FGGY	AALVDQSGVLLAFADQPIKK	1
CELSR1	FDAIHEEFPR	1
IGSF10	LHMDHNNIEFINPEVFDGLNFLR	1
SFTPA1	GEPAGWGK	1
TMED5	SGHIQILLR	1
LOXL4	TLSDCPALEGSQNGCQHENAAAVR	1
TCHH	QVGEIQSQEGK	1
SPICE1	LQPEESTETVDSSYVVGHVLNSR	1
MOXD1	CASIPDIMQQLQFIGVK	1
ETFA	GISFDAAATSGGSASSEK	1
HABP2	KEEFHEQSFRVQK	1
SIRT3	ELYPGNYKPNITHYFLR	1
DCAF13	NYDPALHPFEVPREYVR	1
DYSF	KVPSRPPPHYPGIK	1
ANKRD44	SEEAVQVLMK	1
KCP	GHVECYLEECQALSCPHGWAK	1
ALDH7A1	FQNEEEVFAWNNEVK	1
RAB35	ENINVEEMFNCITELVLR	1
PSG4	VSEGKNVLLLVHNLPQNLAGYIWYK	1
GSTA3	ALLNYIASK	1
MMAB	IYKKNDPSAESEGL	1
NOX4	SNKPVTIISVISHPSDVMEIR	1
GALNS	GDTLMASTLGQHK	1
TTC1	VTDTQEAECGGPPVPDPK	1
GOLGA2	DDPTAQQIMQLLR	1
FAM114A2	AETSLGIPSPSEISTEVK	1
UTP20	QAELVPATVNDYK	1
ENGASE	EEENFTCR	1
PEX5	LANSEGTSDAWVDQFTRPVNTSALDTEFER	1
MRI1	ENIIEERPGQELTDVNGVR	1
CENPC	TISPAESTALFQGR	1
EMILIN1	VLLNDGGYYDPK	1
CTNNA3	NSLNVLDDNQFVDISK	1
HYDIN	SFQIQIAHLDPENITLSGEGIFHQICLDLPR	1
AMY1B	EVTINPDTTCGNDCVCEHR	1
ITGA5	SDFSWAAGQGYCQGGFSAKFTK	1
HIP1R	QEELGAMVDK	1
LIPT2	RLQAEPGIEAPSGTEAGALLLCEPVGPVYTAGLR	1
IRF2BPL	YGLSAAAAAAAAAAAVEQR	1
HSPA4	SVMDTTQIAGLNCLR	1
C1orf87	EAPAPPMEPEVPEMSQSK	1
GALC	VVNVIGAHYPGTHSAK	1
ICAM5	EGLPWPEQQR	1
GLMP	LLHTADTCQLEVALVGASPR	1
SBSN	EGGQFGHDIHHTAGQAGK	1
TMEM132A	KRVEFVTFVPAPPAQSPEEPVGAPAVQSILVAGEEDIR	1
BOD1L1	DGIAVDHVVGLNAEK	1
APOL2	AQACNLDQSGTNVAK	1
HKDC1	MCINTEWGGFGDNGCIDDIR	1
SLC25A15	TFLNVVKNEGITALYSGLKPTMIR	1
PPP2R5A	SQGSQAELHALPQLK	1
TRIM63	NLLVENIINIYKQECSSRPLQK	1
LONRF2	ERPLSAENPGGEPEAPGEGGPAPEPR	1
MYO5C	NALEAQNEIHTK	1
SLCO1B1	ASTEIVGK	1
DPEP1	VFQAVEQASNLTQAPEEEPIPLDQLGGSCR	1
TMEM106B	LNNISIIGPLDMK	1
RBM45	VNMFPFVGEQQSEFSSFDKNDSR	1
VNN2	EYWQVCTMLK	1
ADCK2	AQVPGHQPEATNLIPVAVK	1
PRCC	GPGLNLPPPIGGAGPPLGLSKPK	1
KIAA1522	VSLQALEAEAEAGAETEAVLQR	1
KIF26B	TRGDSQPAEAGEAAAGK	1
MT1X	MDPNCSCSPVGSCACAGSCKCKQCK	1
SMG1	IKEQTVPITSHLMELGLTAAK	1
MRPS22	TFKPALQELKPPTYK	1
CD226	SPISTGQPTNQSMDDTREDIYVNYPTFSR	1
ANXA11	GFGTDEQAIIDCLGSCSNK	1
TRIM65	TLTLCHQPGAVFPPGPQEEVLS	1
RAP1GAP	EHFNYYSLDTALGHLVFSLK	1
GBF1	GGSPSALWEITWER	1
PSG6	GQMTDLYHYITSYVVDGQIIYGPAYSGR	1
FAM174B	FGSGAAGGSGSSNSSGDALVTR	1
ARHGAP12	HSTIVLDTNDKESPTASKPCSPENESSPSSPK	1
MTREX	MYSHPLHNDPDLETVYTLCEK	1
TNFRSF11A	NTECAPGLGAQYPLQLNK	1
ZNF638	SVVSDVPEELDFLVPK	1
PPT1	CPSPPMTNLISVGGQHQGVFGLPR	1
GBP2	TLSGGIAVNGPR	1
CFAP251	DKLGLQILPVDGNPHK	1
CYP2A7	TLDPNSPQDFIDSFLIR	1
MAGEC1	TQSTFEGFPQSPLQIPVSR	1
WDR55	FELLSEPQFGDLTSVTLMK	1
GIMAP7	MVQCNKGAYFSDDIYKDTEER	1
KARS1	KENVATTDTLESTTVGSSV	1
ADAMTS5	VTDGTECRPYSNSVCVR	1
ALPG	DSTLDPSLVEMTEAALR	1
ECM2	QLGIPQTTVFTPVAR	1
IPO4	AVGEPMRPLAEECCQLGLGLCDQVDDADLRR	1
POLR2E	AQFGDKPSEGRPR	1
TUBB8	EAESCDCLQGFQLTHSLVGGTGSGMGTLLLSK	1
SOGA1	RGPGPGSAVACSAASSSRPDK	1
HSD11B2	AHTTSTGLWGLINNAGHNEVVADAELSPVATFR	1
UQCR10	AFDQGADAIYDHVNEGK	1
S100A7	IDKPSLLTMMK	1
S100A7A	IDKPSLLTMMK	1
TSHR	IPSLPTSTQTLK	1
PIBF1	DFELTEEQYVK	1
IGLV3-16	KYAYWYQQKPGQAPVLVIYK	1
MTRF1L	LLNEKEQELR	1
CEMIP2	SAGVLLLVVDPCNVPFR	1
FAM185A	WPGSETEVPPPGPAR	1
HNRNPA0	SSGGGGGGGGSSWGGR	1
RAD18	SAAEIVQEIENIEK	1
PES1	AGEGSYALDSESCMEK	1
PLA2G4F	GIPFPSIEVGPEDVEEAR	1
PPFIBP1	LNATEEMLQQELLSR	1
ZPBP2	ILDILISDLSCHVIEPSYK	1
MFN1	LATEDDLVEMQGYK	1
DOCK9	FTWALSKPGTAAELR	1
JHY	EESLPEISLLELLQNR	1
CSRP1	TVYFAEEVQCEGDSFHK	1
GDPGP1	DLTAEGIQWPR	1
PTPN3	EYFGLQHDDNSVDSPR	1
MYO9A	GYGSLEIQGSDPSEWEDCSFDNR	1
IBA57	LLTQDEGPALVPGSR	1
UBXN1	LYVELHRGQELGGGQDPVQLLSGFPR	1
H2BS1	AMGIMNSFINDIFER	1
EHHADH	KNPDIPQLEPSDYLK	1
MTARC1	DCGEAAAQWITSFLK	1
CYP2A6	DPSFFSNPQDFNPQHFLDEK	1
PSMD5	GISSQPFPEQHCAALK	1
COG4	SEDYEQAAAHIHR	1
SLC1A5	SELPLDPLPLPTEEGNPLLK	1
RSPH1	KPTSTDGPGQDAPGAESAGEPR	1
TSEN15	GDSEPTPGCSGLGPDGVR	1
GAK	MIFMELNNAWSEFENQGSR	1
NFU1	TMDFPTPAAAFCSPLAR	1
F8A1	LHLQLGQPAAAAALCLELAAALR	1
IGLV7-46	AALTLSGAQPEDEAEYYCLLSYSGAR	1
MBLAC2	GDNFETVTWLSDSEVVRAPSPGWR	1
MTG1	VLTGTGNVNVIQPNYPAAAR	1
BCAT2	PVLIGNEPSLGVSQPR	1
SIRPG	FYPQSLQLTWLENGNVCQR	1
IQSEC3	ELTAIVQNQQSLIHSQR	1
LIMS3	AWCMNCFACSTCNTK	1
LIMS1	AWCMNCFACSTCNTK	1
UBR1	MEISAELPETPQR	1
MRPL12	IQDVGLVPMGGVMPGAVPAAAAQEAVEEDIPIAK	1
LTN1	TSSSESSAVISAFFECLR	1
ABAT	GFSQEELETCMINQAPGCPDYSILSFTGAFHGR	1
PSME2	EVPKCGFLPGNEK	1
ALAD	YGVNRLEEMLRPLVEEGLR	1
AKAP10	MIVSDVMQQAQYDQPLEK	1
NBEA	SSHGSGKPQEVPQSVTATAASK	1
NLRP2	VEGFLEEDKR	1
ATPAF1	VFPVRPGSGRPEGGADGSGVGAEAELQANPFYDR	1
SZT2	EIPLTPVDQAAFLSEVLQR	1
REPS1	SEDELRPEIDEHTQK	1
SPRR1A	IPEPCQPK	1
ABI3	LSAASSASSLASAGSAEGVGGAPTPK	1
CFAP77	DSMFQNLLIVK	1
GANC	EEISVEDEAVDK	1
PSME4	NFDDAFLPVLKPHLEHLVADTHESTQR	1
COQ3	DNLLETIPNHQPGKPLLGMK	1
LIMS4	AWCMNCFACSTCNTK	1
C11orf96	GAPAQRPPSESPGAPPPGPADAGGAMAAK	1
FUT8	YATGGWETVFRPVSETCK	1
FECH	LFLDQDLMTLPIQNK	1
GPX4	GKGLLGNAIKWNFTK	1
SLC16A4	NLTVSQNQSEEFYHGPNR	1
EPS8	GFNPVTVNSLGVLNGAQLFSLNKEELR	1
PALLD	FGHGQTPAAFLSALLPSQPPPAAVNALGLPK	1
GNPTAB	NIFLVTNGQIPSWLNLDNPR	1
TBC1D5	GQGQSVQMSGAVK	1
PPP6R1	ELPSEQQEQWEAFVAGPLAETNKK	1
UGT2A3	ANIVASALAQIPQK	1
RABEP1	DVQEQIAVLMQSR	1
CA3	GENQSPIELHTK	1
FUCA1	HHEGFTNWLSPVSWNWNSK	1
BPIFB1	ALGFEAAESSLSK	1
SPG11	SSVSEQFDHLSSHLYLR	1
TBC1D20	LLNVNASDPPPISGK	1
ASCC2	TAYILQAVESAWEGVHR	1
XIRP2	SCHGSLVEER	1
CNDP1	AIHLNLEEYR	1
PALB2	QIFHVLMNSPTITYQQMKTK	1
C1R	QGYQLLEGNQVLHSFTAVCQDDGTWHR	1
KCNJ11	LAEDPAEPR	1
TRAF3IP2	VILNYPSPWDQEERPAQR	1
CCDC170	ASQDAVTTSQSQYSSFR	1
FHDC1	TPSVPSVPHQLPR	1
PRIM1	METFAPTELPELLK	1
MRTFA	GVAPPTLITNSTGTHLVLTVTNK	1
GSS	VQQELSRLGMLEMLLPGQPEAVAR	1
C6orf132	ETPLSLPAK	1
PARP14	SEDVQSIEVQVK	1
P3H1	RIIESYFR	1
TBC1D4	LLPADALANCDLLLR	1
RINL	AGAGPPGAQGPGPEGQSLAPALR	1
PMPCB	LCTSVTESDVAR	1
CPO	EVVTQHFLGVTYETHPIYYLK	1
SLCO2B1	ATMGTPGGK	1
CCT6A	VEDACILTCNVSLEYEK	1
SPHKAP	GQSESTEAPASGPPTGTARPQR	1
CDA	QSAYCPYSHFPVGAALLTQEGR	1
DPYD	EGGANGITATNTVSGLMGLK	1
ADAP1	FHYLQVAFPGASDADLVPK	1
CRACR2B	HDLQGLQSDLPLTPEQLEAVFESLDQAHTGFLTAR	1
ATP6V0A2	CLIAEVWCPEADLQDLHR	1
ADA2	IKFPTVVAGFDLVGHEDTGHSLR	1
AIP	EQPGSPEWIQLDK	1
MYO15B	QIMGTYLVR	1
ADPGK	APQEFMTSHLEAGSR	1
MTMR7	AALGTLYLTATHVIFVENSPDAR	1
ERCC6	SDPLKDDPHVSSNVTSNDR	1
HMGB2	KKNEPEDEEEEEEEEDDEEEEDEDEE	1
EXD2	ALLNAESLPTHR	1
PCK2	LCQPEGIHICNGTEAENTATLTLLEQQGLIR	1
ERO1B	ELEVCEQANK	1
VILL	EVVDGSPAAASTISEITAEVNNFR	1
SLC26A2	RDYEAIGIQVLLAQCNPSVR	1
C16orf89	QQEGCFGEPDAEDEESSK	1
NFXL1	VEDPPLDLWLVPHSCGQVCER	1
DNAI4	TMLIPPELK	1
ADH4	GLTVFPEELIIGR	1
PGAP6	SGAPPVINLLGTSFPDDTAVQPSFQVGVPLSTAPR	1
PAX9	NNFPAAAPHPVNGLEK	1
MTPAP	ESIGSLQDGTHTPSTAMETAIPFR	1
KRT84	EYQELMNAR	1
ATL2	GQQPHQGLR	1
USP8	DIQIGTTLR	1
IKBIP	FLSLESDR	1
HFM1	FQFAFPSDKYEQDDLNLEGVGNNDLSHVAGK	1
FBLIM1	TVFPRELAVEAMK	1
FAHD2B	LVQFWAPHLVGPHLGLETGNGRGIINLNAFDPTLPK	1
AARS2	TLSVCISDGVFPGMSGPPLVLR	1
TMEM263	NQQEIPSYLNNEPPEGSMK	1
RGPD2	LAAVAQGLQQTSIPK	1
CCN2	GLFCDFGSPANR	1
MON2	EEAAQQQQAEEK	1
VCPKMT	YLETPEFSGDGDHALSR	1
SIGLEC5	KKPWPDSAGDQASPPGDAPPLEEQK	1
TMEM176B	FLFHPGDTVSSTAR	1
HINT3	SAGLAPDCEASATAETTVSSVGTCEAAAK	1
PRPH	AQYESIATK	1
SULT1C2	SILDQSISAFMR	1
IGKV3-20	ASQSVSSNYLAWYQQK	1
AIFM2	FNEVSSQQAAIQAYEDTVR	1
SFT2D3	AEEPGDGPAEEWLGR	1
FOXD2	AFYPASLSPPAAGTAAGLPTALLR	1
ATP10B	EAEASLDK	1
AHR	NLGIDFEDIK	1
FUT2	ENIDTSHSDVVFAGDGIEGSPAK	1
ATXN2L	QLTIEMFNMECGAFYFLFLDR	1
HSPA6	MKETAEVYLGQPVKHAVITVPAYFNDSQR	1
IGKV3OR2-268	FSGSGSGTDFTLTISSLK	1
GOLGA8A	TSPCALSSATLK	1
EIF2B5	YAYNVSLK	1
KRT6B	AGGSYGFGGAR	1
KRTAP16-1	VDVSEEGPCQPTEAK	1
IFI35	VQVQPLELPMVTTIQVSSQLSGR	1
PRPF4B	EVIDASDK	1
HSCB	QFLMEIMEINEK	1
PELP1	EQDDTAAMLADFIDCPPDDEKPPPPSEPDS	1
PTPRS	VILQPIEGIMGSDYINANYVDGYRR	1
HPX	EWFWDLATATMK	1
MRPS27	EALDVLDAVLK	1
YY1AP1	AENNLLALGLK	1
AKAP17A	ESAAHPEADGAPK	1
PRB4	PPQGGNQSHGPPPHR	1
MX1	INAFNQDITALMQGEETVGEEDIR	1
ESF1	SLDPALSMLIK	1
LENG9	LDPAYFSVGYVDR	1
MYH7	NAYEECLEHLETFK	1
ERVW-1	EVISQLTQVHGTSSPYK	1
EIF2B4	AAIDGYVQEK	1
NUDCD3	VAMLEENGECVLMEGK	1
WRAP53	LQLWWCGGGPDSSIPDDHQGEK	1
C8B	EVEDCVTNRPCR	1
EIF4G1	EAALPPVSPPK	1
RWDD4	EQFMENHNPINSATSLSNIISIETPNTAPSSK	1
PECR	KHGGSIVNIIVPTK	1
KTI12	ELEREESGAAESPALVTPESEK	1
SYNRG	LNASEVGHK	1
NUDT19	EAFEEAGVLLLQPR	1
C2orf88	EEVKEPPGTNIVILEYAHR	1
PARD3B	EVLNGVQTELLTSPK	1
ARHGEF37	VQPPPTTQLLLPGSER	1
RIMBP2	VYGNKDADGFYR	1
H2BC21	QVHSDTGISSKAMGIMNSFVNDIFER	1
ARHGEF5	EIDRNSQQEGSR	1
DNTTIP2	DLDEDANGITDDGK	1
RUBCN	DIQWLSPHSALHVEK	1
MDC1	LNVSLPFVSR	1
FPR1	ALTEDSTQTSDTATNSTLPSAEVALQAK	1
PGM3	VISTTNAER	1
ADGRG6	SGYFLSISDSQCLLNNALPVK	1
MT1M	MDPNCSCTTGVSCACTGSCK	1
WDR92	LVATSLEGKFHVFDVR	1
RDH14	TPIEGAQTSIYLASSPEVEGVSGR	1
MCM4	FDLIFLMLDPQDEAYDRR	1
CYP2B6	HRETLDPSAPR	1
RBFA	GLGGLVWQGQVAELTTQMQK	1
CARD19	YLLAFLADDLGR	1
SPRR1B	QPCIPPPQLQQQQVK	1
RNASEL	GSISFEELK	1
MTRR	GQEEISGALPVASPASLR	1
DOCK1	KQTSVDSGIVQ	1
CRELD2	EHGQCADVDECALAEK	1
DUS2	QAPDQDPGGPR	1
WAPL	ISHVVIEDTVVSDK	1
PEAR1	SYSYSYSNGPGPFYDK	1
LILRB2	YGCQYYSHAR	1
CT47A3	LSEEATEEPDAEEPATEELTAQEATAPEEVTK	1
CT47A8	LSEEATEEPDAEEPATEELTAQEATAPEEVTK	1
RILP	ELLTDHRVPSLLLEAMK	1
HOXA13	QAMQPLLGSGAELVGAR	1
ADD2	SEETVPEAASPPPPQGQPYFDRFSEDNPEYMR	1
KDR	FLSTLTIDGITR	1
KRR1	SVSFEQAVQILQDDVACDIIK	1
GPAM	HTSEEWGECGFRPTVFR	1
IMMT	QSASQLQK	1
SP140L	TFEDSEDSCR	1
LRRC8C	SNTIQSGPEGSLVNSQSLK	1
MUC3A	HLLHLLLSPLEVR	1
GLTPD2	VATGALGGPEAGVQCSDAYR	1
GIP	ALELAGQANR	1
FHIT	FHDLRPDEVANLFQTTQR	1
CPT1A	AGNTIHAILLYR	1
CFAP97	STETQPSSTAPK	1
INTU	ESQGSDGFEESGTLLK	1
TPSB2	IIVHPQFYTAQIGADIALLELEEPVK	1
PLSCR4	NNSDQMVYVVTEDTDDFTR	1
PLEKHA6	CLSLQAEHAGVR	1
GPATCH2	IQNEGVVLESEETNQTNK	1
CEP135	VAQIQTDYDALKR	1
TBCD	LLSMTLSPDLHTR	1
GIMAP6	KEDLAGSSLEDYVR	1
PNO1	MESEMETQSAGAEEGFTQVTRK	1
FARSA	VVDSMEDEVK	1
DTX2	LSAASGYSDVTDSK	1
CENPF	SEKEDLTNELQK	1
SRA1	SPPVGSGPASGVEPTSFPVESEAR	1
NHLRC1	AAPSALGALTCHHTFGGWGTLVNPTGLALCPK	1
C4BPA	WNPSPPACEPNSCTNLPDIPHASWETYPRPTK	1
IGKV6D-21	ASQNIGSSLHWYQQKPDQSPK	1
VAT1L	AVVLVGFGGLNK	1
LILRB4	QMASPPSPLSGEFLDTK	1
GBP4	EAVAVFMEHSFKDENHEFQK	1
TIMMDC1	YSGETIQERK	1
BHLHE23	GYGTSGPGGDLPAAPAPR	1
TNR	VVYSTLAGEQYHEVLVPK	1
SAGE1	LLVIDLMNDSSGNQTEK	1
MGMT	GNPVPILVPCHR	1
RASA4B	HRELSGGTEAGTVPTSPGK	1
RASA4	HRELSGGTEAGTVPTSPGK	1
ACTN4	MAPYQGPEAVPGALDYK	1
QRICH1	EIQEAIAVASASTMH	1
SNX19	IQDALCALEGSQALEPK	1
ATIC	TVASPGVSVEEAVEQIDIGGVTLLR	1
TOR1A	ITHVALDFWR	1
DNPEP	LEQQLVHVERPVLR	1
MYBPC2	MEIHEDPK	1
ADAM15	ESVHTQTPPEHPLGQR	1
SEMG2	NLNQDQEHGR	1
