only In PXD010154	only In PXD016999	In PXD010154 AND PXD016999
SSSQYIESFWQSSQSQNFTAHDKQR	STSLMEPEPAEPLAAAVEVANGAEQTR	TSFRVPNLEEGK
VYALISDAQPLLLSTFSGDR	GTVSEDDPPGGVIAILSTTDADSEEINR	AVETLSPDWEFDRVDNGSQK
LLGIHSVFCKPQNIR	TSPCALSSATLK	IIRDDMLCAGNSQR
DKLDHCLQEASPCYK	ESAAHPEADGAPK	ITCSADALPK
GHAEQGDPGAPEQTGPQR	GHPAVCQPQGR	KVEQGPPGGIGTAAIRPK
AQSLQKAAHQELNTLK	DLCEEQFMSGDDYPFCVDCYNHLYANK	HEAFESDLAAHQDRVEQIAAIAQELNELDYHNAVNVNDR
TDQALVGSLVSSTCGVCGK	ETATQPLPLYDTPYEPEEDGATPEGEGAPWPR	TSAFPIVESVVHEGDLHDPSR
TFEDSEDSCR	TTSEGSISTK	ELQTCLQALELGAAEK
CSQHVCLVRPELIEQVNK	DAWVRDINK	ASGSFAPISQAPPSFSPPPPLVPPAPEDLR
LNYLDLYLIHWPMGFKPR	HSVSQEGQDTIR	TVNNLILTGPR
KFNELMVMFR	VFPVRPGSGRPEGGADGSGVGAEAELQANPFYDR	LTPVSAQFQDIEGK
ENHLSQFLEGEILSASK	QAPGQGLEWMGWISAYNGDTNYAQK	LSAASSASSLASAGSAEGVGGAPTPK
AQVLALYR	ACAGMISTWVERK	VSTIAGIGIQGTDK
EVHDSYALLLAESWR	SASEVDRMFPGVPLDTHDVFQYQEK	DGIAVDHVVGLNAEK
LELEEAATPEGHAMR	DVQEFINNPK	NTVYLQMNSLR
NIFLVTNGQIPSWLNLDNPR	GEEIIHNYNLPPDLPQFIQAK	LRDEQLNSPYSCQAEGPCLTR
VETGILRPGMGVTFAPVNITTEVK	DNPMSTPK	TLTEEEVEEVLK
EITPPFKPAVAQPDDTFYFDTEFTSR	GPGAEGGSGSPEK	LLIAPESAAPEEALGPAEEPEPGR
GGEKEEGNDGQDLR	AEQQQQQQQQQQQQHQHQQQQQQQQQQQQQQQQHLSR	WLLLCNPGLANTIVEK
AVLMGGSALSPATVISHER	QPCIPPPQLQQQQVK	SHPEVSIEHLGQVVQCSHEEGLVCR
DGDSNSTLEEHSEGK	EQQSHLSSIVTPEEQEFVNNNAQEYQWIGLNDR	SSQSLVHSDGNTYLNWFQQRPGQSPR
QEVPMCTGPEPR	VFEDGTLGISLDETVNEK	QFEESQGR
KEDLELIMTEMEIPR	EQLGATLSGLIEEK	AEDTAVYFCAK
WQQNVFSCSVMHEALHNHYTQK	EIELQQQTIEALK	DREAAEGLGSHER
SGLITSQYFYELQENLEK	EAEASLDK	HDEILTELEK
APPAPGPASGGCGEVDELFDVK	INQPDVVCEDPEEEVAPASCSEHCAECER	DTVSTGLTGAVNLAK
QILKQDFETLSQETK	SYGGDSTGGRPR	PYCNHPCYVAMFGPK
SSVSEQFDHLSSHLYLR	GDENTVVDLGSK	VPSFETAEGIGAELK
GMQGAPPQGSMLGPPQELR	QQALQALEELR	HWDFNIIDK
CVDGQCICHEGFTGLDCGQHSCPSDCNNLGQCISGR	VEPASAGK	CDEPLNILVR
SAMSEIEGIQSLICRR	RSVQWCTVSQPEATK	LQEQQQQMEAQVK
TCQDIDECADSEACEARCK	DGMTLTWYPPEDDGGSQVTGYIVEHK	EIEVLERGDSAPAAAK
FLEENADPSASEIREELEQYTTEIVQNNLLGSQGAHVK	DDALYETETLPNLER	MVAVGICR
QFFSHVIADTIK	RSDFASNCCSINSPPLYCDSEIDAELK	EFCTMVSTTELQK
AKVETMTLDLALLR	CDVNVGEWTMCTPPTGINK	SYPASDHTTPLSR
SLKYNPVVINFEMQPIHEVLR	ATSEDTLNLR	SAGGRPGSGPQLGSGR
FNKPFVFLMIDQNTKSPLFMGK	LHVSQIPTMAVK	HSAYQDGQDTIR
DAHVTPGSGALQGQSVSVWELLFYR	YNGDIEDIK	AVHNEGMQVLSLTESPYSDGEDHSIQQVSESWLEER
NYTSMYDKNNLLTNK	IIVHPQFYTAQIGADIALLELEEPVK	NHEAGTSGCSIDAK
THTAQDRPPAEGDDRFSESILTYVAHTSALTYPPGPR	LSSTDQQESCSSTPGLEEPLFK	AAECSDFPVPSTEGTPIQGSK
MRAPADPAPAPADPASPQHQPAGPAPLLSTPAPEAR	APETDDSFSDVDCHSNQEDTGCK	DPADATEAHESSSR
PGQSPQLLIYEVSNR	AAEGPGSWSHTAR	ELYIPLGESEVAGGASHSSGQR
EEVKEPPGTNIVILEYAHR	EVAQHDVR	STSFRGGMGSGGLATGIAAGLAGMGGIQNEK
GQNDEENIQETSQVKK	KLPPSTAIK	YLDQIGNTTSSQR
VLGTSVESIMASEDR	AWLSSQAAELERELEALR	EGQGEGETQEAAAAAAAAR
YMEDYHQFHEDVKDAQEMLR	ENAEQGEVNMESHRNANAEPAVQR	QSAAELDLVLQR
VLLLEAGPKDVR	ATMGTPGGK	SPLGPHHETAQQLEVLEQQSTSLGQDAR
SPGFPEKYPNSLECTYIVFAPK	IDVVVNNAGILRDHSFAR	FQNEEEVFAWNNEVK
EPGDQGPAHPPGADMSR	SLQIPQCLTTCEK	SNGAYNIFANDRESIENLAK
SIHTVLTF	DPHETQNLATDPHFAQLLEMLR	TGLVEPVNMVDNGDGTHTVTYTPSQEGPYMVSVK
GIETGSEDMEILPNGLAFISSGLKYPGIK	LTFDEYRNNSQK	LRSPLPWQYR
DPAGMPHPQTGK	MEPEPAEPLAAAVEVANGAEQTRVNK	PSQAAGDNQGDEVK
VQPPPTTQLLLPGSER	AGLRQQSHQESARGR	VVFPSEEVVEQK
LIIYAQLTGK	GEPREPWVEQEGPEYWDRETQK	WQQGNVFSCSVMHEGLHNHYTQK
LHPDKNPNNPNAHGNFLKINR	SNASEFQPSFHQADNVR	GMLEPVQRPDVVLVGAGYR
CAGEIAMQADNHK	HQLQSADSSRHSGTGQGQASSAVR	ISGISFITIGLSTVVNEAK
TDPQTGKVHVSGAR	EVNEVSQHFQTTK	GENQSPIELHTK
QQTVAGVNYFFDVEVGR	AWCMNCFACSTCNTK	GVALSNVVHK
NLLVENIINIYKQECSSRPLQK	VICDNTGLTRVPVDAFQVGK	LDEHQGEGTTPCTSSILQEK
WQQLNPDAPEALQAPAQVPSLFR	EVIDASDK	EPGYTPPGAGNQNPPGMHPVTGPK
EESFGPVMIVSR	VEEEGVGEGAGGEAGADK	IALLLMASQEPQR
MLPTYVGSSPHGTEQGDFVVLELGATGASLR	GTVSVTREDSPSEDPVFLR	IMCTVDHQGQR
MGFTNVGPNNQPVSFQEIFEAKR	SNPEESLRAEQSPSVEENLSIEDLELLEGR	NPDSSTMGPWCYTTDPTVR
EQLMQLLGLSK	DLHDDNEDEEMLETADGESMNTEESNQGSTPSDQQQNK	LPQGLPTEENMSNTCLK
LTITSPEMTFPGER	GPWALEEESFGREPEER	ENTDLAGELR
SSELMDVATVQDVLR	KAQPHYSNPLVAVK	LLPWSPEHIDTR
SETVPAASASAGLAAMEKLPTK	QAQVLGTERTEEAAESQTAGR	DVLQAAAAEHQDQGQEVSGEVR
EADECIVSEDKTLAEMLLQEAEEEKK	MEEDIKEEEEK	GTQVVGSDMTVTVQFTNPLK
QVQGGLTVFGMGQPSLLGFR	AEGAQNQGRK	LTGHGAEDSLADQAANK
LQVYDLPGILAQLSK	MIQVFNQLK	HLEESSTLDPHTK
LFSVPSVFTPAIDTK	IGQAIAQR	AAQLLDVR
AVPVWDVLVSGYVSGAAR	VTNSVSSK	TPQEWAPHTAR
DNSQNTVFLQMNSLR	EPWVEQEGPEYWDRETQK	NDYATMLPDSTEINQDTINRIIK
EPVELGQPNTLICHIDR	TAASGVEASSR	APRPFGSVFSPK
NQVSLTCLVKGFYPSDIAMEWESSGQPENNYK	DLGSVQGFEDTNK	LKGELESSDQVREHTLHLEAELEK
QAEVVDTEWEKLNLHSADWQR	GGTGPPGPEGGK	TKIEGLDIHFIHVKPPQLPAGR
GGSPSALWEITWER	ETGVHSLLIDTLTQR	WIQPEEDEGK
NQIKDAQLQNAR	EQEQVRATSQGGDLMSDLFNK	TISAVGEQLLPTVK
FCGEHAGAMEEEDAR	GHDQLAYDGK	LVVQQAGQADAGEYSCEAGSQR
KTGEMFVNDRLDR	ITSNQNQDTQEK	ENAEQGEVDVESHR
GYEAMYTLLGNANGAICAFPFK	CDLVSLQPLPPGFK	SPLPWQYR
KDEEDALPVLQEEIK	GSISFEELK	AKPEGALHNNDGLYDPDCDESGLFK
MGFTNVGPNNQPVSFQEIFEAK	ALGYVTGDMKK	GLEWIGSIHYR
LGPELPLAMDR	PGQAPVLVIYYDSDRPSGIPER	VYLFELHITDAQPAFTGGYR
VTISVDTSKNQFSLR	AEIGVIEGDK	DSGTCHSCPPNTILK
TSHENMLIPVVGTLQECASEENYQAAIK	NSLNVLDDNQFVDISK	TLDPFETMLK
FYNSEGYGFGLTLYPNSR	QPSSPSGEGDGGK	AKLPEATPTELAK
SPISTGQPTNQSMDDTREDIYVNYPTFSR	PSEEEAAAAAGGPPGGPQVNPIPVTDEVV	SSQALAFESSAGIFVGNAGATGLER
DYLMSTHFWGPVANWGIPIAAINDMK	TVMQRGSLGVDSVSASQVTK	YESQEPLAGQESPLSLATR
NLCWDVLCVDQPVVEDPR	IVEAEAQEDLEGLRGSQNEGAGR	QIEELRNQIK
GILVDTSR	TMDSCELDLVYVTER	VSLLFEDDVDSR
VLPFNAETCNATVSGPDLEFSMHDGTIR	IGNEEQPPHEGKPEVACILEDK	VGTASENVYVNTAHLK
NYVSAWELQR	QTLPEDNEEPPALPPRTLEGLQVEEEPVYK	SPADPTDLGGQTSPRR
DHHSTHYRASEEEPEYGEEIKGYPGVQGPEDLEWER	EQSHAEISLPAESGQAVEECK	YQEEPPAPQPK
LSEIQETSEQAQSKFK	AISPTQSTSSWQK	LQAAYNLVK
TGSETPQAPVSGVGPVSGGPGGFGR	SGSFLYQVSTHEQSESTHGQSVPSTGGR	NAIAEPAVQR
GKEMVDYVANYMEGIEGR	LIHNLNVILAK	GANVIAGVWLEEVGQK
QQNVDHVVATLQGEGLSVTGTVCHVGK	MAGKPTHVNVSVVMAEVDGTCY	SNFLVVCYLHDVK
ADEVVSASVR	SALIGCLSSGSPAPR	LLTQDEGPALVPGSR
LEEECEGREPGLETGTQAADCKDAPLK	NLNQDQEHGR	LEQYEGPGFCGPLASGTGGPFTTCHAHVPPESFFK
PGPSFSTPSLALATLR	EIPENLMDQYNEVNAISTACSNGVPECEEMVSGLFK	EQPGSPEWIQLDK
CPSPPMTNLISVGGQHQGVFGLPR	QLIVPNEK	GLASPTAITPVASAICGK
LTSALDQLLQATR	ANSYTTKYAASVK	HAMVVCQETDDTYIPLNHMDPNQK
GTAAAAAAAAAAAAGEGAR	VMITLTDVNDNPPK	FCAMISGRPQPK
EQNQRPLHPVANPHAEISTK	PYLLSQEIPPDWDQQPVK	VQLPTESLQELLDLHR
APKLLIYAASNLQSGVPSR	CSCPPAAACHHVTGACR	ALLEGESNPEIVIWAEHIENMPSEFR
EFYVYFLKDEDYLKDTVENLETQSK	ADQNYNYNQHAYPTAYGGK	DLIATLAK
VVSVIDLGVFVR	DAAYPPGPPSNLHVTDTTKK	STSGGTAALCLVK
EGVYELAVFQMKPGGPGLWGDAFER	EVAQHDVREGK	DAMWIGFLTR
LSEIQETSEQAQSK	MPTQEPTHREPTR	EDTVEVLAIDNTSVR
EEGWLAEHMLVLGITNPEGEKK	VDGNRQIVGYAIGTQQATPGPAYSGR	GCVLDVCMGGGDHDILCK
VRGTQVVGSDMTVTVQFTNPLKETLR	DGEVISEATQQQHEVL	GEPLHIVNSSNVTDEPLLK
KNGAVWCICNENYAGPNCER	SVPCESNEVNETMPETPTGDSDPQPAPK	KCPTPCQLQAEQAFLR
EQTVGGVNYFFDVEVGR	HAGIGHGQASSAVR	LVVQQAGQADAGEYSCK
IQFDEGYDNYPGQEKMDDLKK	VEQGPPGGIGTAAIRPK	HARPPDSPASAPPDSSSNSASQDTK
SGAPPVINLLGTSFPDDTAVQPSFQVGVPLSTAPR	MPLVEQSPEDSGGQDYVETVIPSNR	GVAGSSVAVLCPYNRK
DLEAHVDSANKNR	LPEGSVAIK	YAMAWGVVEK
GFNPVTVNSLGVLNGAQLFSLNKEELR	SASALSVSGGEEK	FWRPEEPIEVIRPDIAALVR
DSSVFILGNTDRPDASAVYLR	IIRDDMLCAGNTR	AGTAFYIDQCAVHAATEGR
VQLPTESLQELLDLHRDSEREAIEVFIR	LCNNPAPQFGGK	EIPELEEEK
TQDEEEQAEALQR	HLPLPYDEVICAANLK	ASQNIGSSLHWYQQKPDQSPK
HASSGSFLSSANEHLK	EGSDLASIHTIEEFDFIISQLGYEPNDELWIGLNDIK	HAFRPTNAAAATSHSTASR
LLRGYNQFAYDGKDYIALNEDLSSWTAADTAAQITQR	EDELTFTK	GRPLVCFLNEPYLQVDFHTEMK
DTCVQSPISSFPR	LMIYDVSNRPSGVPDRFSGSK	EATSVPHIYAIGDVVEGRPELTPTAIMAGR
KEEVWDSFKV	DAVPAEAALQAR	RGPGGVWAAEAISDARENIQR
GGGAGFISGLTYLELDNPAGNKR	CSTNPGNWVTFDDDPAVQSSQK	SGPYVPQCDAFGSWEPVQCHAGTGHCWCVDEK
LCFKENAEQGEVDVESHR	ILPSSLMLPK	GLATDVATFTQGAAPGREDTGLLTTTHGPEEAPR
VAVTSSSSSSSSSSIPSAEKVPTTK	AVNTLNEALEFTK	GWRPSSWEDSLEAGLPLQVR
NNLFMSSAGYR	AVSYPAAVR	NNNIDAAIEDIENMLTSENK
TSGLAGEPEGELSKEDHGNTEK	LHEIGHER	AATDLPGPETPR
SFVHPKPGAAGTVGAGLIPISSELCYR	DTVCSGVTSAANVAK	FSASAVETRPSIWGECPPK
YQDTASTLSGSQDTFR	LVNSLYPDGSKPLK	GLFDDEDEESDLFMEAPQDR
ISLKEENVCEENSPVDQSDFFYEFSK	GGGGGIGGGFGGGSSGFSGGSSGFSGGSGFGSISGAR	ILEFVGHSLPEETVDFMVQHTSFK
KCLKNEYIENR	MELSQPEVSEDFEEDALGVLPAFTSNLER	LSEIDVALEGVR
NSLYLQINSLR	DHENLQTSFVDNVATLK	EGSVGSTSDYVSQSYSYSSILNK
ELEIGQNCLELELGQSR	VMQVVDEK	GVGGAVPGAVLEPVAPAPSVR
RGVESSGQPENNYKTTPPMLDSDGSFFLYSK	LQQGPTCHLAVR	AVEEELDTEDRPAWNSK
LANSEGTSDAWVDQFTRPVNTSALDTEFER	SSTPSTTSAPTTSTTSFHTTSTTSPPTSSTSSTPQTSK	VEDQENEPEAETYK
LSVADQEKVDKFMIELDGTENK	SLSPQDEK	LVVGQNGILSTPAVSCIIRK
TTESPPSPGTTTLGHTR	QSLEPEVPAPTEQEVPAPTEQEVPALTAPR	CQPSGHWEEPR
IQDALCALEGSQALEPK	AEGAQNQDK	SGSLIDAIGLHWDVYPTSCSR
DSAAAVVVYDITDVNSFQQTTK	GGDGGERDEDGDALAEREAAGTEWDPGASPR	MEEEMHTDAK
GEEVEGAGWMPGREPTTHAEAQGNEGDGEEGLQR	GGGAGGGGGAASGPAAGTPSAPGPR	DFENSINQVK
DLGPHAEGQLAPRDGVIGLNPLPDVQVNDLRGALDAQLR	EASDPFSLNELLDELSGK	VWPETPEEK
QQIQAGLELAQAHK	GRPMPEITWSREEGEFTDK	SVQWCTVSQPEATK
RIIESYFR	ASQGVSSYLAWYQQK	VPVTQATRGPQVQQPPPSNR
LGAVYTEGGFVEGINK	ENYLEATVWIHGDSEENK	YPVDTLPTSK
ITHSPQAHVNPQEK	AVVLVGFGGLNK	SVLRPSQFGGQPCTEPLVAFQPCIPSK
AQQNLSWEEITKEYQNEEDSLGGSR	QNPGLAYGNPYSGIQESSSASPLSIK	GTAAAAAAAAAAAAK
PQGPPQQGGHPPPPQGRPQGPPQQGGHPCPPR	PGQSPVLVIYQDTK	VLIVYAHQEPR
ELPELEATAQLLPLEGPKEEK	EEEEEEEEEEAEAGEEAVPEEEGPTVVLNPHPSLGYK	TLTYFNYDQSGDFQTLTFEGPEIRK
EGFSGQIQFTAPLSDKVELGVIGNSVHMEGLPGSSTSIR	QDEDFLLPETTVTK	GSSGTQASDSEGHSEDSDTQSVSAHGQAGPHQQSHQQSTR
GTEAAGAMFLEAIPMSIPPEVKFNKPFVFLMIDQNTK	APPPPQPTVSPRPR	EAVQQQQNQLVWVSEGK
SQPNLDTCAFHEQPELK	QSPGSPER	VAVTSSSSSSSSSSIPSAEK
GTNGAPAYSIYGRPR	AEPSAWSQDTGDANTNGK	RQGSSVSQDSDSQGHSEDSER
LSCAASGFTFSTYGMHWVR	YVGNFGNSSGEVDTK	EGSEDAGNLPEAQEK
KFAENPKAGDEFVEK	GGRAEIGVIEGDK	IEPDRAQVDEVLQLR
IAAANGIGRLVVGQNGILSTPAVSCIIR	GLMESISAGSFSFPGGHK	YVSLIYTNYEAGKDDYVK
SSPSSVTNSSYDGESDSQHHLSCEPVFQTNR	RECVVNSSAAR	HPTIQGFASVAQEETEILTADMDAER
GGPVQVLEDK	AEGPEVAAGVR	VPGFADDPTELACQVVDTK
YVSLENQHCEHCNSCTSK	CHLGPGHQAGPGLHR	GSSVSQDSDSQGHSEDSERR
VSEGKNVLLLVHNLPQNLAGYIWYK	SWLTTTSASQDIEK	SAVQGPPDR
QDLSILVAK	GHDGEDDEGEEEEEEEEEEEEEASTEYGHQAHR	ELVDDSINNVR
GEADDLKSEGSYFSLTSTEQSVK	SSAGERHGSHHQLQSAESSR	SIAATDHEPTDAR
VVSVLTILHQDWLNGKEYK	GAPPSPEAGFATADHSGQERETEK	KGTSEPVLDPQQTQAFDQLCR
KAVTDFTSEVTYDPPGR	DEESYYISEVGAYLTVSDPETVYQGIK	FGYYGDALR
EVGTSDKEILTSR	VALPDDHLK	DCQVIPLPPGLPLTHAQDLTPATSPAGPR
DCNDTLEEDNTNLETPTKR	LEAEGEAMEDAAAPGNDRGGTQEPAPVPAEPFDNTTYK	KPPPAPQQPPPPAPHPQQHPQQHPQNQAHGK
VPEPDYTKVPEPGSIK	VVGACGVGK	VELGVIGNSVHMEGLPGSSTSIR
NKADNNIDAIEETLETDDTTICSDRPPENEK	KYQAVASNSK	VLWLDEIQQAVDEANVDEDR
AEEEFFDIIFTELKK	RPLSVHPGEDAAQLLAK	IDPQTGWPFFVDHDSR
AASAAAAPHLLLLPPPPPAAPPPAGACSPLGPR	GQPQSQEESEEGEEDATSEVDK	SMPIPIPK
KREDAITQQNTMQNEAVNLLDPGSSYLLQEPPR	KTSEDASEYYENYIEELK	LQAEANDLQIR
VSCKASGGTFSSYVISWVR	AGVLADDHLIEVNGENVEDASHEK	RSLRVEVDLLIGSSQDDGLINR
QTGQAYYVILLNR	LTLDESYDLVVENEEVLTLQETLEALSLSEYFSTFEK	TPIALATGIRPFPTEESINDENIYK
WIDTQVILALPYDTPVPGYMNNTVNTMR	TLHQGMAEVYNFDFITMK	ELSGLPSGPSAGSGPPPPPPGPPPPPVSTSSGSDESASR
VGEEEILIYINDHENKNEEAFCVK	KEPEVIVVSQPTEPQPVLIPSININSDSGENK	ATFSSVPLVASISAVSLEVAQPGPSNRPR
ISEKQEEIISILEEK	SRESEPLSK	LMIYDVSNRPSGVSNR
VAEILTGSNLNDGLWHLVSINAR	LITEAFSVSQER	MCSADYAGLLQTFQVFILDELTAR
AVLTINEKGTEAAGAMFLEAIPMSIPPEVK	LLTPLEIAK	EQLQQEQALLEEIER
SSRDQALAEHCLAALTECAASGDGNILALAVDASR	APEPLGPADQSELGPEQPEAEVGESSDEEPVESR	ADNSVPGTPTR
GVTCEDVNECEVFPGICPNGR	EQPWEMVMDK	AAAPAPVSEAVSR
GKGEHFPYER	RASAILPGVPGSETLSNEVFQESEEEK	VDIDTPDINIEGPEGK
DDPTAQQIMQLLR	GDSAPAAAK	GLVQDETELEDENQEGMTVHSSVHSNNLNSMPAAEK
VQANAPLIKPPAHTSAILTVLR	QLERDNVELENLIR	GQTGAILQNTVESLSK
ASLIEEDEPAEKENSSKK	VLNSQSESSALTNQQPQK	LSDLQEALDQALNHVR
EGCVCDAGFVLSGDTCVSVGQCGCLHDGR	DITTGYDSSQPNK	SQDCEILGESK
EHTLHLEAELEKHMAAASAECQNYAK	RDLHDQFQHQLR	LSAASGYSDVTDSK
PAPGSTAPPAHGVTSAPESR	AVPTAPTR	ETEFSSAGHSLQDK
GPSVFPLAPSSKSTSGGTAALCLVK	QLTLQHHMGSADLNATFYGPIK	FLDRYFYNQEEYVR
WQQGNIFSCSVMHEALHNHYTQK	GFCQVNVVDHPGPPVGPVSFDEVTK	SLEICHPQQR
KLGIHSTLLDEK	LAAAAAQSVYAFSAR	MFGCDLGPDGR
FSKEEPVSSGPEEAAGK	NPPQQPLHVDSICDWDSGEVQLLRGER	TQVNTQAEQLRR
DLLNTNDYEEYK	TSRNWGSSFSQDSDSEGHSEDSER	LQELTPSSGDPGEHDPASTHK
YSTTALLEQLEETTR	QCDNPAPQNGGASCPGRK	TLLPEDTQK
KVLLDGVQNLR	ASQGISNFLAWYQQK	VLWLDEIQQAVDEANVDEDRAK
LHSLTQAKEESEK	GEQGEDSSEEK	NDLEDSLLK
IILGGIYNADLNDEWVQR	EAGSDFGPETSSVLHLDHSADSPVSSLPTAEDTYR	MEPEPAEPLAAAVEVANGAEQTR
FDSDAASPRTEPRAPWIEQEGPEYWDGETR	YSGETIQERK	NPPVWVHASPEHVVVTR
SLKEESIEAVK	GPFTYISPSNTELTLMIQEQGDK	GCFQAEIVPVTTTVQDDK
TCAGESKDYALHAGDGSSDPEVLLNIENQR	DNPPNIPSSSSSK	DLQQSIAREPSAPSIPTPAYQSLPAGGHAPTPPTPAPR
YNTEEFITVYPTDPPKNWPVVTLIAEDDR	QDSDALPSPELLPQDQDK	LYEPVVIPVGR
EAFLEQMMGLEGAVK	GVACVVPGTLEIEGR	VLMEDDDLYSCVVENPISQGR
MILFAFGSAVAQAR	TTQNIATGTKNTLGSGVTGAANVAK	PSAEYWNSQK
KGEVPPEEQGPSIK	HLLVHAPDDKK	SDPLCILLQDVGGGSWAELGR
FLRGHNQYAYDGKDYIALNEDLSSWTAADTAAQITQR	LISEVDGDGDGEISFQEFLTAAR	DEIQIYQSK
ASHSISTYLNWYQQKPGK	LSPGSGGPEAR	TEPADMNESCK
DSVTGKESQGERPHLSLLIPR	CVSNIGDVVDNEECNMK	YNPVVINFEMQPIHEVLR
AVTASNDEDLLIAGEFR	ALVDTYCR	FCQLHSSGARPPAPAIPGLTR
MKDVPGFLQQSQSSGPGQPAVWHR	FGDTEADSPNAEEAAMQDHSTFK	VDIDAPDVDVHGTDWHLK
LQALLQDLSEVSAPR	LFVLESQNGSQGLQLEAAR	GISEDSHLESLQDVGQSAAPTFMISPETITGTGKK
ALREAPLGLR	EEPVSSGPEEAAGKSSSK	VVEYLLPADKEESAPAPGHQQAQK
RPPPASAPAPQPAPQPAPTPSVGSSFFSSLSQAVK	SDEEARQSGGSSQAGAVTVSDVQELMR	ALMDEIEHDITK
ATDETDRDIIREPLTELR	AEGEEDEVK	LQDEELDPEFVQK
SEDMAVYYCAR	DASTSPPNRETIGSAQCK	DLGSMSHLTGYETER
EAYFSVGLQGIVEK	EQLQQEQALLEEIERHGEK	TSIECLPELIHACGGK
DPAEPMSPGEATQSGARPADR	HHEASSWADSSRHSQAVQGQSEGSR	EAAEGLGSHER
IQYEMPLCDEGSSSK	GSCGIGGSIGGGSSR	ASQSLDGTYQGGGVCIDCQHHTAGVNCER
SARHPSSPSALRSPADPTDLGGQTSPR	RPEETTVSVQSAESSDALSWSR	LLPSFVSSENAFYLSPHIR
AENNLLALGLK	ICPSCRETAVDGELVVLYDVK	ALREWEEAER
QLLQENEVQFLDKGDENTVVDLGSKR	IDGYIISYREEEQPADR	ADSGVHLCVIDDSNEHMLTVWDWQK
LGHFLEHVLGSGLVTDGTMATDQR	IPSSMDSNYQQSSAGQPINAKPSQTANAKPIPR	VFSVAELQAR
GLGGLVWQGQVAELTTQMQK	HGGHYFPK	DDDGTLHAACQVQPSATLDAAQPR
DIQWLSPHSALHVEK	EEIPTDSSLVTPVDRPVLTK	FQVDLQNGSSVKPR
LDTFLLDNFVPLMSRPDFLSYLSFEKLMSYLDNDYLSR	TVLTGTKDTVCSGVTGAVNLAK	KDEGEGAAGAGDHQDPSLGAGEAASK
LLALSGPFHYWGPVIDGHFLR	IAGMDPVVHSALREER	STDTSCVNPPTVQNAYIVSR
GYDQFAYDGKDYIALNEDLR	GYPGVQGPEDLEWERYR	NENRGNPAVSYVR
YLETPEFSGDGDHALSR	CLAGYYGDPIIGSGDHCRPCPCPDGPNSGR	AGGSYGFGGAR
ADIDVSGPKVDVEYPDVNIEGPEGK	ANLSSQALR	AHAFVVQQK
TRPLEFAAMGDYLDTFALK	LQQQHSEQPPLQPSPVTTRR	DYLASHPFDTGMTLGQGMSR
FGEWSGGPGLSLCPPGGIQEVTINQNPLTPLK	STSLMEPEPAEPLAAAVEAANGAEQTRVNK	TSLSAPPNTSSTENPK
SSCQIVQFMEGDKGGVVNCLEPHPHLPVLATSGLDHDVK	EAVAYAVNSWTTSISCMLLK	TESLTPHCALENRPLTR
RSPEAPQPVLAMEEPAVPAPLPK	LISPQHNQSK	HLELEWSVGPIPVGNTWGK
SLDFGDVPIDSDVHVSSTR	SFYYQHPER	EASQGSSASSAPQSVK
QLQEMLGLSKVPVTQATR	DWNSNQVSK	TTDLSIQLPSADLEVQAGQVDVK
LAAQESSEAEDMSIPR	RGTDECAIESVAVAATPIPK	RLEQNLSGEEHVQELLK
ILDILISDLSCHVIEPSYK	VPVTQATR	ISNSAAYSGSVAPANSALGQTQPSDQDTLVQR
EKQQHMVQGESETADVSPNNMQV	MESEMETQSAGAEEGFTQVTRK	ALFSQISSAVSLR
SRWQQGNIFSCSVMHEALHNHYTQK	MDPNCSCASGVSCTCAGSCK	NTVLATWQPYSTSK
KFSKEEPVSSGPEEAAGK	TEQVIMFLK	NEPVVFPEGPEISEELK
VNLHHVDFLR	SEQLCNEEK	QEVPIGTDPISK
IDWDDEKYYSTSLK	EHLPDEFIK	EIQSQPGNALYFK
RDELLAQHAAGALGLPNLVAVLTR	REVDFAVEVFR	AARPPPAASATPTAQPLPQPPAPR
NTLYLQMKSLRAEGTAVYYCAR	AVNAVGMSENSQESDIIK	MVWDSQVSEHFFEYKK
KKQDEEINQIEGER	IDKPSLLTMMK	TLVSCIDFR
FYPQSLQLTWLENGNVCQR	IQFEMPLCDEESSSK	SPADPTDLGGQTSPR
EKKALQEVHQQALDDLQAEEDK	IDGYIISYR	QGPYFEQPLQWK
GLGVEVPGVGQAPGR	YDTPHDMFNVVAAK	ALAAAAADPEGPEAGCSLAWR
LTAIIEEAEEAPGAWPQLQDAWR	TASDTSTEAYNLLLR	ISHVVIEDTVVSDK
SSPGDSPSAVSSNLSPSASPTSSR	AAQLPDMPLEELGQQVDCDHMR	LSCAASGFTFDDYGMSWVR
IREESVMLR	SPSSSQPLPQVPAPAQSQTQFLVQPQPQPK	AFYYPEEAGLSFGGPGSSR
TPSVPSVPHQLPR	SSEEAGFPGDPHEDKQ	ESSWVTPESCFYK
AEEEFFDIIFTELK	VAIVHLDK	IYIDDNSK
GIYNQEENVRFDSDVGEYR	QGTDLASR	YVSLIYTNYEAGK
TPPDPVNGMVHVITDIHVGSR	VNPVQGLASHWDYEK	LSGLQPQIER
ASQKDFENSINQVK	DWHDLIAK	YLENYYDLEK
KVTPVSSIPVETHR	VQAEREAVQSR	TEPEEVFIEDSAQSDLK
IQPFDDEEDEDIWEDSDTR	CPPQCPGQCPATPPTCAPGVR	TLNEADCATIPPAIR
VWDKSESGNWHCTASWK	GGTSREGGQTAPASSR	DVPGFLQQSQSSGPGQPAVWHR
MSVPGRPAGEEPLAQPPSPR	GSPDTEFK	GVSSPDHIFLPIPNWEHK
LNAEESDKLYK	HSQSGQGQSAGPSTSR	LLIYAASNLQSGVPSR
RGEEWNPQKAEEK	LTAVLLAK	GGGFGGGSGFGGGSGFSGGGFGGGGFGGGR
KHPSPANTLFPGNK	EVTEFYVQNENSVDTWGK	NVDCILLAR
KDPTVSALLTSEK	AFFDEEKDHWK	QDIQSDGFSIETCK
LAILPASATPATSNPDPAVSR	SAGLAPDCEASATAETTVSSVGTCEAAAK	GTAAAAAAAAAAAAAK
DGVIGLNPLPDVQVNDLR	CRPCDCHEAGTVPGVCDPLTGQCYCK	QSGGSSQAGAVTVSDVQELMR
ECEPPSAGAAVSAR	EHPVPLLPIRQTLPEDNEEPPALPPRTLEGLQVEEEPVYK	CHLGPGHQAGPGLHRPPSPR
GTAAAAAAAAAAAAAAAKVPAK	GALNGQGALNSQEEEEVIVTEVGQRDSEDVSERDSDK	ACNCNPYGTMK
GHVFLQTDQPIYNPGQR	GNVYIGGAPDVATLTGGR	LEQQVDDLEGSLEQQKK
VKGDVDVSLPKVEGDVK	NASLSQSLR	AVENINSTLGPALLQK
AFSEYLGTDQSKWKAYDATHLVK	LNSEQSQALQHQQETGHSLK	DVGEWQHEEFYR
AGSHTAQNSDVFVPESDRSDYNCTGGTEVLANSNRK	ALAGWLRPEDGGQAEGAEDEMEVR	IQPEDMFVYDINEK
APEQQPPPPVATSQHHPGPQSR	HVLSTSGLQSDAREPGEESQK	AEVTAHEVAVSLPSVEVDIQAPGAK
SHTLELSEALR	DLCEEQFMSRDDYPFCMDCYNHLYANK	LHWERPEPPGPYFYDLTVTSAHDQSLVLK
MVSGAYRQEFGQSK	QEQIQAMPLADSQAVREQLQQEQALLEEIER	AETSLGIPSPSEISTEVK
SEDCAADLQLR	GTDARPYTGK	AAMRETWLNENQR
HWDFNIIDKDTSSSR	AQLGNESSVDEVSFYANR	DGFVQDEGPMFPVGK
VLCNETNNQTIWDEHDNR	EEVESFASFFPLPGLPDF	MLDAQVQTDPVSIGPVGKPK
GTAAAAAAAAAAAK	PVTSGPISGTHLR	NFGAENPDPFVPVLSTAVK
SPVLHFYVRPSGHEGAASGHTR	ATEVPVSWESFNNGDCFILDLGNNIHQWCGSDSNR	QATSDVQESTQESATVEK
EAEGAPQMEAGK	EAPAPPMEPEVPEMSQSK	KGLASPTAITPVASAICGK
MAEQPQVELFVK	GCGLEDVPVSQPCGEGIAPTPEDPLQPSCR	GTDECAIESVAVAATPIPK
EHLVQKLQAEANDLQIR	LSCEAWNVHGAQSGSILQLPDKK	GSIYIGGAPDVATLTGGR
SEDTAAYYCAR	MVQQPTVQHR	HQSEMKPGEPEPQILDFQTQQYK
GHEVTVLASSASILFDPNYSSTLK	ECEPPSAGAAVSARPGQEIR	LCFVALDFEQEMATVASSSSLEK
GAPMDPNESPAAPEAALPK	TNLEDIGR	TVASPGVSVEEAVEQIDIGGVTLLR
IDWGDDQFYSTSLK	ENQVVKPCNELQDLSESECLR	LTGDCCFDYDR
LLQEDTPMR	SLGNIIMVCRK	GFGTDEQAIIDCLGSCSNK
ADIEMPFDPSKVVASGPGLQHGK	DQTLQEALAR	YPNSLECTYIVFAPK
TTDNFDDILK	TPEVTCVVVDVSHEDPEVQFNWYVDGMEVHNAKTK	SLSSAINASTGDYLLESVNK
YGDPNHHLPLPDNWK	AQLNVGNVLPVGTMPEGTIVCCLEEKPGDRGK	YGCQYYSHAR
LLNVNASDPPPISGK	GYNQLAYDGK	ASQSVSSNYLAWYQQK
CFKEHSSLAFSK	DVDDPMVSQGLWCLK	THNEDHEEEDLKPNPDLEVGK
KPTSTDGPGQDAPGAESAGEPR	MSETVPAASASAGLAAMEK	ASYAQQPTESR
KRVEFVTFVPAPPAQSPEEPVGAPAVQSILVAGEEDIR	ASQSISTWLAWYQQK	DHIVLTVLPDQDQSDETQEK
GSSAACNGLLTNHYVCEVDGQNVIGLK	LSEGSQPAEEEEDQETPSK	ACNVLQSSHLEDYPFDAEY
QAPAEDQVAASPLEPPVPR	SSPCHSQLLEAQSPEASQASPCPAVTPSAPSAALPDEGSR	EVMQGTDEHVVCK
SLLDLENGRSSHVSKR	GCEENLDEAR	LNEGSSAMANGVEEK
ISYGPDWKDFYVVEPLAFEGTPEQK	GPGGENRDAEAQR	DMAGAQAAAVALNEEFLK
VIPIQAHQIVNGAPPARG	LLVIDLMNDSSGNQTEK	DKVPSLTTYEGGDLNNTLEDLR
APVIRPGGTLGLSEAADSDAR	NPDGGPLESSSDLAALSPLTSSGHQEK	VTISCSGSSSNIGSK
CPETLFQPCFLGMESCGIHETTFNSIMK	GGISDHSAFLFVR	SLLEGQDAR
EIGHKNPSAMAVESFTATAPFVQIGR	YIPNRGPLDK	PGVTSLTTAAAFKPVGSTGVIK
VLAFLSLAEVGQVAGPGPQRELK	HGSHHQQSANSSR	EAAGEGPALYEDPPDHK
ERAELAATAVGSSTTSINVPAAASK	AAIDGYVQEK	VISTTNAER
GLCVLCPNSNNSLLAFPGTHTGR	VPSVEIVTPQLPAVEIEEGRLEMMETK	ASCSSSSSIAASYPVSR
GSPDVTCVFLNVER	ADFDDRVSNEEK	SGGTLVLVGLGSEMTTVPLLHAAIR
AVTELGRPDAEYWNSQKDILEDER	IFLCCPGWFQTPGHK	EMVDYVANYMEGIEGR
TEESKAAAPAPVSEAVSR	DLCLLECSQHEACLITTLQTQPGAVR	GTAAAAAAAAAAAAAAAAK
ADESTYVLVAHSGSGVIER	LSETPGTK	LPEATPTELAK
VHCQIVGVQTVER	SALFAQINQGESITHALK	NMITGTSKADCAVLIVAAGVGEFEAGISK
HRELSGGTEAGTVPTSPGK	SSQSLVHSDGNTYLNWFQQR	DSQMQNPYSSHSSMPRPDY
FDFQGTCNYVLATTGCLGVSTQGLTPFTVTTK	SVEDSVDVSAPK	QCQQLQTAIAEVEQR
AVGEPMRPLAEECCQLGLGLCDQVDDADLRR	REDAITQQNTMQNEAVNLLDPGSSYLLQEPPR	LVHDFTDDVIQER
QIEELRNQIKDAQLQNAR	RLAALALASSENSSSTPEECEETSEK	EGLEAAQLK
LQEQHLSSPQGVQLDR	VQAQHDYMATDTDELQLK	QMPSGPTKPSEGPAK
MYALISDAQPLLLSTFSGDRR	TPGAVEHELVLHQLR	SLDLDSIINAVR
TAQILNLQQHLSTLEK	RGQSEADSDK	FAVTNQIGPVKEDSDPTPVNPCYDGSHMCDTTAR
TAYILQAVESAWEGVHR	AALPLPAK	EGGQFGHDIHHTAGQAGK
KVTIPDLEPSRK	EGGQTAPASSR	HNYEVAYR
HTDFEEREYVVLIR	GYGSLEIQGSDPSEWEDCSFDNR	NTNSVPETAPAAIPETR
ELLVPQHTVQLVGGLFPLSSPSDTK	TSAATSSTTSSSGTTPSPVTTTSTASVSK	TNVLNHAYENLTR
QEDKDLEAAMLSK	FLELGPDGHQR	AIDCLEDEK
LGFDISEQEVTAPAPAACQILKER	STPPSPPTHR	QIVGYAIGTQQATPGPAYSGR
NYDPALHPFEVPREYVR	GERAEGPEVAAGVR	ASLEAAIADAEQHGELAIK
GASIPFQFRPENEEDILVVTTQEEVEEIEQHNK	NMSFTSGNMK	AAGEVDIGDAAYYFER
AFGLQAVDLVYIDFR	EWQELDDTEK	ALFSQISSAVSLRR
RQDLEVEVRDEQHQCPLGNLK	EPVGENGGR	EQSFTSLEVR
TLSTSDDVKDRENEK	APWIEQEGPEYWDRNTQICK	TSNSEDGSMGSFSEK
QVVSAVTALVEAAER	MWICPGGGGGGGGGGGGGGGGGGDR	AHSQIDRVDLGTLR
DKQLQIFDPR	DSQESWFK	LSQPFESYITAPPGTAAAPAKPATPATPGAPTSPAEHR
ASQSVSGYLAWYQQR	LVGVVPGPVEEPADSDK	AGPDAVTHDSEWEMLSPQPVQK
TSLSAPPNTSSTENPKTVAK	LSLESEGAAEGAAASPELSALEEAFRR	FSSACDMGGCTGALAR
LKTEPEEVFIEDSAQSDLKEVMVLNATESFVYEPK	SQNSPEAAPTSSLESSSSIEQEK	RLAAETGEGEGEPLSR
GNEIVLSAGSTLR	AEWYRDDLLLK	LCHCPVGYTGPFCDVDTK
RFQTIDIEPDIEALLSQGLSCA	LSVADQEK	EGETQHVVEIEVIFDGVR
EPAIHSEGQWVTLPAPLDTINIHLR	FLESQMVIK	DGSTAIHFEHSWGDGVAVLR
SEKEDLTNELQK	VQAQYPGVYINNEVVEPSAEQIAK	TPEVTCVVVDVSHQDPEVQFK
RASQSLDGTYQGGGVCIDCQHHTAGVNCER	APQMPDSHRGR	MDATANNVPSDRYK
LGAAVAPEGSQK	EMNERLEDEEEMNSELTAKK	LIDAETTAGAWPNVAAVSITGR
ASYFICHDQDTIKK	AGLRQQSHQESAR	FGIQAQLVTTDFQK
GHNQFAYDGKDYIALNEDLSSWTAADTAAQITQR	AGGDTHLGTAPQESQVVVEGGSGEGQGSPSQLLSDDETK	SLDVLGWEER
LQEQQRQEEEER	RGVEIEEGVVK	ATPENYVHQLR
APSVSAKPGPALWPLPLSVK	ESIENLAK	IDVDKDGFVTEGELK
WEVISLGLPFGK	VQQLDCREPFLSCCQFAESLRK	DDAQSVETVGKPK
DRAPELLGGPSVFLFPPKPK	PGSSGPGSAGSWNSGSSGTGSTGNQNPGSPR	SDPVTLNVLYGPDGPTISPSK
KSFPGLNHFK	EPVSGAVEGKEELPDENK	QVTSTASTFVKPIFSR
NPSAMAVESFTATAPFVQIGR	EIPPDWDQQPVK	NAINSPMSPALADVHPEDTQLEENEER
EGQNVNMENLYTALQSIDRGEIVNMLEGSGR	AQQEQAAHQATLRK	DLTGFPGPLNDQDDEDCINRHNVYINGITYTPVSSTNEK
GIFAVQVDENRR	CQAECEPGYFGPGCWQACTCPVGVACDSVSGECGK	NSSVCENCGYFQQLEGK
SMKLPQEQSQLPNPSEASTTFPESHLR	STSLMEPEPAEPLAAAVEVANGAEQTRVNK	RVYGDIIYTPAK
GDEDLGDMGKDEEAQFR	YLFAVTGNGLVNQGNNPEVQVDTSK	FQTATVTEK
GRMEAIPCVVGDEEVWTSDVQYQMSPFNHGHK	GVGGAPPTVILLR	DVTGSPRPGGDGEGDPNHIER
NVIAETIKGQTGAILQNTVESLSK	TSEDASEYYENYIEELK	ENSHFFVATFAR
SLTSLVLYGNKITEIAK	AWEQGWEQTHIEAQGQAQK	AEGAQPQQPPQLGPGAAAR
VTFFEPGSGNENGTSNKEDEFR	HQDSGALVGFSCPGVQDSAALTIQESPVHILSPQDK	HQSPIDILDQHAR
ACPDSLGSPAPSHAYHR	VIDPVTGKPCAGTTYLESPLTSETTQLSK	LQQQHSEQPPLQPSPVTTR
ERIQPEDMFVYDINEK	APWIEQERPEYWDQETR	AEQSPSVEENLSIEDLELLEGR
FGAAVLGNHTTR	EQEGTESTTDEGQLPQVVEELRDVQVAPGTR	VTISVETSK
NNDVINSSSYR	SSMSPTTNVLLSPLSVATALSALSLGAEQR	NDVGPYECGIQNK
NLDYPFGNILR	AEQSEDKPEK	AALGVQSINWQK
YTLNEEWLLR	ATISIPVDMVSISAAK	AQQEQLLLQQQLQQQQQQPPSQLCTAPASSHER
HLSLGSVQLCGVGKFPSLPILSPALMDVSYR	FSVAGPGPNKPGSGQASAR	SGHIQILLR
DGVIGLNPLPDVQVNDLRGALDAQLRQAAGGALQVVHSR	QCTVLDTYPGVSEADAGETLSSTGPFALEPDATGTSK	FSTVADTPELLR
ASQSISGYLNWYQQRPGK	PASQAKPESQPQAAEK	QQHEGAQGALDSGEPPLCR
IPEAGGDNSVFDIFELTGAAR	LIDAETTAGAWPNVAAVSITGRK	EATSDPSWTPEEEPLNLEGLVAHR
EEVPALHPASHDIGK	APAEDGMSAELQGEAIGLDEVK	SQFLEEGIGGTIPHVSPER
WHELMLDKAPMLK	ILGATLLK	GQGQSVQMSGAVK
ELAGGNFTSPDASASSCGK	RGPDHEPAK	ELVDDSINNVRK
YVDEENSDRETSNHR	AEQQQQQQQQQQQQHQHQQQQQQQQQQQQQQQHLSR	LAALALASSENSSSTPEECEETSEKPK
DLSVKYPEDLPITLPNLLR	SQLMMPVSRPMGPVPNPQPIDPASLEEFK	NTFGSGVTGAVNVAK
RAEVLGHKTPELAPR	GGATSVLKPGNSK	QVTSSGVSYGGTVSLQDAVTR
YRPGTVALEIR	RLNEGSSAMANGVEEK	ASGSFAPISQAPPSFSPPPPLVPPAPEDLRR
QLVASVSCAELEGQIAK	TGFSFPAQEPRPQTQNLGTPGPALSHSR	EQGTATMEVQLSHADVEGSWTR
DSLGQTVDLGLTGNHGVVHPSLADSANKFEENTYCFGR	SHACGYSNSSGCGRPQNASSSSQSHR	ENLEALQRPTLLHLTHGK
EVTFHCHEGYVLHGAPK	NIAFFSTMCLEGTAQGLVVNTGDR	LAAETGEGEGEPLSR
KAEPELDLR	FGAFHSLALEDADFDGKPMVLVAGQYSTGK	SIQASVDVSALK
CGPISDTLLYQQCLLNATTSVQALKPGASWDLKGPR	IVGSPFDPTTEQGPQIDK	VSCTYKEDEGLYTVR
EMNLEGTNLDKLPMDSTITK	ENLLLSDSPSCRENDSIQSR	CHLGPGEQAGPGLHR
DGADVASIHLLTAR	VNDDIIVNWVNETLREAEK	EEISVEDEAVDK
VATGALGGPEAGVQCSDAYR	PGQAPVLVIYDDSDRPSGIPER	YVSLIYTNYEVGK
AFVEWSQALLLAPEGSR	EAQNTCAMLTTYNEIDMSNIQEMR	GVAEVLRDGDCPAVLIPSKPLAR
RFVVDVWR	YQAVASNSK	SFQGPVLIGSSHGGVNIEDVAAETPEAIIK
DLLTLRNFTGEEIK	CHLGPGEQAGPGLHRPPSPR	AKEEIGAVSSK
LLSMTLSPDLHTR	GSYGSGGGSYGSGGGGGGHGSYGSGSSSGGYR	GFYPSDIAMEWESSGQPENNYK
DNGQAPFTITPVFSDFPVR	LLDDAMADDK	FAGAHLGPEGQNLVQEELAAR
ENSALFCYLLVNK	NGATQGWDAPQEVPYAYQGNVWVGYDNVK	SLPEETVDFMVQHTSFK
TFAEAAGSGETLSVNQLVTFLQHQQR	NIADADATVK	AVKQFEESQGR
RFQEALQTIFNR	GLVEVTIQNLSEEDK	QELPSALESHEVPGTLSMGVPQIFK
VALSSQTEVALAR	AAAAPEASPSPGGDAAWSEAGPGPRPLAR	GGTLSTPQTGSENDALYEYLR
DLCGCYSVSSVLSGCAEPWNHGK	VVVNSPANANYQERFNPSALK	DEDTAVYYCAR
EACDVGPCTTAWFHSDWSSK	ALTEDSTQTSDTATNSTLPSAEVALQAK	LGIHSTLLDEK
LLLTNDPLEAAHGGNVLITDTWISMGREEEK	DNPPNIPSSSSSKPK	TEETATEMLTSELQTQAHMIK
GGPPPAAAAQAQVQGASFR	KKHTDSVAELGEQIDNLQR	ENEQGEVNMESHR
SGGLSVEMCGPALSQQWK	CGPPPPIDNGDITSFPLSVYAPASSVEYQCQNLYELEGNK	RLSSVSGPSPEPPPLDGSPGPK
SSQFGIIGNDR	LPAEPITR	DIASTPHELYRNDYATMLPDSTEINQDTINRIIK
KDGDEVCESNVSNSITSGEK	VPNLEEGK	KLGNDAVSQDSSSPALSSVER
KMDQTMAANAQK	SPAPGSPDEEGGAEALAAGIR	AEHMETNAVGPSQSSDTR
NSVSLTCEASGIPLPSTTWFK	SPEPSHLK	LPQEQSQLPNPSEASTTFPESHLR
DIRGETLNHHVK	ETVLNALK	DDPSTPCVSCPCPLSVPSNNFAEGCVLR
LDLTGGTFEDNLR	VSGEPQESGDGSLSPQAEAIEVAAGESAGR	DEGEGAAGAGDHQDPSLGAGEAASK
PGPALWPLPLSVK	RNGMMEPDDFR	EEPVSSGPEEAAGK
DVCQAIDHGCEHICVNSDNSYTCECLEGFR	STSLMEPEPAEPLAAAVEAANGAEQTR	LDSAQLEGDLSLANK
GTQVVGSDMTVTIQFTNPLK	WMQVSNPEAGETVLGGQAQTGASTESGR	ATSQGGDLMSDLFNK
EVVDGSPAAASTISEITAEVNNFR	SDGGLAPMDTFSGSR	LSEGPVPEGAGLK
EVSQPDWMPPPEVTLVLTK	TEGPSPALLEETPLEPAAGPK	ALDSNSLENDDLSAPGREPGDFNPESR
NTECAPGLGAQYPLQLNK	QSHACGYSNSSGCGRPQNASSSCQSHR	NNSDQMVYVVTEDTDDFTR
ATLVCLVSDFYPGAVTVAWK	GDNFETVTWLSDSEVVRAPSPGWR	GISEDSHLESLQDVGQSAAPTFMISPETITGTGK
IVMEEGCLTQK	SFLDVPAELQPEPLEPQQPEAQSGASEPGSGDAK	LTGSSAQEAASGVALGEAPDHSYESLRVTSAQK
LSSFYYHEAGVTALSQDPQR	HQIEDNVSK	VLNDGTVYTAR
LVSNSWAQAVLPPPPK	SPYEPPPTGLFDDDDGDDDDDFFSAPHSKPSK	LLRDPADATEAHESSSR
EDEEEEEGENYQKGEQGEDSSEEK	ELSEPMEFQYLPNTDDRHR	YSEYTEEFSK
KCPDYTCPITFSSPADITILLDGSASVGSHNFDTTKHFAK	MEVMALVPPADCR	NEVQIHSGSFQSQVELSNDQEK
AGGHCGSVPAAAAGSGEIVQLNVGGTR	VIRNQSLVNELAFTAR	TTAEYQLLVEGVPSPR
LSCAASGFTFSSSWMHWVR	ADLEAQVEYLK	GSESPRPNPPHAAPTGSQEPGR
AQEALLQLSQALSLMETVK	EDSNIRENSSGAGK	FISGHTSELGNFR
GRVSIAELAQASNSLITWGR	VNGTWLQAGVVSWDEGCAQPNRPGIYTR	VSYGIGEEEHDQEGR
HGTDDGVVWMNWKGSWYSMK	GYHASDDGAK	TVGTNTPPSPGFGR
LKLTIVDTVGFGDQLNK	EMNERLEDEEEMNSELTAK	NDYATMLPDSTEINQDTINR
QTIPHYYLSINVNMGEVLLVR	LAAAAAQSVYAFSARPLAGGEPVSLGSLR	ELTVSNNDINEAGVHVLCQGLK
FHDLRPDEVANLFQTTQR	TYGREIQVTELLNK	IEGLDIHFIHVKPPQLPAGR
DLLANCAIQDDLESR	RYEEEEEEEEDEEEMEEEK	YEVPLETPR
GHNQLAYDGK	IADGVNEINTENMISSIEPEK	EAPETDTSPSLWNVEFAK
ETFGVNNTVYGIDAMNPSSRDDFTEFGK	MEIHEDPK	NQANACQQQQDAPVEGVAGEQR
ASYFICHDQDTIK	ELGPYSGK	DVISNTSDVIGTYEAADVAQK
LLLAHPACNSSLTDK	QECCCTSGAGWGDNCEIFPCPVLGTAEFTEMCPK	GFGHIWLDSVSCQGHEPAVWQCK
RNGQGDAPPTPPPTPVDLELEWVLGK	SCEESADAPVDQNSVVIPAAAK	TGQTILPSLNEVNHSYLSEK
STVLSNGEAAMQSSNSESKK	ASLAPLQAEHSQPHEK	GYPGVQGPEDLEWER
LYVEPAAPLGAPTYIPTLEPVTR	QFEESQGRTSSK	TLDAFPAEK
VLIYDRFGQDIISPLLSVR	YSLVTDTPQIVQAK	TPEVTCVVVDVSHEDPEVQFNWYVDGMEVHNAK
EAGPGPGPLNVGLHLNPLESIQLELDSVNAEADR	GEPGAEPGHFGVCVDSLTSDK	AIFMDCGIHAR
RDELEEGAPSEAMLR	QFLMEIMEINEK	NAAGHGSSGGGGGNTQDECAEYQEQMK
DSVGVSGNLSLPTTEEFEDDAIR	VLDTPGPPINVTVK	THPVEVFEPGAEHIVR
TPDGFDSVPLKTSSGGPDMDL	AQCIYTGGSSYTCSCLPGFSGDGQACQDVDECHPSR	QHVGSSTEFMEAWR
LFCQTLEDILADAPESQNNCR	QQSAPEVAVNGHRDLEPESEPQLESETAGK	CIYNQEESVRFDSDVGEYR
VLIYWASTR	TSLSVDHSR	EAEESTGPDEAEAPESFPAAASPGDSATGHR
LMIYDVSKRPSGVSNR	EHSVPSEK	GPDMLWQCPSSPWEK
MYIQAAIVR	VSVVDYVEPSPQGTR	GASDRDAASGAEAPMQPGFPENLSK
TRNTMSLLAANNLLAGLRGELMPSELK	VEEEPEEEPEETAEDTTEDTEQDEDEEMDVGTDEEETAK	SIAATDHEPTDARK
DIEIGFLPWLTNEVEK	AEWRFLLTGGIGLDNPYANPCTWLPQK	CVDGHCVCNPGFTGEDCGSR
GLAWIGYIYYSGSTYYNPSLK	DSPSESDVILLCPK	SEALPTDLPTPSAPDLTEPK
DCGEAAAQWITSFLK	AEPEPEPEPEPEPENDYEDVEEMDRHK	NVSPVALPR
GAHVVAGTAGYCFGNLHIPGYNLPWEDLSFQYPGNFAR	DSGHRGSSGSQATDSEGHSK	VMFVGGPNTRK
ITVLGSNLGVQAGDIQR	SGHSSYGQHGFGSSQSSGYGQHGSSSGQTSGFGQHK	LCTSVTESDVAR
DLGSEADFADDENSTAGESESHR	ASTEIVGK	SPMVPLPMPK
AVGKDNFALIPEGTNGVEER	AGLENSLAKTECR	TEVPLAENQSGPDCAGSLK
ISLLDDTVYECVVEK	APQAQPTPGPGPAGVK	LVVGQNGILSTPAVSCIIR
NLYEKLQHETR	QAQVLGTER	DFYVVEPLAFEGTPEQK
AIKPSIEATLESIQR	ALDSNSLENDDLSAPGGEPGDFNPESREDTRGGNEK	AEEPGDGPAEEWLGR
CPEDVELCHR	CQEEYYGYRPK	INAGMYILSPAVLR
LHMDHNNIEFINPEVFDGLNFLR	GMAGPAIGTEGILTR	NAYEECLEHLETFK
DVQEFINNPKWYTDR	CVVHEGNQK	SNTIQSGPEGSLVNSQSLK
HKLYACEVTHQGLSSPVTK	DSEDVSERDSDK	TLSGGIAVNGPR
IPEPCQPK	AEGLECAK	MLSFGVSAPGK
SETAPAAPAAAPPAEKVPVKK	MQYAPNTQVEILPQGRESPIFK	LSSVSGPSPEPPPLDGSPGPK
LLEDDENSQCK	GSGIGGGIGGGSSR	TCSFDFTGAVEDISK
ADEPQWSLYPSNSQVSEEVK	VAAVGYINEAIDEGNPLR	LCASGAGATADTAIEEIK
FVVTITVHPEPHVTWYK	AWLSSQAAELERELEALRVAHEEER	LQNEAESVTGMLNEAEGK
LYNPASGTISLDGHDIR	TSDYEQSETSKPALAQPASAK	EIFISNITQTNPGIVTCLENHPHK
TYGLMDSHTVLQISSAKPSDAGTYVCLAQNALGTAQK	HGGPLPYYR	ALAQVFCEESGSSPLLQK
NTFQLLHEILVIEDPIQAER	QGYHHEQSVDR	EALDVLDAVLK
TVVQLEGDNKLVTAFKNIK	LQLERENLQLETR	GCAGVITLNRPK
DEAASTSSTYNFTYYDR	LAAAAAAQSVYAFSARPLAGGEPVSLGSLR	IFEEDPAVGAIVLTGGDK
YQWDLDTCK	PSSWEDSLEAGLPLQVR	EEQEVAMLGAPHNPAPPTSTVIHIR
TSEDASEYYENYIEELKK	ATEVPSLTALHTLWLR	GLTVFPEELIIGR
GIHFQDYDTTPFAK	CPDNTLGVDCIERK	ETPGRPPDPTGAPLPGPTGDPVKPTSLETPSPPLLSR
PQGPPQQGGHPCPPR	GVAEVLRDGDCPAVLIPSK	LTAEFEEAQTSACLLQEELEK
PMSLGSWQSLALSSVVVDPSIR	RVSGEPQESGDGSLSPQAEAIEVAAGESAGR	GPAAPPPPAGGAANNHGAGSGAGGR
REEMEQLFHDDQGSVTR	FTSVPDSMGMMLAQHNTK	GFFDPNTHENLTYVQLLQR
AQQEQAAHQATLR	GGCSIKMEPEPAEPLAAAVEVANGAEQTRVNK	ELAEEFGVTEYPR
KFSLDALITNVLPFEK	EEQEVAMLGAPHNPAPPMSTVIHIR	NSLYLQMNSLRDEDTAVYYCAR
LEKPPKEGVYELAVFQMEPGGPALWGDAFER	DQQVTEISFSMSEK	IAGMDPVVHSALR
GFQMLADPGSFDSNAFTLLLR	EGHALASDVDYR	MQHSLAGQTYAVPLIQPDLR
DESMTAGTSNEEECWNGHSK	KPSEEEAAAAAGGPPGGPQVNPIPVTDEVV	GNTDSSLQSMGK
LVATSLEGKFHVFDVR	LEDEEEMNSELTAKK	SRLETMNQCWESVLQK
LFVLSSSSGDFAATEFVYPAR	HRPSAGGPDSAGHK	TLEGLQVEEEPVYK
IHEEAVQELR	CPKPVGCPEGAR	CPTPCQLQAEQAFLR
HVNALISPGQK	SSPGLYTSPGQDSLQPTAMSPPYGGDISPVSPSR	MQYAPNTQVEILPQGR
NANSQEDAEELKATTR	VPAQESQDGSGSRPAAPLIGAPANSEDTHLVDPK	PFVFLMIDQNTK
AATMENAVLLETNTVEEK	CQLSMANHR	DLGEGEEGELAPPEDLLGHPQALSR
ASGFTFTSSAMQWVR	MGAQELLR	STVLSNGEAAMQSSNSESK
TPPPRPSPLQAGSDGCEEPK	KTTPIEAASSGAR	SEDYEQAAAHIHR
GLQAQEGTVSWAVEAAPQTSDRGAYLSQR	YNVTWYVSSSPCAACADRITK	GAPAQRPPSESPGAPPPGPADAGGAMAAK
YTIAALLSPYSYSTTAVITNPKE	SPVTTPFK	AQVSPPASDMLHMR
IIEDDEKPVDLTAGRR	DDCNRLQEQFDEQSK	WQEGNIFSCSVMHEALHNR
SVMDTTQIAGLNCLR	GPSGFPLRGATVFPSLR	GPGGAWAAEVISDAR
SMGSKEDLIWELLNQAQEHFGKDK	EFLEPDSWETLDEQQFFTEEELK	RWLLLCNPGLANTIVEK
DSKEPFSSVEIQAALSK	ELMTEVCK	SQMTEPGPEVK
GALINVPSPFLGLPR	HSGTGQGQASSAVR	DTVCSGVTGAVNLAK
LDHCLQEASPCYK	TGGAEITGYYVNYREVIDGVPGK	LQGSELSLVPHYDVLEPEELAENTSGGDHPSTQGPR
ASGQESEEVADNYQPVR	LHSLTQAK	SSNTYTLMDVR
FAAITLTQAGAYHCQAQAPGSATTSLAVPISLHVSYAPR	LADSSSVPHDSQVAEGPSVDTRPK	LRPEPSISLEPR
VELFFKDDANNDPQWCEEQLIAAK	EEIGAVSSK	KQPFCDGSHFFQCTGLSPLK
QGISNWLGNMLQFLR	SNPATPASK	VSGQTEVDDILAAVRPTTR
RHFIQDSCLECSPNLGPWIR	SSQSVLYSSNSK	TLHEVSLQESIR
TAGFVKPFTEAQLLCTQAGGQLATPR	STETQPSSTAPK	CQCPSPGLHLAPDGR
TQNKEESYDFFKSYEYK	SQQSVSAEDEEEEDAGFFK	GGTFTDVFAQCPGGHVQVLK
DTSISTAYMDLSR	ATEVPVSWESFNNGDCFILDLGNNIHQWCGSDSNRYER	SVISFVCRPEAGPTNRPMLISLDK
EHFNYYSLDTALGHLVFSLK	ARGPGGENRDAEAQR	DIQQTEQTIEQR
AFITHGGTNGIYEAIYHGVPMVGIPIFADQPDNIAHMK	QVEEEDGSRDSPLFDFIESCLR	MIGLEHPLIPVQHQYVVTSTIPEVK
HHEGFTNWLSPVSWNWNSK	TTTAPGTATSVK	AADWLFSADVSRPPGSTVYTCMLNHHGGTESDLTVSR
EDLELIMTEMEIPR	AIYHGSFSTK	QTAASAGLVDAPAAAPAAAR
VLKEQALQEAMEQLEELELERK	EEQPPVPSSPTEEEEEEEEEEEAEEEEEEEDSEVQGEQPK	LEQQVDDLEGSLEQQK
TYLGKDAGFHSEIFKR	SGSFLYQMSTHEQSESAHGR	EFMEVEEGTDVNIVAK
ALFREPDLVLR	GIGWVPIGSLDVEK	HDPIPAADTFEDLSDVEGGGSEPTQR
RGPGPGSAVACSAASSSRPDK	GEPREPWVEQEGPEYWDR	AALQELESEHGK
AEVCHTCGAAFQEDDVIVLNGTKEDVDVLK	FQSSAVTALALQEASEAYLVGLFEDTNLCAIHAK	FNKPFVFLMIDQNTK
DAAPQTFSVLIGNR	NLVGNAGALHYSDEVEIIQGLTR	SGCTPCSCDPR
ALCCAGCLSENLR	RPRMAPADSGPHR	ELELLHASLEHQR
SRDPHETQNLATDPHFAQLLEMLR	RCESCAPGYEGNPIQPSGK	VYGDIIYTPAK
IPTIIGILACQLR	GANIIAGVWLEEAGQK	EHSSLAFSK
ILYDLHSEVQTLKDDINILLDK	MDVENEQILNVNPAENAGTEEVK	DGDIHQGFQSLLSEVNR
VLQDNLDKLQALADALLEK	KTEEEDVECEDDLILACQPESSVK	INQYPESNAEYLTHLVPGAHVVK
LAGPPAVATSAAAAAAASYPALR	LLSDHSKPTAETVAPDNTAIPSLRAEDEENEK	ILPNDECEK
APQDQVDIAVQELLQLK	GLFCDFGSPANR	GLVEPVNMVDNGDGTHTVTYTPSQEGPYMVSVK
KLQGIPPSGPAGELK	GLMLSLLAEEPLLGDIAAIEEVYHSSLASLNGLEVHLK	EPWVEQEGPEYWDR
GSLEEYEDTPWSDQRPR	CLAVYQAGAR	WFDVDFPSPGPQGGDK
NLFLKPGEEHEVIVSFTPK	TTATFTAK	ENAEQGEVNMESHR
HSLCGETEEEKIR	VLDSPSAPVNLTVR	FTYDQDSEPIQTFHFQAPTMATYQVVELR
PLPLPQGLR	FSQALQSGDSPPLSFSQTNVQMSSTVIK	MVGVPASLDMMLTGR
MDDPSISR	MDPNCSCTTGVSCACTGSCK	LDSSPVLSPGNK
GHVECYLEECQALSCPHGWAK	YIESPVLFLREDMGK	ATLELTHNWGTEDDATQSYHNGNSDPR
LAPRPQSEEDLAALFEASMK	DDSIPCFLEVK	AVTPQGRPVAEYWNSQK
LLDDAMSADKSDEWFAK	RQGSSVSQDSDSQGHSEDSERR	QQHEGAQGTLDSGEPPQCR
YAGEFEHVFEASTAGITLQAPQLDINTVAAGGGSR	EFDINQQNSKIEDEQALALQLQK	KVEGLLGCKPEVTIECTGAEASIQAGIYATR
EAGKFSAVSEGQGDPPGGPAPTVLAPMPLAEVELK	MVAEAGSMPAAFSVK	EHDVQNTFEEMEK
ISDLKICADEFPGSSATYR	RQCDNPAPQNGGASCPGRK	VLLDGVQNLR
DKQSGICMDSGGFR	EVTERAENEEEINAELTAK	VLLDGVQNLRAEDLVGK
GPEGGEGAECGGASEGGEGGQNGGDAAPARPPAGEPR	MQSLQPVVSCGWLAPSPNGQK	EVEDCVTNRPCR
YILQGVTSWGLGCACPNKPGVYAR	RNTLSLAMLK	DVTVLQNTDGNNNDAWAK
GIGGIFFDDLDSPSKEEVFCFVQSCAR	VGDFTPVSEK	KAENSSNEEEASSEGNMR
LLASTASSSSPASVMVAKEDRN	AAAASAAGDSDSWDADAFSVEDPVRK	WLFPTGGSVR
NQVVLTMTNMDPVDTGTYYCAR	DRPLEADGQEVPLDSSGSQAR	ENLQLETR
LHPDKNPNNPNAHGNFLK	RKEEEEEDDDDDDSK	EAAGTEWDPGASPR
EQGLRDIASTPHELYRNDYATMLPDSTEINQDTINR	ILAAQGQVSAQGGAQPSVEAPAAPRPTATQLTR	VKFPTDTLQELLDVHAACER
EEVDEDRDVDESSPR	ETPLSLPAK	DGDEVCESNVSNSITSGEK
QLQEETPSGGPLTEALPPAR	TKSQLMMPVSRPMGPVPNPQPIDPASLEEFK	RDDDGTLHAACQVQPSATLDAAQPR
SGMEPQVALPSPWPGEGR	VDVSEEGPCQPTEAK	GFYPSDIAVEWESSGQPENNYK
SLEHSEGPVGRDPAGPPDGGPDTEPRAAQGK	ASAQTYRENLR	VEDPPLDLWLVPHSCGQVCER
LIDSISNSHPLLPPELRPLGSQVQK	IASPHFTVSK	AAPSTAPAEATLPKPGEAEAPPK
TASGAAEGWDRGQASMAEVAAAR	VPHDVTDASK	QVEILNRHPHFK
AEIKDGLEFMQHSETLWK	EVEQWFATQTEKLNK	RAVPPNNSNAAEDDLPTVELQGLVPR
NNQQVPDNTEELGQTK	AAFGGGSDCQMTCENQNPCFPIQLPEEAR	DLEAHVDSANK
SCSGPASGSGSGPGPSSGPGAAPAADKER	QHPALPQHQASVQNLPSFTVAPDHQTK	SSSYSGEYGSGGGK
VNLASRPEQGPSGPAAAPGPGVAPAGAVTISSQDLLVR	EDALPTRPK	GIIDLIEER
YSLIDPSSAPELLR	SDFSWAAGQGYCQGGFSAKFTK	ILGVGPDDPDLVQAR
GVAPPTLITNSTGTHLVLTVTNK	CQVAGWGSQHSGGR	AAASHLFPFEK
DKTPAPLQHLNTLLDGTYK	SETGLAGAPAR	AMQADISEAAQILSSDPSR
LSEIQETSEQAQSKFKSEK	VVDSMEDEVK	EELGHLQNDLTSLENDK
LLRDPADATEAHESSSRGEAGAPGEEDIQGPTK	SDSELNNEVAARK	HPLKPDIQPFPQSVSESCPGK
VTYDLVYYVR	HSSWSEEEEHGYSSGHSR	FHYLQVAFPGASDADLVPK
TLSTDSIQYHLQMQDK	RYEQEHSAIQDK	SYIEVSHGLGHVPQQNGFSGASETANIQR
DSCKGDSGGPLVCK	STTQASSHTPGEPGR	VVEYLLPADK
ISVPDLDLNLKGPK	EIQVTELLNK	GQNDEENIQETSQVK
VREVSQPDWMPPPEVTLVLTK	QYTDSTFHVPVER	ESDWLSQSMFTCR
DERFEQSANNFYQQQAEGHK	NLPSLAEQGASDPPTVASRLPPVTLQVK	EEGWLAEHMLVLGITNPEGEK
CSGTEASVVAPPPVVLLPNVETPSEEDCMFGNGK	AESHPEVSIEHLGQVVQCSREEGLVCQNQDQQGPFK	ASGVPDRFSDSGSGTDFTLK
SMIYKDILLLGNNYVIHR	RGGAGPSAITS	TIEEIYMSSIESLAEVTAR
LYLSNNHISQLPPSIFMQLPQLNR	KTEDRFVPSSSK	QQDVAQFADFQEVLTTR
NTMYLQMSNLK	VIGYHLECK	DSPVLHICESK
DSTLDPSLVEMTEAALR	EDEETLAHR	AHLWELEQAR
LSPDDASFVDAIHTFTR	AQLNVGNVLPVGTMPEGTIVCCLEEK	KLSVADQEK
GTSEPVLDPQQTQAFDQLCR	DSEDVSER	LEADVHGKPLPTTEWLR
AEAPYLLVSNGHLPK	ATGQVCHALCSPEGCWGPEPK	QALLQAQLEEQLQDK
AINLNRPILYGEQEESTVHVGR	KAEGAQNQGR	ICQSNLQLVHAR
WIQPEEDEGKVVVR	QDAGVLGLR	FEEGENSLLHLK
KPIEEKPSQPYSAR	STMECPPALIVHPPAGGMASGSSQPWAAASATPMLSSK	SESGNWHCTASWK
VWPNPEVFDPSR	KAEGAQNQDK	AEEEQAGSAPGAGGTATK
DPDGNKLDLVCDAMR	TDPPSADAGTDYVGISCNLDFAPGVNMQPVR	LLNLLADLVER
QPTGFSLNNPMYVR	ADNSVPGTPTRK	LDSTDFTSTIK
VVEKDNDVLLHWAPVEEAGDSTQIIFSK	SCHGSLVEER	QAFITAQNHGYALDNALPAGWK
SDINVTVLIGCK	YRSEALPTDLPTPSAPDLTEPK	AEDMALYYCAK
YFSTSVSWPGR	RGPGGAWAAEVISDARENIQR	DITTGYDSSQPNKK
LEEECEGREPGLETGTQAADCK	SVEEYANCHLAR	VMFVGGPNSR
MIFMELNNAWSEFENQGSR	EVVTQHFLGVTYETHPIYYLK	FFGSLPDSWAR
VEGLLGCKPEVTIECTGAEASIQAGIYATR	CSNEAVFAVDFHPTDTNIIVTCGK	AFVHWYVGKGMEEGEFSEAR
GDVDVSLPKVEGDVK	AEGAQNQGR	LEGANVQEAQK
RMDPFSTKEHIEIIAPSPQR	ENIIEERPGQELTDVNGVR	MAQWGNKPIC
GQEEMLLLFHHLTPR	GPGSPSVDSSSVMTVPRPSTPSR	VLAVPAENYDYQILHK
AFSEYLGTDQSKWK	SSEEELHR	VLEMTGNIDETEWEWK
AHAFVVQQKEQELQQTLQQEQSVLDQLRGEAEAAR	YANLSSPTSTVSESQLTKPGVIRPVPVK	AGVAAPATQVVQVTLQSVQR
WFDVDFPSPGPQGGDKETYNNIIR	TYGAQEDGSVGEGDLSCILK	ELEVCEQANK
AFVEWSQALLLAPEGSRR	VSWENPSPQEAPAAESAESSQAPCSETSEAAPR	ELLVPQHTVQLVGGLSPLSSPSDTK
YFYTAVSRPSR	HSQSGQGQSAGPSTSRNQGSSVSQDSDSQGHSEDSER	SYNRFQTATVTEK
KEPEVIVVSQPTEPQPVLIPSININSDSGENKEEIGSLSK	CLQHQNRYDGQVAVFGSDLQEK	MNTEPERK
IYKKNDPSAESEGL	ASPGHTLCR	CVLLSNLSSTSHIPEVDPGSAELQK
FHFQGPCGTTLPEALACHGNETVS	QIFLDQNMLAVIDELMQALNFNSETMPQK	HSVSQEGQDTIRGHPGSSR
GPLQPMAGTCPAPEIR	DTVCSGVTGAVNLAR	FTVGDHSR
FFDNDLLVSTSR	IYFGGLPTLSNLSMK	FSFAAPSSEDDVFIPTVR
DIDLSCGSGSSK	IDGYIISYREEEQPADRWTEYSVVK	LENNMLMLPSVQPQDAGTYVCTATNR
SMQDVVEDFKNKYEDEINR	KGDITTIR	CTLDPDTSDQTDNLTEQAVEFCQR
SQPAASTLESESVQR	HPARAPAQGDSEDR	SISIIDSPGILSGEK
QHNEDILQYKR	ACPSGHHLHR	ETVIVEEQTEK
LSCAASGFTFSNAWMNWVR	APQMPDSHR	KLEALIASNDNANK
LTVDKSRWQQNVFSCSVMHEALHNHYTQK	DSPETEESPAPEPR	VALEELENKPR
WCDADPCCTGFGFLNVSQLK	EENVCEENSPVDQSDFFYEFSK	VSHGEGGGEEAAAAAR
MAVDISESEAVESGFDLR	RNTNSVPETAPAAIPETRR	VQLTPVEEAHQQLER
KEDLRPSAPQQEGVASK	VSRPESEQLRNDNK	SSQSVLYR
TLNNKFFSFIDKVR	VPVDAFQVGK	LEAEGEAMEDAAAPGNDR
GEESYCICGSER	CLCDPGYTGPTCATHMCPADCR	SGASGASAAPAASAAAALAPSATR
LTENPEKQTLPGSK	LLRGHDQLAYDGK	HAGPVPVQVPLR
NEPVVFPEGPEISEELKDLILK	VPEARPNSMVVEHPEFLR	RPGSSVSQDSDSEGHSEDSER
NYHVEVLIPPSISKDDPLGEVGVK	VGPTDGTPESQVELRPR	QGHVEQCECLGGR
SHSAHFFEFLTKELALALGQDR	SSSKDSRPSQAAGDNQGDEVK	MVAVQNYHGNPAPPGKPVLTFQTGDVLELLR
ASQSIRSYLNWYQQKPGK	DILEDERAAVDTYCR	SSGGPGAGLCLFPLDEVHAK
HIYNREEYVR	RPAAGGDRELLQWLER	QTFIDNTDSVVK
WESPYDSPDQDLLYAIAVK	SGQEFDVPIGAVVK	LLEGPVSEGAGLK
NSVQNQNHQTFLTVEK	ANIVASALAQIPQK	RSGASGASAAPAASAAAALAPSATR
HHHIDQLGDGTCSLLITGLGR	GCQTITSGK	QGAACNVLFINSVDMESLTGPQAISK
HWLEGELLYLELTAR	INAFNQDITALMQGEETVGEEDIR	VAVTQAAEVAVATMEPVAR
AALVDQSGVLLAFADQPIKK	TSTNNVEQYQAMVTSLEESLNK	DTVCSGVTSAMNVAK
GEQGEDSSEEKHLEEPGETQNAFLNER	TVGTNTPPSPGFGRR	HLGGIPWTYAEDAVPTLTPCHFTGSEIR
SVLSIQQQHTNPGAFGK	ESNIQTIGGK	NSTLSEPGSGR
FRGQFVMEHHTLPDVK	NWGSSFSQDSDSEGHSEDSER	RLGSANGQAEDGGSSTGPPR
KAFITNFSMNIDGMTYPGIIK	GGGPAEDSAGPPAALPQQTATPETSVK	YVSLIYTNYEVGKDDYVK
FTWALSKPGTAAELR	DSIRTMEEGAETPVYLALLPPDATEPQGQLVHDK	FSDSGSGTDFTLK
NTMGYLQWR	SLDLDGIITEVK	AEAEAGSPRPEPR
AQEAMTDETPDSSK	LPEGSIAIK	VSQGISSYLNWYQQK
DGVIGLNPLPDVQVNDLRGALDAQLR	DDPLGEVGVK	YGLLVGGAVSHR
ISILANTLINPQPITTFQQK	TAVHNGLGEK	EHGQCADVDECALAEK
ASQGVSSYLAWYQQKPGQAPR	VGNTVPFGAGAAVGGGGGSSSSSENVK	EAVSSGVTGAMDMAK
GTTIMALLTSVLHDDR	GTGVQSEGTWESQRQDSDALPSPELLPQDQDK	QLELPEQQEGQLK
GMPETTQPDKQR	MPEVAVPEVRLPEVQLPK	MVWDSQVSEHFFEYK
VLQEGSVEAR	GEPAGWGK	CPDNTLGVDCIER
SSTTSTWELLDPR	ENTDLAGELRVLGQAK	EMHAFQCSR
SSAIKLEVYPTSLTKNDLEDSLLK	PGQSPVLVIYQDNK	YATTAYVPSEEINLVVK
EKLHSLTQAK	TASEDVKPGSK	GVAGSSVAVLCPYNR
WHHEPAEFQAR	ASAILPGVPGSETLSNEVFQESEEEK	EQVPHCICANGR
SFGQSSTLFQHQK	GTAAAAAAAAAAAAAAK	SETVPAASASAGLAAMEK
EAYVSCQNQGADLLSINSAAELTYLKDKEGIAK	EVTERAENEEEINAELTAKK	GPWALEEESLGREPEER
KKPWPDSAGDQASPPGDAPPLEEQK	GSFPAMITPACQIAK	AKLPDATPK
QWMQNPNNNPIHPNLR	SSYTHSLNR	NTLYLQINSLR
LEADVHGKPLPTTEWLRGDK	GNPVPILVPCHR	AVTELGRPSAEYWNSQK
NLTVSQNQSEEFYHGPNR	VTGHPKPIIK	QGGPPGPTRPLTSSSAK
NLPAGTLAAELQETFGHFGSLGR	GCEENLDEAREQK	IQQHLGEEASPR
FLEENADPSASEIR	HLEEPGETQNAFLHER	DISNDAFTALDPLGDK
STESLQTNVQR	PQFLTCGHDK	THPDQFDLWYTLDRPPIGWK
VYALISDAQPLLLSTFSGDRR	QEPFLLSGGDDGALK	NVVYSCNEGYSLIGNPVAR
GSGVGEQNGGLIGAEEK	FGGTICSGDIWDQASCSSSTTCVRK	SQEVVETMCPVPAAATSNVHTVK
YPMEHGITNWDDMEK	NAAHEDGGIYSLTVENLAGSK	FSLDALITNVLPFEK
AGTLTVEELGATLTSLLAQAQAR	IGCNTCVCR	CESQSTLDPGADEAR
LRDGDSNSTLEEHSEGK	AAATSPDSGAK	GETISGGNFHGEYPAK
AVTELGRPDEEYWNSQKDFLEDR	DKDSPETEESPAPEPR	DSGRGDSVSNSGSDALR
LAQMVDDGAFTAGLAQVSFDK	GKPVLEFVETPSYQASK	EDEGLYTVR
IVNLFPQCTKDEIQIYQSK	GYSGSQATDSEGHSEDSDTQSVSAQGK	HTLSFVDVGTGK
MDDPTEQCQDPVPEPPR	DVTEIDILIK	GYHQDAYDGK
GIVDGVILPTETR	ENAEQGEVDVESHRNAIAEPAVQR	SVSSFPVPQDNVDAHPGSGK
ENIDTSHSDVVFAGDGIEGSPAK	GLNSWQQQQQQQQQQPRPPPR	DMAYVFSGAYVPLSCR
EEAAGPALALSLIEHYEPSETAK	WNPSPPACEPNSCTNLPDIPHASWETYPRPTK	GDQPNTHQLLAMASR
NTMSLLAANNLLAGLRGELMPSELK	LPDDLEDLK	EHTLHLEAELEK
LKHELTDEELKSLFTNFANVVDK	ANSSATETIK	LGHCSLSESGCVSGSSSCGGPGNQR
LSGDRNPLHIDPNFASLAGFDKPILHGLCTFGFSAR	EAVSFALSQK	DLEEATLQHEAMVATLR
DTVNPLYDETLRYEIPESLLAQR	MAHGYGEESEEERGLELGK	TQIAICPNNHEVHIYENSGAK
VIDGMTVVHSIELQATDGHDRPLTSCSIINSGK	PLPNVVTLQEDITTER	ECVLHDDLLEAR
LQAEEKAHAFVVQQK	IPSLPTSTQTLK	VSVAIEEDLEPENGILELETK
FQFAFPSDKYEQDDLNLEGVGNNDLSHVAGK	WSGSASRNHHGSAGEQSR	KKPSEEEAAAAAGGPPGGPQVNPIPVTDEVV
TMDFPTPAAAFCSPLAR	VTFGGGTK	LEDEEEMNSELTAK
EIAAVISPELER	RGHAGTADNEK	SMPESLDSPTSGRPGVTSLTTAAAFKPVGSTGVIK
FVCAPPSRLTLVPVYTSPQLDMSCPLLQQNK	NQVVLTMTNMDPVDTATYFCAR	LIAASSRPNQASSEGQFVVLSSSQSEESDLGGGGK
DILTIDISR	HTQTSSSGQAASSHEQARSSAGER	AQVDEVLQLREELEALRR
GVGAGGPEEGAPPATSAQR	NSTLSEPGSGRGPPQEEEEEEDEEEEATK	CPAAPPPPAGGAANNHGAGSGAGGR
QITLHALSLVGEK	GHQHQEEESETEEDEEDTPGHK	NCNGGAINCTNVQISDSPFR
PQVQIHVQSQTQPVSLANTQPR	TLGDRFSASAVETRPSIWGECPPK	TTSAPTTSTTSVPTTSTISGPK
CKYVSLIYTNYEAGKDDYVK	SEQELAEMIEEK	DDYPFCMDCYNHLYANK
FLDKLPQQTGDR	NHLGSAWEESRDGSRHPGSHQEDR	AEPSEATQSHSISSSSFGAEPSAPGGGGSPGACPALGTK
EQALQEAMEQLEELELER	EENDDFASFRVDRTER	VAPDEHPILLTEAPPNPK
ELDAEGLEAVR	NPSSSMPRPSAGSVK	TGFSFPAQEPR
SQGSQAELHALPQLK	GLRGPLTLNSPLTPEK	VQVLAAQLLSEMK
IPDPSAIKPEDWDESEPAQIEDSSVVKPAGWLDDEPK	DEELSPREPVLPPQK	AWLSSQAAELER
NISFCVQEGEILGLLGPSGAGK	LSPQDPSEDVSSMDPLK	DNAQNSLYLQMNSLR
DRLPFEEKLEVENVMK	REEAEESGPQLAPLGVPAPEPKPEPEPPAR	WLNVQLSPR
VAGALAEAGVGLEEIAKQVNVVTK	SELLLLACVHNYQPCVQR	ESDTEVITVEK
ITYEELPAIITIEDAVKNNSFYGPELK	DGLHSVVDDDLDTEHR	VVYSTLAGEQYHEVLVPK
ETLIATCHFDAVK	ASFTNVTETQFTISGLTQNSQYEFR	ILSPSGGKPK
FFDMELENLER	GPTGVQGPR	HCLTGGEALNR
LTSQMQATLQQASQQVLASEAR	SLKPQQQQQQQQQQQQQQQQQQQQQQPPPAAANVR	VPGDQTSTIIR
MVGCTGKVIGIDHIKELVDDSINNVR	CQGSSVSQDSDSQGHSEDSER	VCVAIDECELDVR
GRPGPEGAGPTAGLDVR	NSGEEEIDSLQSMVQELRK	AFSEYLGTDQSK
LDHCLQEASPHYK	RSALENSEEHSAR	NPLLDLAAYDQEGR
DLYHYVTSYVVDGQIIK	QTEDSLASERNRLTSK	LTQAQIFDYSEIPNFPR
STCNVVHDEFLDIPCTNR	QSAYCPYSHFPVGAALLTQEGR	NHLGSAWEESRDGSR
NLPAGTLAAELQETFGR	EEENASVTDSAELQAYPALVVEK	TSDPALCPLIVSAAADSAVR
KLSLANLIHDMSR	AAQAQGQSCEYSLMVGYQCGQVFRACCVK	EALELDSIR
VSQGISSYLNWYQQKPGK	AEGLGMVNEDGTGEK	EDSDPTPVNPCYDGSHMCDTTAR
EMLNSVMQELENYSEGGPLYK	EILQIMDK	LEGLDTGWDALGR
ILPPGEVPLKDLYPK	LLEGPLPEGASLK	AEDTALYYCAR
GMDDDWGPR	FPEDFESCDSIPGMNLEAWR	WGAAPYQGRPK
EQCTAGAVCCLQPATGR	YGPADVEDTTR	HGYFDEEMNR
TLAIELASR	AQVSNEDCLQVK	TYGLMDSHTVLQISSAK
SDEFGCMPPKVVTPPR	TPIEGAQTSIYLASSPEVEGVSGR	AQSLQEAAHQELETLK
TCGLCGDFNGMPVVR	FNHTAIPK	VMFVGGPNTR
CPDYTCPITFSSPADITILLDGSASVGSHNFDTTKHFAK	LAIEAGYHHIDSAHVYNNEEQVGLAIR	VGVTDLSPFGK
MDVTQMEFPDASFQVVLDK	SHEYQLESWADSQTSSCLCADEAK	HIDCAAIYGSEPEIGEALK
VLHASLQSVLHK	ALETLQER	ALGHGVDLGHIYGDNMER
NHFLVVGVPASPYSVK	IAGAIGPCISLNVK	YGMHTLEINACDFEDTAQYR
LAAAAQLPVRALQGGRQAPLR	DQPGEPATEFSCQELEAGSLVYVHR	CVEPLGMENGNIANSQIAASSVR
NTLSNIAMRPGLEGYALPR	SPAADAKPAPK	ILKPAEGNPTDEAGFSEDRDFGYSVGLNPPEEEAVTSK
NTGENEGGIDKFSR	ASDYYSQQMAQR	SNPNWILPDSVDWR
HLANTDVPIPTHYFVVLTNCK	RTGFSFPAQEPRPQTQNLGTPGPALSHSR	GLVVHDVSPEDAGLYTCHMGSEETR
LVSELDDANLQVENVRDQALILMNSR	ENMDFSISISNITPADAGTYYCVK	LSWAEAGSQTAAGAMER
VRGTQVVGSDMTVTVQFTNPLK	GAQAGTQVEEAEAVAVASGTAGGDDGGASGRPLPK	IMQDQSEGNSLQNQALQTLQER
ADLDVSGPKVDVDIPDVNIEGPDAK	EEFILYMEEASEEK	STFQSVVSESPQEDSAGDTSGAEMTSGVSR
EKIESLTEVHR	QTRPDSLQER	AVPPNNSNAAEDDLPTVELQGLVPR
NSTLSEPGSGRGPPQEEEEEEDEEEEATKEDAEAPGIR	YPVEHGIVTNWDDMEK	NASGLVLPTDMDPTK
RLSGLIYEETRGVLK	VQSNCPLSPTK	LLELEEHIR
TMMNTWTLQR	QYTDSTFHVPVERK	LGITPEGQSYLDQFR
DGPHGSVLEEGLDDYLTHLIEER	GYGTSGPGGDLPAAPAPR	DLTGFPGPLNDQDDEDCINR
KNWMVGGEGGASGR	EESYDFFK	EFVSFSDKPVDQIVVEEK
IFSFNGKDVLR	LPQVSPADSGEYMCR	RLLSDLLPPSTGTFQEAQSR
HFNENLTGR	ANYHGGEIR	QAPGQGLEWMGR
APQEFMTSHLEAGSR	KAEGAPNQGK	ENEWNLFSR
AQYESIATK	ALSCQTLAAGYYHTECVSGCVCPNGLMDDGRGGCVVEK	DGLEFMQHSETLWK
YGMTEIGMALSGPLTTAMR	FWIPGEPNDAGNNEHCGNIK	RLNEGSSAMANGVEEKEPEAPEM
EVQQGEEFERRIGQPTLLLYVDAGPQTMTQR	VEVRVPDVEVSLPSVEVDVQAR	PFESIDEGHVTHNWDEVDPDPNQLR
CIKWMGGVGYTK	QRSPAPGSPDEEGGAEALAAGIR	MRESALEPGPVPEAPAGGPVHAVTVVTLLEK
ASEIHMPGPVCLIENTK	PAAVRPPAAAAK	LPEGHLPEVAGLK
GHNGLQGLPGIAGHHGDQGAPGSMGPAGPR	LARPVVPGPR	IQTPDALNDALEK
DNSKNTLYLQMK	VVVNSPANANYQER	YTAIPIVGQVFQSQCK
YFYNQEEYVR	DPADASEAHESSSRGEAGAPGEEDIQGPTNADTEK	DAASGAEAPMQPGFPENLSK
RGLVQDETELEDENQEGMTVHSSVHSNNLNSMPAAEK	GGGPAATLSR	PATPATPGAPTSPAEHR
VTLNGVPAQPLGLR	MVQQPTESEPVTINIQDLLSCSNFAVQHR	EEHEVAVLGAPPSTILPR
CGPGLRPCAPLEDECEAPPVCR	GATYSSEIPK	EDLRPSAPQQEGVASK
TPAMIISR	LLRDPADASEAHESSSRGEAGAPGEEDIQGPTNADTEK	RGPGGAWAAEVISDAR
LLQAQAAGVDWREGAR	RLSLESEGAAEGAAASPELSALEEAFRR	ALNSASTSLPTSCPGSEPVPTHQQEQPALELK
ESLLVSAWSEELISK	RQELEEAEQVGAGLSEMEQQIR	DVDGLTSINAGR
TRGDSQPAEAGEAAAGK	TSELPPLK	EDTGLLTTTHGPEEAPR
DLSMIVLLPNEINGLQK	QAIDDDCNQTGQMTAGFLDWPQGTFASQVMLEGDK	DAVCSGVTGAMNLAR
EKQATSDVQESTQESATVEK	LQSPQGFNK	ALDRPYTSK
VQNHCQEPYYQATAAGALTCATPGTWK	DGEGPVREATVK	LAQASHTCGSPPEDFCPHVGAAGAGAQCQR
AQTDREDLRTLLR	TALATGQLPGR	NQQEIPSYLNNEPPEGSMK
VDLNLPNIGIK	QAQVTLIDATTCNEPQAYDDAITPR	GLQIGYCSVDDDPR
VVYALLNLYEHHHSAR	LLIYGNTNRPSGVPDRFSGSK	DSMFGITVK
EGLPWPEQQR	QVEEEDGSR	AEDTAMYYCAK
LHQLVPPQTDVLLHVDVAAAQTGVSR	FNLSQESSYIATQYSLRPR	TSAGMFPGSQPQAPASPVLPARPPPPPLPR
LLDTAFDLDIFKNFS	YFHPYIAYCSNEVYQQR	APADPAPAPADPASPQHQPAGPAPLLSTPAPEAR
SEEAVQVLMK	GPEVDIRGPK	SQQQQQQQQQQQQQQQQQQPMPR
NLIPVGSLVVMDVEVDKIEDQK	EECHVPILEANVDAQPK	NTLYLQMK
QYWEALGAPEALR	HGSHHQQSADSSTDSGTGCR	GTQDSSAVPSAAHQEAPVTSGPAR
SDFVSESEEAACR	CRSTDTSCVNPPTVQNAYIVSR	ASEGAMSDGPVPAEHR
NKYEDEINR	DAEECPETAEVK	EQALQEAMEQLEELELERK
KFDFQGTCNYVLATTGCLGVSTQGLTPFTVTTKNENR	MDLPGVSIADEGETGMFSLCTIR	CICNQLSLTTK
LVLPSGMEELR	KAEGVALTNATGVVESTSQAGDR	NSLSETVR
GSDVIIVGR	EHGHFSSLPQDSAYHSGIQSR	MEPEPAEPLAAAVEAANGAEQTR
GFPEISFQPSSAVVVTWESMAPYQGPSRDPDQK	TTYTENGR	DSMPDESSQTSLQK
AGTGLKGEEVEGAGWMPGREPTTHAEAQGNEGDGEEGLQR	DVPGFLQQSQSSGPGQPAVWHRLEELYTK	AQREDELTFTK
FGGGSDAGSKGPMVSAQESQAQAILQQAR	SPSWISASVTGPLEQVEAEAALLTEEVLER	EQLYTTASLK
ADEPQWSLYPSNSQVSEEVKTR	HAGIGHGQASSAVRDSGHR	AQACNLDQSGTNVAK
GCQLTITFSVPNEDVFQELEKR	AGTNMTMVGVHGPK	GNTQATSHCFDVR
LLDDAMSADK	AYAQQLADWVR	EANALAAGHPAQAAAINAR
APYPNYDRDILTIDISR	AAGEVDIGDAAYYFERDIK	DILLQQQQQQLGHGGPEAAPR
RGKSQQQQQQQQQQQQQQQQQQPMPR	AALTLSGAQPEDEAEYYCLLSYSGAR	TYGQVSGEAIK
EVLAQQVQQSLEK	EEIGAVSSKK	LTGSSAQEAASGVALGEAPDHSYESLR
HSTIVLDTNDKESPTASKPCSPENESSPSSPK	VSDALGQGTR	MSLSSVEVDVQAPR
EQELLSQELWQR	GGPGQLGFEGEQGTR	VLGTAGTEEGQK
GWVDFFVPK	ELSEGIVDEGASTSIGPHSIDDSNLNHGNR	NLLASEEGITTPK
VDKTVAPPVAGPSVFLFPPKPK	RDAYVSCLNAIYQNNLTK	FIQENVFVAANHNASPLSIK
TSFRVPNLEEGKSYFFR	VLLDEPPEEEDGLRGGPPPAAAAQAQVQGASFR	ESALEPGPVPEAPAGGPVHAVTVVTLLEK
LAAQEGQFTEPRPEEPPQEK	SIEAMVDVSAPK	EAGFPPGVVNIITGYGPTAGAAIAQHMDVDK
AILQQLLLLR	QTAASAGLVDAPAAAPAAARK	ILGEVINALK
SNNIFQVGECR	MDVENEQILNVNPADPDNLSDSLFSGDEENAGTEEVK	EGEDPQASAQDETPITSAK
APTGEPGGVGSQPDDGDSPRNPHDSTGAPETRPDGR	DLDEDANGITDDGK	SGDTAVYYCAR
SVFKPFIFGVGVAQAPQVLSPTFGAQDPVRTLPR	NKPAVEVASTAQGDFPSEK	AAGFEEIEQDLTQR
TLSVCISDGVFPGMSGPPLVLR	STFGGGTK	GAYHGCSPYTLGLTNVGIYK
ERPQVSENLQKTELSDGK	TGAGEVNGDVGDEDLRPGYLNDIPR	AAGAAEAAVAAVEEVGSAGHFEELLR
LIKENQEAEKLEDDIR	WQQLNPDAPEALQAPAQVPSLFRNDR	TIHDAFCVFEQNQGLPLRR
QGTSGGVNTSSEQIATLTGFPDFR	QSASQLQK	QNPATQNVPR
NKYEDEINRR	NHNSLLSLPQEPYSFSK	RLVVQQAGQADAGEYSCEAGSQR
VGDTITVAAWNHSASMEEEGEDCTLNVYR	LAAAAAAQSVYAFSAR	SLNDITAR
TQCTEFFLAPVKTEVPLAENQSGPDCAGSLKEETGPSYQR	GADGAAGPR	NLPSLAEQGASDPPTVASR
NPDSHYGELIEK	QPEVPSLLAK	SLVQESLSTNSSDLVAPSPDAFR
DYDSLVQPGFFDR	VVELPTQEPEVGSTCLASGWGSIEPENFSFPDDLQCVDLK	RLEGILEGLGLR
ELTVCSSSEEQK	TVFPRELAVEAMK	AFCGNPAAVCLLENELDEDMHQK
SWYSTHSIVGDK	TSRDGAEQQGPEATVEEAEAEAAAFGSEK	DVNERPPQPQASVPLQLTR
FDAIHEEFPR	ESIGSLQDGTHTPSTAMETAIPFR	TVYFAEEVQCEGDSFHK
LVLSTFSNIREELGHLQNDLTSLENDK	NRPETVVSR	SAVQGPPDRDLCGCYSVSSVLPGCAEPWNHGK
IIVATIENAQPILQIDNAR	DTVVFVNQWSVNHDPVK	HSAYQDGQDTIRGHPGSSR
HVVCSLSGGVDSAVAALLLR	LNSHMDALHLGSQANR	NQLEIYNQPNQEGPFDVQETEIAVQAK
AAYSYRPGPGPAAGAALPDQSFLWNVFQR	AQALEVFCDMTSDGGGWIVFLR	LHVSLMENYPGTLEALGEPIR
EVLLHPLVAETQLGEAEVALEASGCPPPSR	VAALDCMEEENQAVCHDYDIHFYPTFR	GATYNIIVEALK
GLEWIGRIYTSGSTNYNPSLK	MNVEGIHCDR	EAFEEAGVLLLQPR
QEMECCLNNILK	LSDLQEALDQALNHVRDAEDMNR	LTPEDLSDDVFK
YLPHHSAHSSQLDADSWIENDSLSVDKHGDNQPDSSSLK	QKPGSTPNLQQK	YSQVVPAVTEGPIPEVLK
IYSLNEGYAKDFDPAVTEYIQR	FNEVSSQQAAIQAYEDTVR	DMVTQASLYLFEATGK
RLEELDLGNNEICNLPESIGALLHLK	SLTEEMALGEPAAAAAALLGGEEI	EADECIVSEDK
LGELTMTDATPDSLSLSWMVPEGQFDHFLVQYRNGDGQPK	FSSPVDMLGVVLANK	ARDEGSYMCSAYQGSQAVSR
EVLNGVQTELLTSPK	ALEWLAVIDWDDDK	ASSESQGLGAGAR
LQPEESTETVDSSYVVGHVLNSR	IAAHPSVQK	HSASQEGQDTIRAHPGSSR
VAALNIQVGNLCEFLPQDKVGEFAK	NWNGSVEILK	NFDREIGHNNPSAMAVESFTATAPFVQIGR
LSVADQEKVDK	ASQSIRSYLNWYQQK	HGAGVAMDGQDIQLPLLK
SFSGLLTMYQR	LPQQTADR	DTVCSGVTGAAK
NSQATASTSLLGPPPGLLTPPVATELSQNAR	VDGTPEIGISWYK	DAGFHSEIFK
AIHLNLEEYR	HVLSTSGLQSDAR	QLQEETPSGGPLTEALPPARK
VLFPGCTPPAYLLDGLVR	TSTNHVSVSK	GFTGNTEGSMLK
STHNLQVAALDANGIIVEGPVPITIEVK	SQREGQGEGETQEAAAAAAAAR	LAQGHTTVDELAWR
VYPERPHPEDQR	VTTVSESTKR	SDSELNNEVAAR
QPELPEQQMGKLK	LVEECDGRR	HTSEEWGECGFRPTVFR
EQWNSLKQNADQQDTEAMPDYKK	MEGKGDVMSTACGTPGYVGK	SFTFVQAGQDLEENMDEDVSEK
HSDHILLFNDAHFLMASLGAHDPQTTQELLTTLR	DVSEGETSDGVRK	EIGHNNPSAMAVESFTATAPFVQIGR
NLVQLYKNEDDTEISKK	MPGAVQQFK	AELTSQELQISTYEEELAK
PAQASPSSSSSSSAPELLGGPSVFLFPPKPK	AQLNVGNVLPVGTMPEGTIVCCLEEKPGDR	SPPGAAAPAAAKPPPLSAK
LLNKVELMLPEK	RRPESSPVQK	LMEHGIIQHVSSK
GQEEISGALPVASPASLR	AQPHYSNPLVAVK	VHLAPPPTWEGYDPSWN
YFSTSVSR	LDPEAYGAPCAR	SLQEEQSRPTTAVSSPGGPAR
AGSGVRQVTSTASTFVKPIFSR	AGAGAGAGAVLK	DIASTPHELYRNDYATMLPDSTEINQDTINR
LHVSLMENCPGTLQALGEPIR	IVGSPFDPTTEQGPQIDKK	GGPEGATTWLMK
TQEACVHQDTQAHHALLR	VTTVSESTK	RGPGGVWAAEAISDAR
AAGSDVNIDMAFILDSAETTTLFQFNEMKK	MEDSASASLSFAAATGTSTSTPAAPTARK	QLQSLTCNLESLRGTNESLER
LLEPHCFPLSLVPTEFCPSPPALKDGFVQDEGPMFPVGK	TTYTENGRVK	VGVVQYSHEGTFEAIQLDDEHIDSLSSFK
AESLVGGAPGPR	TEAEPTHVNK	TRPGELMVGEDDAR
LIQLAKGNLNTLVTEMNELLTR	HFMPLSDVLYGR	HPFGFGQVPDNWREVAVGDSTGMALAR
CPGKPAQASPSSSSSSSAPELLGGPSVFLFPPKPK	HSGIGHGQASSSVR	IYTSGSTNYNPSLK
TEDSNAGNSGGNVLAPDSTKGSLKQNR	IAAAPAGSR	RGAPAGAGSGTQTGTGTGAR
LRSDAVESAAQKTSEDLER	ATDLSIQPPSTDLK	KPAAGLSAAPVPTTPAAGAPLMDFGNDFVPPAPR
LQWFQNHLDPPK	EEPGRPAGEVSTGCLASEK	LLQAQAAGVDWR
VKLEQQVDDLEGSLEQQKK	SGVEVRLPDDLEDLK	QNTGTWESNANVK
NVHFNYPSR	DAAYPPGPPSNLHVTDTTK	VVTTPAFMCETAVHYIHDGIGAMVR
DFKDGTFDPDNLEEYGFEPTQEGK	WEMAEDMEK	ASLIEEDEPAEK
LMIYDVSNRPSGVPDR	SPSEESAPATSPESVSGSVPSSGSSGR	LLIFGASTR
VYGNKDADGFYR	EQDDTAAMLADFIDCPPDDEKPPPPSEPDS	VQGIGWYLDEKK
MQQEIAFQQVMSQIANVK	HGSHHQLQSAESSR	ITQSPSSLSASTGDR
ETQDPTAQSLAASLSTGQLLR	KMYELAGK	EEGLVCQNQDQQGPFK
RGQSEADSDKNATILELR	ANSSATETIKK	DEPLHALYDNVEK
KQTSVDSGIVQ	DINVEQMDVDCK	CDCTPCGTEACDPR
LLSLGAGEFR	MPHQLFIGGAFVDAEGAK	MSGDNPSQLTK
RNTNSVPETAPAAIPETR	SLEAPSGQQHR	VEANVSLPSMQGDLK
LLPSVWSESEDGAGSPAPYR	FTQPLANCTTVTGYNTQLFCCVR	GRPVPMVIPDELAPTYSLDTR
IETAFMDIEEQKANIYEMGK	DLVLLSEIEVAQANDIISYTEISSAEK	DQALAEHCLAALTECAASGDGNILALAVDASR
MVIQEIENSEDEEGKDSGR	IAPESIPSLEALNR	YDNFAHRTEVQK
TEDSNAGNSGGNVLAPDSTK	SQDLSLQEAETEQSDTLDNK	VKLEQQVDDLEGSLEQQK
AVQCQHLEAPNEGTMDCVHPLTAFAYGSSCK	GISFDAAATSGGSASSEK	FEQSANNFYQQQAEGHK
EAASSPQVVLGPSR	IPSSMDSNYQQSSAGQPINAK	ASSSILINESEPTTNIQIR
RGHDAMIAYDALLAAGNSWTELCHR	GEAGAPGEEDIQGPTNADTEK	LQGASWDTQSGPQER
EESSSGSSHAVMDISLPTGISANEDDLK	SVEDSMDVSAPK	TTPIEAASSGAR
ASAILPGVLGSETLSNEVFQESEEEKQPEVPSLLAK	AFGPGLEPTGCIVDKPAEFTIAAR	FHYLTFVPSAEDVYDCR
METKTESSGIETEPTVHHLPLSTEKVVQETVLVQER	TPEVQGRVPTLER	ISNSAAYSGSVAPANSALGQTQPSDQDTLVQRAEHIPAGK
TQLHEDLLPR	MEPEPAEPLAAAVEAANGAEQTRVNK	LACESASSTEVSGVLK
RGEWKDLIATLAK	QCGQVAAAAAAAQPPASHGPER	SMDSYLNQSYGMNNHSGGGGGSR
LLQGKDYIFR	NAYSLEIR	VQLPTESLQELLDLHRDSER
NFDDAFLPVLKPHLEHLVADTHESTQR	NYLTWYQQK	LDSVFEEPLSK
ISVATGALEAAQGSKPQCQTR	GVACVVPGTLEIEGRK	SSQESGEEAGSQENHPQESK
LPEEVATPTTDEEEDSLIAIDR	SGEAGISNTSR	FLENEHQELQAK
NTQEKFNLSQESSYIATQYSLRPR	VGDSVEAGDPAGDGVEAEGPAGDSMDAEGPAGR	LYACEVTHQGLSSPVTK
SAVQGPPDRDLCGCYSVSSVLSGCAEPWNHGK	NHHGSAGEQSRDGSRHPGSHQEDR	EPSAPSIPTPAYQSLPAGGHAPTPPTPAPR
AVSMLEADHMPPSR	LFLVSPLIISHEINEK	GTAAAAAAAAAAAAAAAK
AQQNLSWEEITK	CLFASGSPFEPVK	ATSYAELCNEYR
AHTTSTGLWGLINNAGHNEVVADAELSPVATFR	GQSESTEAPASGPPTGTARPQR	ICHRPEEITR
YAYNVSLK	VSAEAEVALVSPEVTQEVVEEHCASPEDK	ADPVPLESMDSASTGK
RANGEAPSALPYCYFLQK	SQVLSPPHPPLPQK	HQWGEEEPNSQTEK
AEGAQNQDKKAEGAQNQGR	CVCHVGYELGADGR	DMYATHLASGMLGVR
IDGITIHQSLAIIEYLEETRPTPR	SHCGPNPCFR	EVAQQAVDADVHAVGVSTLAAGHK
TYGRHEGQYLRPGEDER	FYMQIFQLSNEQTKTLMFFEGCPQHLGCTIK	AAYLDDLR
TVLEINTPKVEQVPIVDIMFNDFGEASQK	VRENSCPVGAR	LFGSPLSDYYAYSPVQER
TTSQAQTEVPLDDPDR	GLAPGQPVTLR	AQFGDKPSEGRPR
LGEPAGESVENQEVQSK	QSSQDDELK	ADLATAPPHVTIVR
GLVYPARPAQLR	GERVDGNRQIVGYAIGTQQATPGPAYSGR	NTLSLAMLK
SNKPVTIISVISHPSDVMEIR	LRPVSTPGK	GVVDSEEIPLNLSR
EYYAIGSLR	SYGGDSTGGTPR	TVTISCTR
EQLGEFYEALNCLCIPR	AEQQQQQQQQQQQQQQHQHQQQQQQQQQQQQQQQHLSR	AVEVATVVIQPTVLR
VEQMPQASPGLALR	ITLEGPTEDVSVAQEQIEGMVK	VLTGTGNVNVIQPNYPAAAR
STEGMDIVMDNLK	SAHTLVGPTR	AEILESVIK
AQVDEVLQLR	AGEGLDQVR	MFPGVPLDTHDVFQYQEK
ASQSVSSSYLAWYQQTPGQAPR	EQLLELPEQEEGHLK	AENTEGDLNSNLPHAPYHTGDPQLDTAIGQWLR
GRAPPRPSGLPGTPGPR	MEWNGMKWNGMEWNGMEWNGMEWK	AVENINSTLGPALLQKK
AEEGGETEAQKEGSEDAGNLPEAQEK	APQQGRAPQAQPTPGPGPAGVK	GYDQFAYDGK
QSVQAGELLFVVPR	FQPQSADFLDITNPK	ALASYVAACQAAGVVIK
IMDYYETNSQCSEPGIVFITK	CESCAPGYEGNPIQPSGK	LSAYPALEGVLHR
HQLPLDDASLSFAHANCTLIISYQKPK	TSDYEQSETSKPALAQPASAKPVER	HLTAQVCSLEAQVAHADQQLR
SIEDCVQEEAR	ATDTLDSTGK	QIDQFASEVER
VAVQEGINSGTAMSR	EESIEAVK	KQDEEINQIEGER
AHQTGQTVTGSGTQTQAGATQTVEQDSSHQTGR	AGNPETVPTTPGPAADPATPETPAPAAR	AMGIMNSFINDIFER
LQHLLSCYDSGKPVFLGER	IGTTEVEK	LIQLVNAQQAK
LTASEPLTLEQEYAMQR	AGGSGPPQQQQQQQAVARPGR	SYHYTDSLLQRENEWNLFSR
MALGIAAALGSNVIR	RGSDVIIVGR	VAVPHTPGLCTSLPDPVK
KLYESLLVGSLPDVNK	NEDDTEISK	VPEPCPSTVTPGPAQQK
RDTVNPLYDETLRYEIPESLLAQR	LLGLPGPPDVPDHAAYHPFRR	DQAANLMANHGDHCR
PVLIGNEPSLGVSQPR	ETVSTGYTQPQPPPAGLPQNAR	VGEAGLLSVNCSEAGPGALGLEAVSDSGTK
GGSSGNPTTTIESPK	NALEAQNEIHTK	YFEVEEADGHK
SKTTEIIHSTLNPTWDQTIIFDEVEIFGEPQTVLQNPPK	DQEDSDGDLSVNLEYAPTEGTLDIK	IHVLVEPDHFK
DKNFNLPQLCIWK	LLIYENNK	VNDCILQVNEVDVR
ASGVGLPGGANYQER	AEVCHTCGAAFQEDDVIVLNGTK	MTQSPSSLSASTGDR
LAAMVDITTEELKQQFNQEIK	TQPEPESLGPETPGFPEQEEDELHR	RYEVPLETPR
YQELQIMAGR	VIIEMDALSELDMLQAEALQDSLR	LFLDQDLMTLPIQNK
GPKVDIDVPDVGVQGPDWHLK	LTQSSAFYSQR	KLDSVFEEPLSK
TSVVIKWESPYDSPDQDLLYAIAVK	HHEASSWANSSR	LNATEEMLQQELLSR
NSGEEEIDSLQSMVQELR	NALENYPNFTSVVDPPEIVLAK	FPTDTLQELLDVHAACER
ERQEDKDLEAAMLSK	VEAAEQVR	DSLFVLHELGEQLK
RLEQNLSGEEHVQELLKEK	LNASEVGHK	ILDVDNVDLAMGK
DMVTQASLYLFEATGKR	TSSSEDGSMGSFSEK	DTLMISRTPEVTCVVVDVSHQDPEVQFK
QHEDQSMTGHLQEELEEK	TKAEAAEQAALAANQESNIAR	EQFCDYMFQQAVK
NVVFIDMGHSAYQVSVCAFNKGK	HFLEQILFPSSPR	CLSLQAEHAGVR
VLLTCWDPEENKMAPCEFGVLNNLANVLSQHLNQK	WELLQQMNVDTRPINLEPIFQGYIDSLK	ELYPGNYKPNITHYFLR
KEDLAGSSLEDYVR	QRLEVIADK	AGPDAVTHDNEWEMLSPQPVQK
AWMETEDTLGR	FQEEADSVSQTLVK	VSGSSGELPLEDGVSHK
LTAIIEEAEEAPGARPQLQDTWR	CQVEGGSPR	GPGGVWAAEAISDAR
DVASLSSQIQDTQELLQEETRQKLNVSTK	TKGQPREPQVYTLPPSQEEMTK	FLNPNTLER
NTLYHQMNSLRAEDTAVYYCAR	NPNNPNAHGNFLK	EAADTERLTLQALTEK
ISSSSQTPQILVK	ELQDGIGQWQTVVR	SVVIEEVGGGDPGEEAAK
IREPLTAQQLEMTTER	ETQPEIGSSQESGDAALK	SMPESLDSPTSGRPGVTSLTTAAAFK
DYPDFNPSVDAEAIQK	LLIYGNTNRPSGVPDR	SGAHSFISGLPQGYDTEVGEAGSQLSGGQR
VYGSLFHINHGDPFNMEVLVDSWPEYQMVIIRPQK	SSGGGGGGGGSSWGGR	GDAADLVDDGEDESAEHDEYIDGDEK
NTVEIFKFEEGENSLLHLK	ELGGSSQAGNR	MVDFAGMK
RIGQPTLLLYVDAGPQTMTQR	TVSLTPSPATQVETPDLVDHDNTSPLFR	GELFWDDGETK
PDIQPFPQSVSESCPGK	LVPSRDQTLQEELAR	IQENMHYGCASGYK
ETLQLIDSTTSYGLTGAVFSQDKDVVQEATK	DLAVDSASPVYQAVIR	ANYNPSLK
LLLTNDPLEAAHGGNVLITDTWISMGREEEKK	SLLDQENCNASPEPGAEAGAGAGGGADGFPALACSLEEK	RQDIQSDGFSIETCK
TFLNVVKNEGITALYSGLKPTMIR	AMTAYWTNFAK	TAASGVEASSRPLDHAQPPSSLVIDK
IIPILGTANYAQKFQGR	GRAPLTYSLEK	TYFGAEPQSVNFVEASDQIR
ELSLGIFGPMPNLR	GPKVDIDTPDINIEGPEGK	FQLGNSGPNSTIK
GLSEEDIFTPLQTGSCVLEH	NPHCTSPEHK	LYHQLEQETGIQTGYTR
VPVDVACR	TMEEGAETPVYLALLPPDATEPQGQLVHDK	SGTPQLSLPFAAR
LGELTMTDATPDSLSLSWMVPEGQFDHFLVQYR	ADSSRHSQVGQGQSEGPR	LLSDLLPPSTGTFQEAQSR
MVDFAGMKDK	GGPDDDGGYAADFDLRPSR	DLTAEGIQWPR
QMASPPSPLSGEFLDTK	ILDCGSPDIEVHTYPFRWYQK	GSSGSQASDSEGHSEDSDTQSVSAHGQAGPHQQSHQQSTR
VLQALGSEPIQYAVPVVKYNR	CVGEAATRPGR	DSRPSQAAGDNQGDEVK
DLMTDPSWPQK	SPSSMVPSVLINK	MGTPVLEALGDGEFVK
CIYNQEESVR	AASSQTPTMCTTTVTIK	DYALHAGDGSSDPEVLLNIENQR
AEVSPEPLR	AKPPQESPSSASALAEWASIR	QVGDFHQVIIR
WISAMEDQLQSDDPGK	EPLGVNAQGQQVFLK	TQSGESQERPLTQADLGR
DSILLLEDVTWK	GAEVQGDRASPGEK	LGADMEDVR
EAAEDCEVLGQR	ADFSGMSAEK	SEMSCIDGEK
LVQFWAPHLVGPHLGLETGNGRGIINLNAFDPTLPK	GRPMPEITWSR	ALPNSEDLVK
QVGEIQSQEGK	ATSYAELCNEYRK	EVACLETLVR
LIDIFYPGDQQSVTFGIK	EEGEEMPR	REPGYTPPGAGNQNPPGMHPVTGPK
VLDEHIQER	QSPGSPERDYSPYYK	ETVWHLEEFGR
VAVNGVHSLQYK	PASQAKPESQPPAAEK	VTYLVHNFEEGGGIAMGMYNQDK
APTGEPGGVGSQPDDGDSPR	VTEELILR	AILDAEPGPRPALQPSPSIHLPLDAPLPGSK
DRLVAGEDDLEQATEALDSISLAGK	CVSTNMCIPASFHCDEESDCPDRSDEFGCMPPKVVTPPR	QEELESTVAR
RDFHFVYRPLDGGGGGGGSPPCLVVR	EEPRAPWIEQEGPEYWDRNTQICK	NLQTQQASLQSENTHFENENQK
FIEGGDGHLSEDEEIK	TGGAEITGYYVNYR	TEASTELAGTVAHELQGVHQGEFGSEK
QGYQLLEGNQVLHSFTAVCQDDGTWHR	RSGEAGISNTSR	CSATGSPVPTIHWSK
NLHMAEAPANLEQPTSSFHVGTCFANAQR	MPSFGVLAPGK	ADSGVHLCVIDDSNEHMLTVWDWQR
GDFPTDCVYVMPTVTMPPR	SGHSGYHHSHTIPQGR	HLGDQMEVSLLAVR
LYHLSDSEGNLVVR	PGQSPQLLIYEVSSR	AEVTAPDVEVSLPSVEVDIEAPGAK
NQTAEPLAPEPPAVPSEVELQHLR	NEETPAAPTPAGATGGSSAWLDSSFENR	NTLGSGVTGAANVAK
DSGRGDSVSNSGSDALRSGLTVPTSPK	FSVAGPGPNKPGSGEASAR	SDIIIIAIHR
KAQTSFLHLGYLPNQLFR	SDSDNQQGSGVPSR	TMQGSEVVSVLK
EIQEAIAVASASTMH	CQAGFMSSRDDPSAPCVSCPCPLSVPSNNFAEGCVLR	WLNSGRGDEASEEWQNGSSPK
LLPADALANCDLLLR	AEGAPNQGK	TEVPLAENQSGPDCAASLK
TRYSELTTLTSQYIK	LEEFSVPFK	GGGAGFISGLTYLELDNPAGNK
TLDIPGNSDPNMIPDGDFNSYVR	VVGVFHTEYGK	LTLQALTEK
TVAPPVAGPSVFLFPPKPK	VVEHPEFLR	RPHPEDGDEQSLEGVSSSGDSAGLEAGQGPGADEPGLSR
KQVEILNRHPHFK	ENLQLETRR	SIAASVDVSAPK
AAAAAAAAAPAAAATAATTAATTAATAAQ	MEVDQPEPADTQPEDVSESK	ITQQMVCAGYK
TLDLGKNQLETLPPDLLR	QMGVHGFGR	NRPDSGVEQAWK
HLLHLLLSPLEVR	YANLSSPTSTVSESQLTK	SGAHSFISGLPQGYDTEVGEAGSQLSGGQQQAVALAR
EQLQQEQALLEEIERHGEKVEECQR	GDSGGALLCAGVAQGIVSYGR	KGCAGVITLNRPK
RECDNPAPQNGGASCLGR	LDYDGAILDVDEDDVEK	ICIDAMHGVVGPYVK
AEDPEVDVNLPK	RDTVNPLYDETLR	TLTYFNYDQSGDFQTLTFEGPEIR
KQQPNPGSELCYK	YLDQIGNTTSSQRR	RQTFIDNTDSVVK
ALEWLAHISSNDEK	DQGDCCINYSSVCQGEK	CQPGFHSLTEAGCRPCSCDPSGSIDECNVETGR
TGDEGKAGNPETVPTTPGPAADPATPETPAPAAR	EIVPVLVSTRR	VEGNTVHIEVK
RTLPTQGIDDFLK	ALIDMYIEGIADLGEMILLLPFTQPEEQDAK	SPPDISHGVVAHMSDSYQYGEEVTYK
HQGHRDEEEDEDVPTER	DQAVGNSHAK	HTGSGILSMVNAGPNTNGSQFFICTAK
FQQLANISMSGNNLAEILPPALQDIKELQHNVQK	EIDRNSQQEGSR	
NTVLQQVLEGR	DGHLLNVDQNQNSYR	
NYTSMYDK	VLNGNPQQEDGGLAGVTEQQSGAFDRWEMIQAQELHNK	
YATGGWETVFRPVSETCK	LDSARLEGDLSLADK	
TLLLDVPPGVEK	SDSHFQASHTGCQSPLCSAQR	
YANEVDSDAGAFK	EGMPAPFGDQSHPEPESWNAAQHCQQDR	
SSCSLSVAEVDR	NTFGSGVTGAANVAK	
SSDSELNENEPHLPHGVSQR	CQGSSVSQDSDSQGHSEDSERR	
VLHASLQSVLHKEESLGPK	NHLGSAWEESR	
TEASTELAGTVAHELQGVHQGEFGSEKK	EEAAGISGPAGR	
GLNSWQQQQQQQQQQQPRPPPR	HQDCIEGATATLR	
NYTVQFDVGVQFEEDLR	KFPESETK	
SSMSPTTNVLLSPLSVATALSALSLGAEQRTESIIHR	ALGEDQVAETSAMSDALK	
VSTFVVSTVNTQNPHVNAFFQECQK	QSSNDLFQVNSTSDDEIPRK	
VKTVVQLEGDNKLVTAFK	ECDNPAPQNGGASCLGRK	
DHVGVEILTPLFGTLHPSFYGSSR	SGSSLYQVSTHEQSDSAHGR	
TRSWDSSSPVDHPEPEAASPTTR	QEIAAESSENVDCLENPK	
LAFEEFQLER	GTIFCPPCYDVR	
VFQAVEQASNLTQAPEEEPIPLDQLGGSCR	MLEANDGSGMLDEDEEDLQR	
TPDEGAWTSIYAAVTPELEGVGGR	GQQPHQGLR	
TSSSESSAVISAFFECLR	NEESLPFQNLPIEK	
QEHSQGTTTFAVTSILR	IEDYNRMENVAK	
FTPPQPAEPWNFVK	AAGGPGPEQEASFTVTVPPSEGSSYR	
SPAINLMGFNVEEMCEAHAWIQR	ASQPEAASLGPEMTILFAHR	
SLDYLGEVLK	YYSDGQHRPSPAQHR	
ENPDSFLNHVLALTAQSPNIEHLNEVSLK	RENMDFSISISNITPADAGTYYCVK	
LSEEATEEPDAEEPATEELTAQEATAPEEVTK	ETPVDLHLPR	
RAPVCGDDGVTYENDCVMGR	ASSDMSASAGYEEISDPNMEEK	
LKEAQNTCAMLTTYNEIDMSNIQEMR	YIGAIAMTEPGAGSDLQGIK	
YEDEINRR	EDEGLYTVRVPSPFGPR	
VDHKGPQIDIK	QWWFGGGCDLTPTYLNQEDAIHFHR	
ILVCLLQGSRDDVSSFVDPALALQDAQNLYAAGEK	SETGTRVGVVQYSHEGTFEAIQLDDEHIDSLSSFK	
TLSEDELK	LQGLEADCVRGPDGVCLSGDRGPQGDK	
FVEKPQVFVSNKINAGMYILSPAVLR	NAVDLVYRAEDHATEFQR	
NDNIPEQDSLGLSNLQK	LSGVGNVTPAR	
LNSVTAADTALYYCAR	GPCPFHCR	
GTDECAIESVAVAATPIPKL	GTEEPGEK	
GATYSSEIPKEDSTTFAK	SEIPLQEQNYPAVDSPPSGGGWAGWGSWGK	
LKTEPEEVFIEDSAQSDLK	VYEEDYGSSLEEDIQADTSGYLER	
HIYNREEYAR	MNQADYALDAAVTLLEFYEDYFSIPYPLPK	
LVASELHTSLYSSMVGADR	LLEGEMQPAINAEDADLSK	
RSPESLPAGPGAAALEGGTLR	RDQSIVALGR	
ERDPVPKPSVLFLHPDLGVGGAER	SSAGDRHGSHHQQSADSSR	
AYSPELIVHPVLDSPNAVHEVEEWLPR	DDDLNSFNATDLK	
TFVGEPQRLGSETCLPQHIR	DEVNRLSGLQPQIER	
PAGISPLSLSTEAR	ERPLSAENPGGEPEAPGEGGPAPEPR	
WQGSPAELESDTQGAR	VSDLAATAYK	
SMGSKEDLIWELLNQAQEHFGK	ALDSNSLENDDLSAPGGEPGDFNPESR	
MLKEEQEVAMLGAPHNPAPPTSTVIHIR	REEEEEEEEEEAEAGEEAVPEEEGPTVVLNPHPSLGYK	
GGKQILLSADHIIIATGGRPR		
HQHVCSNLVTTDDLR		
GATACDLVQR		
EAVAVFMEHSFKDENHEFQK		
SEEPLKTDSSASNNNSELK		
LASYQSCLLSSPGTMLK		
DNSKNTLYLQINSLR		
GDLLSENPQQAASSLGPHR		
ALLMKNCNGGAINCTNVQISDSPFR		
VHPGIQSGTTNKPNK		
EENSGLLQELEELRKQAEK		
DNAKNTVYLQMNSLR		
LPNTLKPDSYQVTLRPYLTPNDR		
NLHTHHFPSPLSNNQEVSAFGEDGEGDNLDLWTVR		
VFLTDTDPNENLSAQGEDEWPPLRK		
YFHTAMSRPGR		
VPLASQGLGPGSTVLLVVDKCDEPLNILVR		
ASEEEPEYGEEIKGYPGVQGPEDLEWER		
ANLQEEEGSHEDFSQLLR		
TCSNDVVDYFKR		
RATVEQEMELR		
FLDKLPQQTADR		
ALSQHLPETGTATDQLLR		
EQNYDLTQVSESMK		
MEISAELPETPQR		
LHVTLYDCSFGR		
SSFYSLTSSNVSK		
TADGEFMAVGAIEPHFYELLIK		
QVVVEGQEPAKFWMALGGK		
LLISAASTLQSGVPSR		
LQNMSSGENKPSCICGGENVVENAHTEFPTVTENR		
RLTAIIEEAEEAPGARPQLQDTWR		
LQLWWCGGGPDSSIPDDHQGEK		
GSTYALQTGPLLGQPDSLELQR		
TNHIQALAHSTVGQTLPIPLK		
NANSQEDAEELK		
NSTSFFGLMAAAAISK		
AGHFDKEIVPVLVSTRR		
SPDHSPTEQDDRTPGR		
AGTFPVNGPPRDSLAAASGVLGGPQTPLAPEEETQAR		
SLADYRTEDSNAGNSGGNVLAPDSTK		
AREEVPALHPASHDIGK		
YIELFLNSTPGGGSGMGGSGMGAYGR		
TALDAFGRIDVVVNNAGILRDHSFAR		
SNGGNLLCAVDESNDHMFSVWDWAK		
ARNGDDCPLGPGR		
IGVLITDGKSQDNVEAPSKK		
SEETVPEAASPPPPQGQPYFDRFSEDNPEYMR		
EFHNCQDALELSSFQNVIMR		
IGSVLAVFEAAASAQSAGASQSR		
TLDPNSPQDFIDSFLIR		
SALENSEEHSAR		
ELHMEDSDKPLLSSLFNAAGVLVEAR		
NCEQCKSFYYQHPER		
VWPETPEEKAPAPAPEER		
SHIYFWTLDGGSLSK		
VHPSQMEISETVEK		
EKFWLAANSWGK		
LLEEALLCLLPAELPAKR		
STTELDDYSTNKNGNNKYLDQIGNTTSSQR		
AAEPQGEPGGGGGGGGGGRGGSSVWLEPR		
DVNVENVNQHR		
TEEELKELQAEQQSQEVAGR		
IKEQTVPITSHLMELGLTAAK		
YCLCEDENHEVGSEEEEIPFR		
SLEENLATAKHNLLR		
EQLDMAGAQVR		
EVFPMAALMPGAEK		
RIQQHLGEEASPR		
SGLGPVDLALLGLSAER		
YLTWASRQEHSQGTTTFAVTSILR		
RQLQSLTCNLESLR		
ASEDPLLNLVSPLGCEVDVEEGDVGRDSK		
LQALANEQAAAAHQLEK		
KCCVECPPCPAPPVAGPSVFLFPQNPR		
IIPILGIANYAQK		
RSVSSFPVPQDNVDAHPGSGK		
MVHLTPKEKSAVTALWGK		
LNNISIIGPLDMK		
PLPTTEWLR		
SWLSSSQGVVLTAYHPSGKDQAVGNSHAK		
VSLQALEAEAEAGAETEAVLQR		
FSVPVQHFCGGNPSTPIQVR		
RVHLAPPPTWEGYDPSWN		
LQHLVNELTHDIITK		
YELARGMLEPVQRPDVVLVGAGYR		
SAVGTATPYLHHPGDSHSGR		
EVGAGGCCHALPATGILAFPK		
SVLTGTKDTVSTGLTGAVNLAK		
VTLSALDTSESSFTPLVVIELAQDVKEQTK		
DSAASHQTEPEAYER		
TLADHLGMIAGGTGITPMWQLIR		
QTATLTCTGNSNNAGNQGAAWLQQHQGHPPK		
ESDQHVVPTAPDTEADNCIVHELTGQSSLLR		
AVSFGLMAPAPSGVAVGLGVAR		
MNDADSTSVETMYSVASQCLHEK		
EKSSQESGEEAGSQENHPQESKGQPR		
VMIPLSSIPTYSAAMDSNSFLK		
NPILWNVADLVIKFPEEEAPSTVLSQNLFTPK		
YIQQQKQQQQQQQQQQQQQQQQQR		
AEVLGHKTPELAPR		
SSTTSAVTTSTTSGPETTPR		
DAEEWFHAK		
LQDNELQALPPLRLPR		
EAMKDAVLKVVEEER		
EYFGLQHDDNSVDSPR		
KAADWLFSADVSRPPGSTVYTCMLNHHGGTESDLTVSR		
TQNKEESYDFFK		
FQDTNGKHLLPK		
FLPAEVADSGIYTCIVR		
HALSYNQGQLK		
IFEKPVLGALTTPGEK		
FYLGGPTSVR		
EDAGVVCSEHQSWR		
HASSGSFLSSANEHLKEDLNLR		
KLQGIPPSGPAGELKFEPHI		
IAPPEAPVTGYMFGKGIYFSDMVSK		
AHPVQSEFPSAQEPGSAASLDLPEMEILLTK		
LAKDVASLSSQIQDTQELLQEETR		
RASLAPLQAEHSQPHEK		
TPNSVVGHYTQVVWYSSYLVGCGNAYCPNQK		
LGNDAVSQDSSSPALSSVER		
AAPTQVLSMTAQPGPGHGK		
WNYIASSECLPFWPENLSGK		
YVVMDFVMDHPDYPFSDEY		
EAGAQEPLVDGCSGGGR		
SQGAANTTSGENFDQSPLKR		
EDIPVDYMK		
ENPAEPGAVTGSATVTAFWR		
VTSTNNMAYNKAPRPFGSVFSPK		
IIEYGSPEELLQIPGPFYFMAK		
QWECDGENDCHDQSDEAPKNPHCTSPEHK		
ASQDAVTTSQSQYSSFR		
LQSAGSAVPTSSSFK		
IAIQPGTVGPQGR		
CKYVSLIYTNYEVGKDDYVK		
AVLDEAVVVLQAAFR		
KTPESFLGPNAALVDLDSLVSRPGPTLPGAK		
IYDPNKNRYEVPVPLNIPSMPSSTPQGQLYDVLIK		
QQEGCFGEPDAEDEESSK		
GKIYSLNEGYAKDFDPAVTEYIQR		
LQTEAQEDDWYDCHRETR		
HLAVLNGAMVSTPHYSPGLLIEK		
FGSGAAGGSGSSNSSGDALVTR		
VEGFLEEDKR		
RACQNVSVVIHTACIIDVFGVTHR		
HVATQHADEIYHQTDSILK		
GKDWEIPVPVGISVTDENGK		
KLCFKENAEQGEVNMESHR		
QTEHSPEDAACGPGHICSER		
GLHLNLGNTIMKDYEYLWNTVSK		
ENITSDSLLTTSMASESTVK		
MQQEIAFQQVMSQIANVKK		
ILEAAGGQILIDGVDIASIGLHDLR		
GAIQFVTHYQQSSTQR		
NQVVLTMTNMDPVDTVSYCCARI		
LFPMAFNLVK		
YVAQAGLDLELLRSNRPPTSASQSAR		
AKLDSAHLQGDLTLANKDVTTK		
TEITGATTVTSVGHQSMTPGEK		
RVLQEGSVEAR		
KDEGEGAAGAGDHQDPSLGAGEAASKESEPK		
TLAASGSQPSNGPEPGGQQLK		
TVMIPGPQLKPEEEYEEAQVEAQKPQLA		
FVFSLQTIPR		
DDANNDPQWCEEQLIAAK		
DVSQSSLDGASNNPHGLQEAQSTSTSATAASHTR		
QMAQPFHREDQLGLSLLSLEQLESEETLQR		
IIMATDLDSEDK		
GPGSDSSLFATYNVELVR		
VSSTEGAAKEEPK		
MTENHVSQASVTIR		
FGHGQTPAAFLSALLPSQPPPAAVNALGLPK		
TEYLCENALEGK		
RQEILEEEGEGQEPPLEAER		
GNLNFTCNGNSVISPVGNR		
RTPDGFDSVPLKTSSGGPDMDL		
GYEQHAYDGKDYIALNEDLR		
LLGLELSEAEAIGADSAR		
LMIYEVSKRPSGVSNR		
LQEAGILSAEELQQLAQGHTTVDELAR		
VCSILASLHALADQYEEAEYYFQK		
FFTGVMEPQLMQTSEMGILTSTALLHR		
SRIMQDQSEGNSLQNQALQTLQER		
YTSDKDVPSEQNNYSR		
DGGSPITGYLVEYQEKGTQDWIK		
LEPTLHLLGVQFDQNVAHGIITEKPGVATK		
FSGSGSGTDFTLTISSLK		
RSTSDCGGPKDHPLTCDHPQLSGLFL		
TLEKHADKEDLVILFTDSYDVLFASGPR		
HHQEEVGELLGQIQGSSAAQAQMQAETR		
KAFSEYLGTDQSKWK		
LSGLIYEETR		
NVFLPKPTWGNHTPIFR		
DTLNFCFKERLQAVDLTNQPLDK		
WKAPKSPVGVQPILNEHTFCAGMSK		
LLIYENNKR		
VTISVETSKNQFSLK		
YCADACGELDLER		
LHTLQEVNNNVR		
PSQAAGDNQGDEVKEQTFSGGTSQDTK		
FIEGGDGHLSEDEEIKR		
GTAAAAAAAAAAAAAAAAKVPAK		
QAVEMKNKSEEEQSSSSVK		
GSAVPVDGYISGLLNDIQK		
KTKAAAAAAAAAPAAAATAATTAATTAATAAQ		
SLEVLVADLVNAQKDSMPDESSQTSLQK		
DLYHYITSYVVDSQR		
YGVNRLEEMLRPLVEEGLR		
NSSRDSGRGDSVSNSGSDALR		
VRQGHVEQCECLGGR		
EDLLYQSKGYNDDYYEESYFTTR		
IHTGEKPYECADCGK		
FVVAHGEDMR		
CSGLLQVIFSPLEEEVKAGIYSKPGGYR		
RSIEDCVQEEAR		
KLQSYFAACEDETPAIR		
LECGGSAVEDK		
GPKVDIDAPDVDVHGTDWHLK		
EGQNVNMENLYTALQSIDR		
GFPCSLEHAFSSSPDPVSYIPR		
DDVSSFVDPALALQDAQNLYAAGEK		
QCDNPAPQNGGASCPGR		
ASGYTFTNNGITWVR		
KQEEWGLTSTSVLK		
MEQEDFVMEGHGK		
TPIYPYLLPK		
GQGWPEEEDGEDVR		
LKEEEFCSFQINEFPWEDKISILNYK		
IAPSMCITKPEVDFALEVFR		
VDSDSSKPPETLTNPPGVCQEK		
GLQAQEGTVSWAVEAAPQTSDR		
AFEPYLEILELYSTK		
GFYPSDIAMEWESSGQPENNYKTTPPVLDSDGSFFLYSK		
SVDLDLLCGHYNNDGNSPSFGLLR		
MAPYQGPEAVPGALDYK		
GFHPDPEALKGFHPNPEALK		
NYSGTPPPALHEGPSLHLQAGDTVELLK		
VGSHDLTLVNLHLAALTLLGSENSSK		
ASLIEEDEPAEKENSSK		
MTLDLNDENDAGNLITFPK		
FTFAATRPSSVLVEQLAVCVSK		
LGQTPFDVADEGLVEHLQLLQK		
IEPHHTAVLGEGDSVQVENKNPK		
KPQYEQLTAAGQGILSRPGEDPSLHGIVK		
EKYLTWASRQEHSQGTTTFAVTSILR		
CRPQEDTGWVLFPVNK		
NTLYQMNSLRAEDTAVYYCAR		
HMAGAAAAGAVVGGLGGYVLGSAMSR		
VLEVDTQGTVVCSLDR		
VGAGLGGLFTDK		
GIYNQEENVR		
RIVGSPFDPTTEQGPQIDKK		
VAEQRPGSILYGTHGPLPPLYSVSLALLSSELAR		
DPADATEAHESSSRGEAGAPGEEDIQGPTK		
LHFFMPGFAPLTSQGSQQYR		
SLAAYTAACEAAGVAVKPWR		
LQGHTPGEDHGEVVSQDR		
NLDKLIQLVNAQQAK		
QAADFALK		
KQCQQLQTAIAEVEQR		
VTQEFLEYHVNR		
LREENDLGPAGMVDSSQGQGYLEEK		
EFENLYIENIELR		
AGAGPPGAQGPGPEGQSLAPALR		
MDTESELDLISR		
ALRPDMGYNTLANFGIEK		
ITHVALDFWR		
ETLCQWSTLSYPGLVK		
VLAVPAENYDYQILHKK		
VAMLEENGECVLMEGK		
DSQIYAVDYETLTRPFSGR		
SDPLKDDPHVSSNVTSNDR		
QKLTAEFEEAQTSACLLQEELEKLR		
LHQLAYDTYQEFEEAYIPKEQK		
MDPNCSCSPVGSCACAGSCKCKQCK		
TVEHGFPHQPSALGYSPSLHILAIGTR		
ISTEVDITNVDLSTVDKDQSIAPK		
CGKTLTSGGHAEHEGKPYCNHPCYVAMFGPK		
AEAEDTSKDPVGR		
QEVPMCTDSEPR		
SLLGKEGEKLYTPSGNIVPR		
AEEWLKLLLEYQK		
YCICNSGVVR		
NSLYLQMNSLRAEDTALYYCAR		
VLKEQALQEAMEQLEELELER		
HILELQEVYDYLYQPSYR		
AELQTESLTPVPNSGSSVLGSLFK		
WLDLTVVEAK		
DLSMIVLLPNEINGLQKLEEK		
DYDSLAQPGFFDRFLR		
KVPSRPPPHYPGIK		
HIYNREEYVRFDSDVGVYR		
SVDALDDLTPPSTAESGSRSPTSNGGRR		
LFSVPSVFTPAIDTKAPEK		
APTTQGTPQTPKDDPAITLLNNR		
ASQGISNFLAWYQQKPGK		
AEESMGIGSEEKPGR		
EEIVHFGIK		
VTLEYRPVIDKTLNEADCATIPPAIR		
LCFTVQGFPMPMVQWYK		
HRETLDPSAPR		
ITQQLTFLHFQR		
ATDKDITDTLSNPEVFNYGVETHEAYK		
VHTVMLPPASETFPPGMPCWVTGWGDVDNDEPLSPPFPLK		
TQWLEVDTRR		
ESGPALVKPTQTLTLTCTFSGFSLNTSAMR		
VVQETVLVQER		
SPPVGSGPASGVEPTSFPVESEAR		
SLCACSDDCKDQGDCCINYSSVCQGEK		
QTWTDEGSVSEQMLR		
ANFLNSNDVFVIK		
VHIEFTEGEDKITLEGPTEDVSVAQEQIEGMVK		
VNLPQYPPTAIDYK		
TEVPLAENQSGPDCAGSLKEETGPSYQR		
QGGPPGPTRPLTSSSAKLPK		
LLHGMKDDVVPWHTSMQVADR		
CLIAEVWCPEADLQDLHR		
EYWQVCTMLK		
SMTSELEELDKPEEIVPASKPSR		
EHLVQAMPENLQEAR		
TTQNIATGTKNTFGSGVTGAVNVAK		
DQQKQQMFENKLIK		
MADALDNYVVR		
LKAGVAAPATQVVQVTLQSVQR		
LQGGAGPEPISEER		
ADPVPLESMDSASTGKTEPGLLGK		
AFYPASLSPPAAGTAAGLPTALLR		
DGQYFEPVVPLPDLVEVSSGQENEQVVFSHR		
LQFKDHIVLTVLPDQDQSDETQEK		
LAQMVDDGAFTAGLAQVSFDKLK		
VLWLDEIQQAVDDANVDEDR		
PGFFFEPTVFTGVEDHMFIAK		
TLACVCALLVWHPAGPGEK		
GPSAAGGHPGPAASEPVLPPLPGPQR		
GEVYSCGWGADGQTGLGHYDITSSPTK		
GFSSGTVDALGVLTGAQLFSLQR		
YELYSETQR		
KENVATTDTLESTTVGSSV		
VQVLAAQLLSEMKLQDGKR		
ITQGQPLEVAFGSQITLR		
LSSSAIPHLYSEALK		
ETDAHLANPVLPNEVLQEAVPGSIR		
GATIGVLLDFNRK		
EPQVYTLTPSREEMTK		
QEYFVVASTLQDIIR		
MYYSAVDPTKDIFTGLIGPMK		
LCQPEGIHICNGTEAENTATLTLLEQQGLIR		
VTITCRVSQGISSYLNWYQQKPGK		
RLVVQQAGQADAGEYSCK		
AAEIGYEDPINPTYEATNTMYHR		
EDSQTAGANCGTLGK		
TYFGAEPQSVNFVEASDQIRK		
VVNVIGAHYPGTHSAK		
VGSEKPGTTLPQPPPTTCPPGALQAPEAPASR		
ALGFEAAESSLSK		
RASAILPGVPGSETLSNEVFQESEEEKQPEVPSSLAK		
GSLAEMAGLQVGR		
SLRVEVDLLIGSSQDDGLINR		
DWAQTAFDESISLSAVGYFR		
SPHSSTGVKVLAFLSLAEVGQVAGPGPQR		
ITGSIANGTDGFVINLGQGTDK		
LHLQLGQPAAAAALCLELAAALR		
TNGKPEEKNHEAGTSGCSIDAK		
CPEALFQPCFLGMESCGIHDTTFNSIMK		
LYVEPAAPLGALTYIPTLEPVSR		
KGEPGAEPGHFGVCVDSLTSDK		
EKYLTWASQQEPSQGTTTYAVTSILR		
HELTDEELKSLFTNFANVVDK		
LSEPAEITDAVK		
RVALEELENKPR		
IEEIMPNGDPLLAGHNTVDEVYVSR		
SQNKEDYDGLKEEFR		
FLEVQYLTGGLIEPDMPGR		
EYQELMNAR		
FLEVQYLTGGLIEPDMPGRVPLDEALQR		
YFSTSVSWPGRGEPR		
AYPSQKPLAAWTQDLAMR		
KQLYWELSQLTHGIK		
PRGSSVSQDSDSQGHSEDSER		
ALEWLARIDWDDDKYSTSLK		
YEQEHSAIQDK		
RGDIFYTSK		
VTITCRASHSISTYLNWYQQKPGK		
EVPEAPPAACPEVSQAR		
ADVSQEVEEVLAESHVQR		
ADDAGMETPLCSEQFGSGEAR		
LIVQPNTHLEGSDVQLLEYEASAAGLIR		
EGWECVFCGDECTGLLLSDLAR		
VQQELSRLGMLEMLLPGQPEAVAR		
AEAYLIEQMYDEAIQDYETAQEHNENDQQIR		
ALGEDQVAETSAMSDALKDILK		
EPAPADGAALEHSEEDGSIYEMADDPDVWVR		
TLISITQAKPESESSFLCASSDGMLWNLAK		
SDLSLIQQQQQQQQQQQQQQQQK		
IAYHSANANSHFSSPTQR		
AVMNGLAPGSNGQDKDMDPTK		
LGLSFNSISAVDNGSLANMPHLR		
QEEEKQILKQDFETLSQETK		
TLSTPQEER		
LAAQLGAPTSLIPDSAIVNTR		
VQLLTSVGTSGLFLGVRVREEGAGMR		
AATMPHSVISDSPR		
KLGITPEGQSYLDQFR		
MCINTEWGGFGDNGCIDDIR		
GLNEDELLDFAALTEGHPLDVR		
HGTDDGVVWMNWKGSWYSMKK		
KAFSEYLGTDQSK		
WNETFQKEVLGSR		
IQDVGLVPMGGVMPGAVPAAAAQEAVEEDIPIAK		
VETMTLDLALLR		
RAKPEGALHNNDGLYDPDCDESGLFK		
ALQNFKEGNAIFTFPNTPVK		
IYQFTASSPK		
SDEHVVSGNLVTPLPVILGHEAAGIVESVEGVTTVKPGDK		
LDHGEESNESAESSNNWEK		
DADAGDEDEESQEPR		
YAMAWGVVEKK		
SCCSCCPVDCAK		
ALNVPPSLDCR		
IQDKLPTVTAKEDEEED		
LHVGCDEVYYLGEGEASRR		
LENGLAALSPSSK		
LEKEIEVLERGDSAPAAAK		
EGQGEGETQEAAAATR		
CPTSITQESSFGSPTGNQLSSDIDEYKK		
NPSLIPLLLEAR		
AGPKAEGEEDEVK		
VLIFQEENEIPASVFVKEPVSGAVEGK		
EVNTSGFAPARPPPQPGSTTFWAWSVLR		
DKPLWPVILSPTMEEGHGLDLTYITER		
MQLKPMEINPEMLNKVLYR		
FLIHEQQELWAQDLNK		
AGSLDTYVQCFVLPDDSR		
VYIHHMSPTGGTDINGVLQR		
SENYSLTDFWAYMVVSK		
DSVQHLQTLTQSGADEHEAWNQTTVIHLQAAK		
FSGVPDRFSGSGATDFTLK		
QEELGAMVDK		
KEDVFKDNFDEMDR		
DLHDQFQHQLR		
LKDVGGEAFYPLLEDDQSNLPHSNSNNELSAAAMLPLIIR		
AVVAEKPSNQLQK		
STQMESTCVSASLPR		
QVIITILDQEPDVQNR		
TSSVQLHVAGLQPVLLQDR		
FGNANVVNVLSSHHLIVK		
GLEWVSGISWNSGSIGYADSVK		
LTMSIEAR		
LEQDLSIIQSIQRPDAEGATEHR		
RGLIEVKTDEFPR		
DNDVLLHWAPVEEAGDSTQIIFSK		
GLNDYAVVMEKEEVEELFQR		
GQFVMEHHTLPDVK		
TNTFPLLEDEDDLFTDQKVK		
ESGPALVKPTQTLTLTCTFSR		
EEGEAPSPAPASEGR		
DTEGGPKEEESPV		
TSIKRDTVNPLYDETLR		
IEPHHTAVLGEGDSVQVENKNPKR		
WKNEVQIHSGSFQSQVELSNDQEK		
ATQAALSLLEALDTILPPTRPTDKPLR		
ESPGALVETSAGEEAR		
KQYDQFGNDKSQAAR		
HTQTSSGGQAASSHEQARSSAGDR		
ECTSLCCEALTCK		
TYLDLLCSMCDLSNASVKTTAKDIQQTEQTIEQR		
LNVSLPFVSR		
GLQTGPVPPGRLAGPPAVATSAAAAAAASYPALR		
VILEEHSACENEVSK		
VAVVQYSDRTRPEFYLNSYMNQQDVVNAVR		
NAAGSTSVAFLVEIHTVPTIR		
HNQVESIFLSAIDMYGHEFCPENLKK		
GGMGSGGLATGIAAGLAGMGGIQNEK		
HEESEMHINNSVK		
APKVLIYGASSLQSGVPSR		
VNSMQTVFVGYGPTFK		
AKLDSAQLEGDLSLANKDVTAK		
YRLPPGVDPAAVTSALTPEGVLSIQAAPASAQAPPPAAAK		
DGERPSGIPER		
GCPHVLGYEGPGDPASDEGDGLPGDRPR		
IQNEGVVLESEETNQTNK		
KALAQVFCEESGSSPLLQK		
YLLAFLADDLGR		
MKGTAHYHSLPAQDNLVLK		
GDTLMASTLGQHK		
YLKHQTFAHEVDGRSEQVHGVINLGNSLIER		
LENHVNDLK		
GAALKVGQMLSIQDNSFISPQLQR		
AAPQNGGSSEPPAAPR		
LEGDLSLANKDVTAK		
DLLLSEIPSSTASLCSR		
KLIVQPNTHLEGSDVQLLEYEASAAGLIR		
AEDEENEKETAVSTEDDSHHKAEK		
YQLEKEDTVEVLAIDNTSVR		
CLAENAGDVAFVKDVTVLQNTDGNNNDAWAKDLK		
ITNNMFCVGFLER		
GETGPAGPTGPVGPVGAR		
VKGDMDVSLPKVEGDMQVPDVDIK		
CMANKVMEDPGQGSSMAR		
VPSFETAEGIGAELKAPLKQEPLQVR		
ANNSMEQGENLQK		
DKYILQGVTSWGLGCACPNKPGVYAR		
GSLPILYQFHHEDAALER		
VVVLPSGALQISGLQPGDIGIYR		
EVGKDDYVK		
TLSGPLDLEQNGQGLPFK		
DKTVVLGDLLIDNKDTVR		
KNPDIPQLEPSDYLK		
EWQELDDTEKVQR		
STHSLAILGPENPK		
DKALEQKNTALEQK		
WPGSETEVPPPGPAR		
QEVPTCSDPEPR		
IEPDEAPVVAVLGSGGGLR		
HLHLASPVQESPFYILIETSGSNAGHDAEK		
EPTTHAEAQGNEGDGEEGLQR		
YENESLQSGR		
MHKEEHEVAVLGAPPSTILPR		
TSGSKMALSTGDVVEVVEK		
KHGGSIVNIIVPTK		
DPAGMPHPQTGKDLYEPSHGAK		
GTAAAAAAAAAAAAKVPAK		
DFAHMLLLK		
LQGIPPSGPAGELK		
LATGSDDNCAAFFEGPPFKFKFTVGDHSR		
LKGDIDSNAAIDLSNK		
QILLSADHIIIATGGR		
QPAGKGLEWIGR		
LLNLLADLVERDR		
GTQVVGSDMTVTVQFTNPLKETLR		
ENVAFEQEKEGQSNEKNDFTK		
GLCVDGQCVCEDGFTGPDCAELSCPNDCHGR		
QINDLKSQNDALNEK		
VPSLGYGSPAAGAASADTAAR		
FIRQLIVPNEK		
EWQLNQKR		
SYGGPCGTAPVWGTPPSYGGGCR		
MAEGAQPQQPPQLGPGAAAR		
LPTVTAKEDEEED		
TSNGQHFHLTSTFTMEDIYQNR		
YWCNDGKNPGAVNACHLSCSALLQDNIADAVACAK		
LAAVAQGLQQTSIPK		
EVVQGSSAPAASSPTWK		
TLTEEEVEEVLKNIFK		
AAEVAPAVR		
LTIYTTLIDVTK		
QTLPVTLR		
ESGMATAFIHALER		
LGPELPLAMDRFPYVALSK		
NVVFIDMGHSAYQVSVCAFNK		
LQPHSNGKVDLNLPNIGIK		
FRCPEALFQPCFLGMESCGIQETTFNSIMK		
EANHSEGQEGSEETDMR		
FLDKDGLISK		
AVATSPSLEAPAALHVFPEVTLGSSLEEAPSPVR		
TFQALEIDLQAQYSTK		
QAMQPLLGSGAELVGAR		
VEDACILTCNVSLEYEK		
EAPILKEFKEEGEEMPR		
AFFPTCCVSADSGLLVGR		
ESSTDDSNIWIGLHDPK		
DCSNRGLCVDGQCVCEDGFTGPDCAELSCPNDCHGR		
QQSVESLAEEVKDKVPSLTTYEGGDLNNTLEDLR		
AKLDGAQLQGDLSLADK		
AGALNSNDAFVLKTPSAAYLWVGTGASEAEKMGAQELLR		
TLTSGGHAEHEGKPYCNHPCYVAMFGPK		
EGQGEGETQEAAAAAAAR		
AGSHTAQNSDVFVPESDRSDYNCTGGTEVLANSNR		
PPQGGNQSHGPPPHR		
ALASYVAACQAAGVVIKDWR		
LEGDLSLANKDVTAKDSK		
AGEPNSPDAEEANSPDVTAGCDQAGVHPPR		
HGDVHFDHFHPCAALTTDHIER		
LDHFNFQR		
HWLVTDIKGADLKEGK		
LQCPQVDLFYLHTPDHGTPVEETLHACQR		
SILDADPEAQALLEISGHLR		
LNVLESLIK		
ESGPVLVKPTETLTLTCTISGFSLSNAR		
TVALQEGLRR		
TISPAESTALFQGR		
VCLVGCGFSTGYGSAVNVAK		
QPFCDGSHFFQCTGLSPLK		
LPWVCEEGAGIPTVLQGHINCGSLLGYR		
HLSQSSLLLEHLLSSWQQIPK		
VEKVPSFETAEGIGAELK		
LGLDFPNGMLGSLLAQLSFPGFPSIQLPYLIDGAHK		
EDHDEALKNTWDLHPTSSK		
ALAVWSLDGQQALQVR		
MDKDLGSVQGFEDTNKSER		
TGEVVLTQSPGTLSLSPGER		
HFHNQEELLRFDSDVGEFR		
LIVQLTVLEPMEKPIFHDPISEK		
VEKVPSFETAEGIGAELKAPLK		
KQEELESTVAR		
HWVLSISWSPDGKK		
RTVALQEGLRR		
EAYFSVGLQGIVEKDIETVR		
VGVTALQQAPAVDVVAVGLMSGQVIIHNIK		
QLTLQHHMGSADLNATFYGPIKK		
GSGLRGPLSRFYSGSPTSYFTSGLQAGLK		
KKQIDQFASEVER		
SIIMCRVSLLDGTDVSVDLPK		
TPSETPGPSPAGPTR		
DLCPLLSEHGLQCSLEPHLNSNLCVYCCK		
CPGSLPEGQNNPQVCPYNLYAEQLSGSSFTCPR		
LNEGSSAMANGVEEKEPEAPEM		
MDALATSINQFALELSKK		
NRVGASSKLDSSPVLSPGNK		
HMMAFIEQEANEKAEEINAK		
LTQTSGESTHTDKEPVGEGK		
DQNQQCSYIPGSLDNYQTAR		
VIGIDHIKELVDDSINNVRK		
ISDISVEVGR		
VDIPPLIR		
SSLWEAPR		
LFAYSSWEVLR		
RDVEQLEQLIESHDVAFLLMDTR		
TMLIPPELK		
QAELVPATVNDYK		
SVFKPFIFGVGVAQAPQVLSPTFGAQDPVR		
WEWGTPHNFLYK		
NWGLSFYADKPETTKEQLGEFYEALNCLCIPR		
VPVPGYTKVPEPCPSTVTPGPAQQK		
PWRPLPAQAQSAWEPAPAPATYR		
SEVCGGELALPPVPK		
GVLLDISGVLYDSGAGGGK		
ELETPLAVPGLR		
DPADATEAHESSSRGEAGAPGEEDIQGPTKADTEK		
VELTEDKIDYTK		
NEVLWHPTLNLPLSPQGTVR		
SKDVINFAAEK		
EFENLYIENIELRR		
VLPQELVDLPLVK		
VVSVLTILHQDWLNGK		
ALSCQTLAAGYYHTECVSGCVCPNGLMDDGR		
VIWHGSSPHGIR		
IREEIVHFGIK		
CPKALFQPCFLGMESCGIHETTFNSIMK		
IGQPTLLLYVDAGPQTMTQR		
QVSSLSSSPSTPSGLSSVPSSPMSR		
SLSETCLPNGINGIK		
AALAGGTTMIIDHVVPERGTSLLAAFDQWR		
EADECIVSEDKTLAEMLLQEAEEEK		
QGSTTDNACHLFAELDPNQPASAIVSFVSK		
NLELGLSQGSFAFIHK		
LEELDLGNNEICNLPESIGALLHLK		
TQSTFEGFPQSPLQIPVSR		
AVQDKLNQMVFIWENIHTLVEER		
KMDQTMAANAQKNK		
QIAFPSGTPLHANSMVSENVIQSTAVTTVSSGTK		
AAVFHEKDYDSLAQPGFFDRFLR		
DHRPQMVWDSQVSEHFFEYK		
AFDQGADAIYDHVNEGK		
DLYHYITSYVVDGQR		
DSMFQNLLIVK		
YFHTAMSR		
LVNSLYPDGSKPLKVPENPPSMVFK		
EVTINPDTTCGNDCVCEHR		
LEVYPTSLTKNDLEDSLLK		
NQVVLTMTNMNPVDTATYYCAR		
SSESSPNHSLHNEVADDSHLEK		
GFYPSDIAVEWESNGQPENNYKTTPPMLDSDGSFFLYSK		
AGEGSYALDSESCMEK		
VPEPDYTK		
APGFPLVSSLRPTAR		
KVSVVDYVEPSPQGTR		
KMTLDLNDENDAGNLITFPK		
RMDSLNWDQPISSTQESGR		
VFAEDQDMQYASQSEVPNGK		
PAPGSTAPAAHGVTSAPESR		
AVPNMLKDMATETDASLSTLLTETK		
AKLDSAQLEGDLSLANK		
RCDAEAPEDQCTVTR		
ERADEPQWSLYPSNSQVSEEVKTR		
ASHQWMNTQGGHLALGVYQHVTGEMMGGHAIR		
GVFPPLLQK		
EIPLTPVDQAAFLSEVLQR		
CASIPDIMQQLQFIGVK		
VYGDIIYTPAKDR		
PRPESSQEPAALPK		
LSVFSTIDAPVAPSDK		
SYCFTASKPDGSIR		
SNSKPADGPSDSKSPDHSPTEQDDR		
MDSKQQCVK		
DTVYSGVTSAVNVAK		
DSLPIPVR		
GDCSVRDPEDTAMPGR		
AQDTLAQLQETLELIDHMQCGVTPTAPARPGK		
SRWQQNVFSCSVMHEALHNHYTQK		
GDPGRPDPQAESPR		
TRPEFYLNSYMNQQDVVNAVR		
KEEFHEQSFRVQK		
KTSEDASEYYENYIEELKK		
HSDLAALYTIVAVFPSPLAAQNASLHLNNSVSR		
SVSFEQAVQILQDDVACDIIK		
TLSTDSIQYHLQMQDKNGR		
TITLEVELSDTIDNVK		
IPQDTTQTNVTSAEGWWDQESNCQDGYRK		
IQPEDMFVYDINEKDISGPSPSKK		
LSCAASGFTFSSSAKHWVR		
EAAAAAAATHQQALR		
QLGSAPPGPFAWPLIGNAAAVGQAAHLSFAR		
VSRPESEQLR		
SVGGSEHSPQWSPNGVLLSPEDEEELTAPGK		
SLSSAINASTGDYLLESVNKLFGEK		
NIITTELNSATDNPMVFANRGETISGGNFHGEYPAK		
LNGEIQDLELPQKAEALK		
TVLTGTKDTVCSGVTGAAK		
GKASGSFVVVQK		
TCDLPSCPGTEDKDTLGLPSEEWELLAR		
EWFWDLATATMK		
STHGLAILGPENPKIAKDPSWIIR		
ATVEQEMELR		
PGSSPTTVIYEDNQRPSGVPDR		
NHPVPVIAMVNGLATAAGCQLVASCNIAVASDK		
LIHVMLMDNSTPQSEGGTLK		
AENFTPVFMAPPVHYPR		
STEGDTVIPVLGFVDSSGIK		
VNMFPFVGEQQSEFSSFDKNDSR		
IKGVTCEDVNECEVFPGICPNGR		
SNSAWQLYLQR		
LGQSDPAPLQHQMEIYQK		
MEAIPCVVGDEEVWTSDVQYQMSPFNHGHK		
AASYGLTPATSDCR		
EQQNDTSSELQNR		
TDFGDTEEEVKGPEK		
ALGALDSCAPGLCPDWDSWDASKPVTNAR		
RGHVFLQTDQPIYNPGQR		
GTAHYHSLPAQDNLVLKR		
GLEWVALISYDGSDKYYADSVK		
ALFNYNPNEDK		
SSHGSGKPQEVPQSVTATAASK		
KLSVADQEKVDK		
FLSLESDR		
QAIDDDCNQTGQMTAGFLDWPQGTFASQVMLEGDKLKVER		
QVPELPVIR		
MQHSLAGQTYAVPLIQPDLRR		
ELTFGSSVEVQGQLIK		
SAPATSRPGSAPTPGAPGEADLR		
MNTEPERKFGVVVVGVGR		
SRPSFHPVSDELVNYVNK		
KFFDMELENLER		
EGAIISGDSPVATNKLDQEVQEETQGR		
TAASGVEASSRPLDHAQPPSSLVIDKESEVYK		
TQTVEVPCPPPSPR		
YLVNFIGQGPATYGPFCAER		
LIYLEHSPNSEGAASHTGDSR		
LLSDTDDLILENFYDK		
HPPPPPFQNQQRPPQR		
ELALGQNR		
APLPEFGAVSLKPPQPQFTDLPK		
ASQSISGYLNWYQQRPGKAPK		
LGCQDAFPEVYNKICK		
MKETAEVYLGQPVKHAVITVPAYFNDSQR		
KEEENASVTDSAELQAYPALVVEK		
LLESGDLSMSSVK		
RFGIQAQLVTTDFQK		
GMLQPGTALVLLEAQAATGFVIDPVR		
AAPSALGALTCHHTFGGWGTLVNPTGLALCPK		
KSDIIIIAIHR		
FAENPKAGDEFVEK		
VFTTLVLCDKPLSQDPQNR		
AKEHMLQTNWK		
MELLHPLGLDSPIAGFLQK		
AGVETTIPSK		
DKQVNSQLYSK		
AFFQSHPAPSAER		
VPTNLAVEEALSLQDGCR		
GAVNVVVAETDYQSFAVLYLER		
KHTDSVAELGEQIDNLQR		
ELEAIFGRPVVDR		
LGAGYGLLSEAELKVVPIIAK		
NYLQDENENR		
MVHLTPVEKSAVTALWGKVNVDEVGGEALGR		
ALEDVFDALEGK		
FRPTTAANGLEPLLTK		
HIDCAAIYGSEPEIGEALKEDVGPGKAVPR		
GVDQEPLNLFYIER		
AKLDGAQLQGDLSLADKAVTAK		
VVAPVESHVPESDQAQGESPAANEGTTVQHPEAPQEEK		
EPSGGGSTALLNK		
IKFPTVVAGFDLVGHEDTGHSLR		
MEMPSTPQQLQNLTEDTR		
FLGQILTAFPALR		
VTTPDMSTTQHNK		
NLGESPTGSADSAGIALR		
VSVAIEEDLEPENGILELETKSSKLVQNIIQTAVDQFVR		
SLDFNTLVDNLSVDPETGDLWVGCHPNGMK		
EELLAESGSGTLDLPALTR		
DNTRNTVYLQMNSLR		
VGQMLSIQDNSFISPQLQR		
GAMQTGLNTTQNIATGTKDAVCSGVTGAMNLAR		
KAPGTKGTAAAAAAAAAAAAAAAK		
LEGSDVQLLEYK		
GWTGQESLLDSDPEMWELLQR		
QIQEAYEK		
GPGLNLPPPIGGAGPPLGLSKPK		
TQCTEFFLAPVKTEVPLAENQSGPDCAASLKEETGPSYQR		
GYMLSEEPYIHANYQPVEIPVSHQPESK		
SPDATLSPATTTSSGVSK		
NWHNSVTACQEVR		
EAESCDCLQGFQLTHSLVGGTGSGMGTLLLSK		
VSPGLPSPNLENGAPALGPVQPR		
SCGSSTPDEFPTDIPGTKGNFR		
LGQMTVRDITSDSLSLSWTVPEGQFDHFLVQYKNGDGQPK		
AAEPQGEPGGGGGGGGGGR		
SDITVVVFFIMPAK		
MYSHPLHNDPDLETVYTLCEK		
TPESFLGPNAALVDLDSLVSRPGPTLPGAK		
VIFDIVDLYTTWEAMEK		
LYVEPAAPPGAPTYIPTLEPVSR		
AARPPPDQLASEEPWTVLPEHLILVAPSPCDMAK		
VPTASTTFAPTTR		
QLGCGWAVQALPGLHFMPGR		
HDLQGLQSDLPLTPEQLEAVFESLDQAHTGFLTAR		
LKEEEFCSFQINEFPWEDK		
RAQQEQLLLQQQLQQQQQQPPSQLCTAPASSHER		
SLDPMVYMNDTSPLTPEK		
DAVLKDLGDLIEATGFDR		
DAAVGTLVQMR		
VILQCNVFGSGTK		
SFNGFSSAQKNQEQLLTLASILR		
LAAELSATLEQAAATAR		
NNLPTAISDWLYMK		
NVHFNYPSRK		
VHDRSEEEEEEEEEQPR		
LQDSDTEYGSGYPNDPK		
NTIAVGVDPQEGK		
ELIHISDWLPTLMK		
SMSMDETDKSPCEAGR		
DITYQYKYPEGSSEER		
ELVLTQTGQCGNQIGAK		
SFVHLKPMSHELPCGHTQTVQAHYILNGGTLLGLK		
LYLSVAGVSTTCQEHSHICL		
SLDVLGWEERQLALVK		
TKAAAAAAAAAPAAAATAATTAATTAATAAQ		
NMENYLQALNISLAVR		
LDKEFYEEEERAEADEIR		
EEEVPAGEAAASQPQAPTSVPGAR		
GQAGGGGPGTGPGLGEAGSLATCGLPLAK		
QDSDALPSPELLPQDQDKPFLR		
VENLLFHVVSTPTNGQLVLSR		
QLGIPQTTVFTPVAR		
SSPTTSEGTSMPTSTPSEGSTR		
SEKETVIVEEQTEK		
SMPVFLDPADIAALEGISWR		
SWDSSSPVDHPEPEAASPTTR		
ESQGSDGFEESGTLLK		
SNKGESPVEPAEPCR		
FSQPELSEHPQK		
SILDQSISAFMR		
SVVSDVPEELDFLVPK		
SIHQPDPTAVEQISLESVDMDSPVNMK		
SWTAADTAAQISQR		
CPAPELWGGPSVFLFPPKPK		
ECINHGDLNNHNILIESSK		
ASSGDIGSLDYQEFVVDIESR		
NVVYPLYQLGGPQLR		
GTNGAPAYSIYGR		
IISHFSQDDFTALVQMTEK		
TTAKDIQQTEQTIEQR		
GGGGDSGDPGRPDPEAESPR		
YVCDCSGTGYIGR		
GLAGHFLDYLTR		
TVLTGTKDTVCSGVTSAMNVAK		
ESVHTQTPPEHPLGQR		
MSIYQAMWKGMLQPGTALVLLEAQAATGFVIDPVR		
QAPDQDPGGPR		
QEEDMAVVQR		
AFGAGADFVMLGGMFSGHTECAGEVIER		
SALSGHLETLILGLLK		
AIAHLATEYVFSDFLLKEPTEPK		
GYCNPGIQLCSVGSYTINFR		
LKAFAKLPPNVLR		
NKSTESLQTNVQR		
DLQAALTPGALTAAAAGTGTPGPR		
LGGPGNSFHTPPR		
TEVPLAENQSGPDCAASLKEETGPSYQR		
DLAGYLQELDKDHAR		
NASPSGDEDSSDSPDSEETPR		
WILTAAHTVYPK		
QIFHVLMNSPTITYQQMKTK		
LAKEEGWLAEHMLVLGITNPEGEKK		
NGYSLKDIAVLFTK		
VLSQPMPPTAGEAEQAANQQER		
VIGIDHIKELVDDSINNVR		
GTNCVTSYLADCETQLSQATR		
ISQLEKELIEDLKSLR		
SQENKGEDAPLDQGSGAILASTFSNSGSYFALTDDSKR		
LQQALLPVVDYEHCSR		
KLDDQSEDEALELEGPLITPGSGTAVLYIGPLK		
ADSQDAGQETEKEGEDPQASAQDETPITSAK		
NSTIVFPLPIDTLQGIIGAK		
ELDVDSIIAEIK		
CSGLLQVIFSPLEEEVK		
EEAAQQQQAEEK		
LTIVDTVGFGDQLNKDDSYKPIVEYIDAQFEAYLQEELK		
LQPGAFQLSGDQLVVAGPGEPAAAR		
CECQSGYEFADDR		
QLQDAQILHSVAIDSGFR		
EELGHLQNDLTSLENDKMR		
IILFLPCISQK		
GDCGDTLAATQSLVMK		
VCQPPPEILHGER		
EHLPDEFIKDEQNKGLIDEITK		
IDLTTIVKPEAPFDLSVIYR		
LQGTLAADKNEILFSEFNINYNNEPPMYR		
QQTVVGVNYFFDVEVGR		
TPDWYNPER		
DKLGPELPLAMDRFPYVALSK		
FLMGTNSPDSRDGEGPVR		
LLVNLADR		
KHTLSFVDVGTGK		
TLSPEIITVTSAVGPVSMAAPTAITEAGTQPQKGVSQVK		
VEGDMQVPDVDIKGPK		
TLTPVGHQSVSPGGTTMTPVHFQTETLR		
HIDCAAIYGSEPEIGEALKEDVGPGK		
CTAQWHNYQK		
SSPVFQIPKNDNIPEQDSLGLSNLQK		
AVFPPEPGAGKPGGAAAEGAGPGAAR		
DEQHQCPLGNLK		
GLEWVALISYDGSDK		
SEDELRPEIDEHTQK		
ADNNIDAIEETLETDDTTICSDRPPENEK		
ALFNYNPNEDKAIPCK		
MTLLNVCSIVNNLNSPAEETGEVHEEELVAR		
LLSTCGLIQSVELQEKPDLAESPK		
HCYPLIGSMTYSVK		
QNQEVEKENSHFFVATFAR		
RELNESLQVAER		
SQDKDVSEGETSDGVR		
KLISEVDGDGDGEISFQEFLTAAR		
KDGPHGSVLEEGLDDYLTHLIEER		
LSEKLDSTDFTSTIK		
RPPGPASQSLWGNPTR		
VAPLVFFHFSGARPDQGLALTLLR		
EKDPEMFCDPFTSATTTTNK		
GPDGVCLSGDRGPQGDK		
AKSHPEVSIEHLGQVVQCSHEEGLVCR		
ANGYCFGAQEQR		
ELGIEESIPETAADK		
IKNEPVVFPEGPEISEELKDLILK		
QHNEDILQYK		
TLINESLNFK		
GLEWVSAIGTAGDTYYPGSVK		
QNPGLAYGNPYSGIQESSSASPLSIKK		
KEQGVLTGMNETSVIIAAPQNFTPSVIFQK		
LPLPCPECGHR		
VTDTQEAECGGPPVPDPK		
LQGSVMELLQDVDGVIKR		
LQNIQNTIEETGNLAEQAR		
EFKEEGEEMPR		
SELPLDPLPLPTEEGNPLLK		
GLETHIIALK		
LQNAFWEHGANR		
VLFICTANITDTIPEPLRDR		
NNYNYVIWAK		
GLNLEEITVSRPDSK		
LIVPSQFKPTSPNR		
QVHSDTGISSKAMGIMNSFVNDIFER		
VLEACALQPDVDSFPEGVHTSIGEQGMNLSGGQK		
IVTDYTLAEADAALQK		
EAATLEVERPLPMEVEKNSTLSEPGSGR		
SEESTASHSSQETTGTIVLPAR		
IKPLKLPQGLPTEENMSNTCLK		
ECDNPAPQNGGASCLGR		
GYEAMYTLLGNANGAICAFPFKFENK		
AGPLGLGPGDGCFTLPGHR		
EALLQALGEPGPYLLAGEGPLDKGESCGGGR		
FELTMPCSSLEINIGPFL		
ENINVEEMFNCITELVLR		
SSESDHFSCVQLR		
LKQEYFVVASTLQDIIR		
RDYEAIGIQVLLAQCNPSVR		
DLSAKQLQEMLGLSKVPVTQATR		
TLHQGMAEVYNFDFITMKPILK		
SSQALVASLR		
AVDGFTFTEGDKSPDGR		
DIQIGTTLR		
LPRPGPSFSTPSLALATLR		
IQILNNWMEAQEER		
TAVEKLSWAEAGSQTAAGAMER		
SLTIRVIPIQAHQIVNGAPPAR		
DKLGPELPLAMDR		
AAVDCSVPVSMSTSIK		
GYMTKFPTFPSWLGK		
SRGPGAPCQNVDECARSPPPCTYGR		
MAPGEIKVDDAK		
LLSLFPLSCQK		
PGGSEPPAAFTGDTLFVAGCGK		
DCNDTLEEDNTNLETPTK		
LDPAYFSVGYVDR		
IIDTAGLSEAVGLIMCR		
AMVGHLNELLVK		
LGSETCLPQHIR		
VHSRAPSPLYSVEFSEEPFGVIVHR		
ILAAQGQVSAQGGAQPSVEAPAAPR		
DSKPNVVSNNVFHIQWSLISFK		
ASQALQSEVDTDLHTL		
LQFIDDAFSLSK		
LHEEEIQELQAQIREQHVQIDVDVSKPDLTAALR		
VDDVINVSGHR		
QDALVCFLHWEVVTHGYCGLGVGDQPGPNDK		
LQSYFAACEDETPAIR		
INPQAEWVIKPQPSS		
VFLENVETFIK		
YLDLLPTSLPHAVTCDIK		
QVAAGEDVCLELEVVAEAGEVIWHK		
TESSGIETESTVHHLPLSTEK		
NTLYLQMHSLR		
KQEEWGLTSTSVLKR		
IKNEPVVFPEGPEISEELK		
GIGCHYLEEGAQCPAPLSYVPR		
QLQSLTCNLESLR		
NLLDLLSPQPAPCPLNYVSQK		
RPGGVPEKPHSR		
KFDEFQTGILLYELLHQPNPFEVR		
KDAMWIGFLTR		
DTGHFKVLQNEDVFTLVLK		
KMPYTDQPAKLPEGSIAIK		
AAASHLFPFEKL		
AVMDAAVFLAK		
GKNLSMIVLLPNEIDGLQK		
EGVTIFTLGIEGTSDTQLEK		
GSMPAYSGNNMDKSDSELNNEVAAR		
ADDKVYPGKQYTYMLLATEEQSPGEGDGNCVTR		
LHQLAYDTYQEFEEAYIPK		
LATEDDLVEMQGYK		
LSCAASGFTFSNYAMHWVR		
YEVPVPLNIPSMPSSTPQGQLYDVLIKK		
LGLDFPNGMLGSLVAQLSFPGFPSIQLPYLIDGTHK		
TAMVATVSPAANNYDETLSTLR		
RGEESPGHFLVAATGTAAGGGGGLILASPK		
KILGAFMQIITFR		
QTMQSLNDR		
ENNPIQGPDGK		
DPLSAVNAGNRLVRSHTSMYIEK		
RLSGLIYEETR		
ESQGERPHLSLLIPR		
PQGSSWQGALLSTAQGAISR		
LAVISNFDRRLEGILEGLGLR		
DPSLPVASSSSSSSK		
GHNQLAYDGKDYIALNEDLSSWTAADTAAQITQR		
SRPPGCYTCADCGLNLK		
PCSCDPSGSIDECNVETGR		
LQPNLTDEEVLLLSMR		
AGKDVTGSPRPGGDGEGDPNHIER		
PYAYWYQQKPGQAPVLVIYK		
VNGEAIYETYTWR		
IFLQTLDTHHR		
ALRETLLAQPAAGQATIPEWCQGSAPSGLEGELLR		
RWIQPEPR		
DSRPSQAAGDNQGDEVKEQTFSGGTSQDTK		
EDLGHLCVWSDGCR		
HKLENGLAALSPSSK		
YVNPGNEAVSGHITIYPSWGAAQSK		
YLDKDTVYHLQPSGR		
FLILPDAEAQLDR		
QLLQENEVQFLDKGDENTVVDLGSK		
VLTTGPTPSSFPR		
KGSPDTEFKSGAGTELSVR		
PGIPGSTASLLEPTSGALGLFQGSPAR		
LLNEKEQELR		
EEERAPESSANQTVNK		
MVQCNKGAYFSDDIYKDTEER		
NWMVGGEGGASGR		
FDLIFLMLDPQDEAYDRR		
KQWDLDVGSGCLVSSSLSKPEVFGNK		
SSSYSGEYGSGGGKR		
NLWIPMKPYYTK		
STTTGPEAAPKPSAK		
TSVAIGGIIK		
KLEELELDEQQKR		
GLPAAAAPVCPAASAAAAGGILASEHSR		
EVPVYTYSEPR		
GVSSPDHIFLPIPNWEHKENPETEEDVGPVVQHIYELR		
LDNLFLEQEDEEEK		
ALLPKNTAPDNGPILLQAQTTQR		
TILQNEYMKDDFFIK		
RFCGEHAGAMEEEDAR		
VYGLQSELQYK		
PGPGPAAGAALPDQSFLWNVFQR		
RTSDPALCPLIVSAAADSAVR		
IYTSGSTNYNPSLKSR		
SRPSFHPVSDELVNCVNKR		
EESLPEISLLELLQNR		
LTIVDTVGFGDQLNK		
CDPSTPVPASSAALNR		
LEGPDVSLKVPGVDLPSVNLSMPK		
AGNTIHAILLYR		
GRVLLDEPPEEEDGLRGGPPPAAAAQAQVQGASFR		
GIETGSEDMEILPNGLAFISSGLK		
TTHLSIQSPSADLEVQAGQVNVK		
TVIPTDLER		
ELTAIVQNQQSLIHSQR		
LCNTGDNAVCTTK		
ELPSEQQEQWEAFVAGPLAETNKK		
LLDDAMADDKSDEWFAK		
VPETVSAATQTVK		
LSCAASGFMFSTYEMNWVR		
VLIYGASSLQSGVPSR		
LADKFIHAGVR		
ALLNYIASK		
ASSEGTIPQAQR		
MLPVYQEVKPNPLQDANICSR		
DLEAHVDSANKNRDEAIK		
EPQVYTLPPSPEEMTK		
LLIYSASSLQSGVPSR		
AETEKPANQKEPTTCHTTVK		
LETTNEVTDSDFETR		
EQFMENHNPINSATSLSNIISIETPNTAPSSK		
DVWGLEGCYPK		
ADGENPDILTHCEHDSNSQASDSPDICHDSEAKEETEK		
EHLPDEFIKDEQNK		
SYSYSYSNGPGPFYDK		
LLDTAFDLDIFK		
FSESTAMGASR		
LASTLLDAITDKDPLVQEQVCSALCSLGEVRPVETLR		
NGPSGLRGAAPEGDSAALAEESPPAPSSR		
TTSQAQTEVPLDDPDRAGWPAGK		
LLIYAASALQSGVPSR		
EGHNYENNHNFHMNTPK		
LMHLTSEELNPHPDK		
KFSQPELSEHPQK		
KEIPENSAVDQEA		
AFAKLPPNVLR		
LKTEKAPQDQVDIAVQELLQLK		
VALLLMASQEPQR		
TRGIFAVQVDENRR		
VLAFLSLAEVGQVAGPGPQR		
NGAAGGPRPAPTDGPQSR		
KSVEEYANCHLAR		
ALEQQASTPPPPLLPGSSAEPPPPPPPPPLPSVGAK		
VSTIAGIGIQGTDKEGGAK		
ILNDLNMAIKPGEMTALVGPSGAGK		
LLEEALLCLLPAELPAK		
LQTNGALPDDLKQGR		
GQMTDLYHYITSYVVDGQIIYGPAYSGR		
QSGPGAPNLDCFYQQVTK		
FPQSVYQISVSEAAVPGEEVGR		
DEAEFTCR		
NSSAGGQGSYVPLLR		
LEVLTNKK		
NVWIPMKPYYTK		
VHTVMLPPASETFPPGMPCWVTGWGDVDNDEPLPPPFPLK		
VGALHGILYVLECDLLDDTAK		
HLMPMNPNDDSLFK		
ELLVSALQELQSSTSNSPSNK		
LSCAASGFTFSSYGMSWVR		
VFHFLVFQLNTTDLDSNEGVK		
LENLLLVHYQPGGTAQGFGPAEPTPTSSYPTR		
SPSSSSVGGRRDELEEGAPSEAMLR		
LTEDPAERVLLLEAGPKDVR		
QKLYEPVVIPVGR		
KAPPRPGPVPEAAQPFLFTTR		
DHPLTCDHPQLSGLFL		
ELEREESGAAESPALVTPESEK		
TLTLCHQPGAVFPPGPQEEVLS		
CGTDWEEYIK		
SSSSYHTWNTGTEGSFVER		
AAGFEEIEQDLTQRFEEK		
NQDPNPPPQPEELTSSLHTFK		
LALSPNAQILALASGSSIHLYNTR		
TTLPQDCSNPAPLSSPFNGVHDR		
TAHDSNVLHIAR		
EAEAAQGQTGDETYLDIFR		
AHMGVFTELAILYSK		
ASSESQIFELNKR		
GLEWVTIISYDGSIQYYADSVK		
LENNMLMLPSVRPQDAGTYICTATNR		
ELESCKPGLLGGSLVLLR		
AVDVVLDCFLVK		
SAGILILPIMSR		
GDSAPAAAKENAAAPSPVR		
VDIKGPQVDIK		
QLTIEMFNMECGAFYFLFLDR		
SEDVQSIEVQVK		
VLLNDGGYYDPK		
EVISQLTQVHGTSSPYK		
AHRLHQLAYDTYQEFEEAYIPKEQK		
GAPPSPEAGFATADHSGQER		
NHPVPVIAMVNGLATAAGCQLVASCDIAVASDK		
DISNDAFTALDPLGDKEIK		
QQQMVVAHHYSFAPDGEAR		
NLHMAEAPANLEQPTSSFHVGTCFANAQRGTYFDGTGFAK		
LGMIVDKIDVDKDGFVTEGELK		
KHTGSGILSMVNAGPNTNGSQFFICTAK		
SLQAEPWFFGAIR		
TFKPALQELKPPTYK		
EVTEFYVQNENSVDTWGKRLVIDK		
DVEQLEQLIESHDVAFLLMDTR		
TAQAIKDFNR		
SVEDVRPHHTDANNQSACFEAPDQKTLSTPQEER		
TQCTEFFLAPVKTEVPLAENQSGPDCAASLK		
YSFLHNSQTSFCFSDSIPTPSNMEETQQK		
KILGEVINALK		
MLLQGSGCLAGIYLEDTK		
TFQVVPEIEFPPSLDIHQEIPQQEDQKK		
TPAPLQHLNTLLDGTYK		
TLYQLQAQR		
FSMPGFKGEGPDVDVKLPK		
FNSVTELCAEIPEQK		
EGQGEGETQEAAAAAAAAAR		
QYNIVGLPTNIDFLLNLSGHPEFEAGNVHTDFIPQHHK		
NDWGDHYHWK		
ERPQVSENLQK		
FAVTNQIGPVKEDSDPTLVNPCYDGSHMCDTTAR		
NEEALQVPR		
RLAAQESSEAEDMSIPR		
AELSRSDLSLIQQQQQQQQQQQQQQQQK		
DDMLCAGNSQR		
TTRLQQQHSEQPPLQPSPVTTR		
IKNVDCILLAR		
ETWLNENQR		
QPPLLLAALQAPTQILK		
NGYLHVFYDFGFSSGPVHLEDTLKK		
QGSSVSQDSDSQGHSEDSERR		
ELAKLSAELDKDLR		
LAEDPAEPR		
LQGQKEPGDQGPAHPPGADMSR		
SGYFLSISDSQCLLNNALPVK		
IVVHKDWNSNQVSK		
GKGLLGNAIKWNFTK		
VDLLCTYLQPFSGPGLPIK		
QLSLVASVLLAQGDRNKEVR		
QRVQEALLQLSQALSLMETVK		
TGQEMIEGGHCASDNVTTR		
LQGSVMELLQDVDGVIK		
HFHNQEELLR		
LTAEFEEAQTSACLLQEELEKLR		
VPEPDYTKVPEPGSIKVPDQGFIK		
LETMNQCWESVLQK		
HSTLGTEIEEQR		
LLEVLDTEK		
GKDLSMIVLLPNEINGLQKLEEK		
EVPKCGFLPGNEK		
AESGPEKPHLNLWLEAPDLLLAEIDLPK		
TSYETTDKVLQNK		
DVQEQIAVLMQSR		
KLSEKLDSTDFTSTIK		
SSSFSHRSELLHGDLASLGAAALQPQPAAPPQTASPR		
LTFFNSTLNTSGPVPEGDALPIPGAHRPGVVTK		
VGAIEEFTFLPLTESR		
MRPWEDPPSDLLLLK		
SYEQHNGVDGLANHGQTR		
EQSAAGPAAVPGGGSATAVRPPVPAVDFGNAQEAYR		
LYAESYERNPSGHDQEPQAVLSPLIAIALK		
DAATAAAAAAAAAATAK		
EDYDGLKEEFRK		
VYVELQELVMDEKNQDLR		
ASRSVSSNLAWYQQKPGQAPR		
AENEEEINAELTAK		
QLQIFDPR		
KALPNSEDLVK		
APDPGFQERFFQQRLDHFNFQR		
LPGEGGDGTPAEAR		
HPAGQQLDEFLQLAVDKVEAGLDSGPCR		
VVIQPEALFSIYSK		
SKLEDNIRR		
ENEQGEVDVESHR		
DFELTEEQYVK		
AEEINAKAEEEFNIEKGR		
AQTLGAVVPPGDSVR		
ISELTSELTDERNTGESASQLLDVETAER		
SPEAPQPVLAMEEPAVPAPLPK		
FQEALQTIFNR		
VGEAGLLSVNCSEAGPGALGLEAVSDSGTKAEVSIQNNK		
GGPVQVLEDKELK		
AIMLLEGQKVIPR		
QLLGFPCVEVSGLSTER		
TVVLGDLLIDNKDTVR		
SIDPGLKEDTLEFLIK		
QVPGFGAADALGNR		
LFSILSTALLR		
KVQVAALKASPPLDQDDR		
ISAFFSSVWDTILTK		
AALGTLYLTATHVIFVENSPDAR		
SGNGEGTPVEHVR		
DSVEGDALVNGAR		
GKQTVQVDEHARPQTTLEQLQK		
KTPMTNYTTVR		
NTLYLQMHSLRTEDTAVYYCAR		
LEQNLSGEEHVQELLK		
NAHVPIQTEGVNTADEPTTFKK		
EEYVQEDAGILFVGSTNR		
LLHLLVDDMPVKPYSDGEGGIEDENR		
EEFCGLLSSPTRPLSSCHK		
QFLFDSLLK		
MVSALQQQQQQQR		
QQPAPAVPHQEQAPLLFPR		
NSLYLQMNSLRTEDTTLYYCAK		
EGEDPQASAQDETPITSAKEESESTAVGQAHSDISK		
ELTDKEAER		
FVDADFSDNVCSGNTSHSLNSPR		
GPFKYAWVLDK		
NGLLTNHYVCEVDGQNVIR		
SRPSFHPVSDELVNYVNKR		
QEGQYLRPGEDER		
EGATLVCGGNQVPRPGFFFEPTVFTGVEDHMFIAK		
FLSTLTIDGITR		
SIQTPQSHGTLTAELWDDK		
DGGMHSDPVSLNVLYGPDLPSIYPSFTYYR		
LKGDIDSNAAIDLSNKASLAFLQK		
EEVEELFQR		
ASGGTFSSYVISWVR		
KPVPPSPENLSVICFTSGTTGDPK		
SLDPALSMLIK		
KVSPWETSTSSFFPILAPAVGSYLTPTAR		
SILTSTTTVEHAPIWRPGTEQSSGSSGSSGGGGGSSSR		
YGWSANESGQIFICSQEESIKPK		
SGGSAGGLAEGAGVLAPPPPPPQIK		
QCPKDCSNRGLCVDGQCVCEDGFTGPDCAELSCPNDCHGR		
LLEHVTQEQNELLK		
SEEEKDQQKQQMFENK		
KEDFIVQDLEVWAFE		
IPPGDLVFDPDQR		
DHLQAPDIEEHNTK		
KQAEVVDTEWEK		
ASAILPGVPGSETLSNEVFQESEEEKQPEVPSSLAK		
YGDNNHSQGINWFHWK		
SQRPHQGVDVLCSAGSTVYAPFTGMIVGQEKPYQNK		
NSLEFFTMLAQR		
VVGVAIDLPVWVPKPSVDLK		
TFHEASEDCISRGGTLSTPQTGSENDALYEYLR		
FGGGIGVPTKEER		
DAGFHSEIFKR		
EEENFTCR		
SFQIQIAHLDPENITLSGEGIFHQICLDLPR		
VDNALQSGNSQESVTEQDSKDSTYSLSNTLTLSK		
CPDYTCPITFSSPADITILLDGSASVGSHNFDTTKHFAKR		
DTVNPLYDETLR		
QPLAPLAQPPR		
VDDSSEDKTEFIVK		
FQDVLPYDDAR		
TLDAFPAEKESEWK		
TPDIDVPKENITSDSLLTTSMASESTVK		
AYQYHSYNGWNR		
IYVDIGYVDLSTIR		
LIQEQEQQLVGALAADLHK		
SALGNLAGDNSLGLEPLR		
ADISQEVEEVLAESR		
DGVLQQPMR		
LQSTGNKAEDTKGTECVK		
DALTQINIHYGGVQNLCSR		
LQDSDTDYGSGYPNDPK		
LSGVLYQQHSQALGK		
AVDSKYTAIPIVGQVFQSQCK		
SKSEMSCIDGEK		
ADSQAQLLLSMVVGVFTAPGLHLK		
SIEASVDVSPPKVEADVSLPSMQGDLK		
QEIFHQFVSLSTSGGK		
VVYPSKADLATAPPHVTIVR		
LSCAASGFTVSSNYTSWVR		
STTQELMEDDCVKR		
ESSWVTPESCFYKESWLTGK		
VQVQPLELPMVTTIQVSSQLSGR		
MDATANNVPSDR		
RQESSSSLEMPSGVALEEGAHMLR		
LENVIVTDVDPK		
LPLALHDTPPIPGQPEEIR		
LSSPLHFVNTHFNGAGSPQDGVK		
IQFMCGEDASNVMPVIFGK		
GLEWIGYIYYSGRANYNPSLK		
ANNAGGGLPAAGPGDR		
KNPDSHYGELIEK		
HNQVESIFLSAIDMYGHEFCPENLK		
HNYGAVESFTVQR		
DGTTHQTSLELFMYLNKVAGK		
FENEEAQAVYWHSSAHIMGEAMER		
LLLEAGADPTVQDCR		
NLGVVVAPHTLKLPAEPITR		
EFVEEFIWPAIQSSAPYEDR		
GPTVGGGLPGTGVQGLEGNLQMPGIK		
FVVHGLTTGEQYLFR		
TVAHLQTVQHQLAELK		
QDALVCFLHWEVVTHGYCGLGVGDQPGPNDKK		
IGTTEVEKPAGLLFQQPDLDSALQIAR		
IPVTVITGYLGAGK		
DSTYSLSNTLTLSK		
DYLMSTHFWGPVANWGIPIAAINDMKK		
GASAEELLAQCLSSSLR		
SVKHDPIPAADTFEDLSDVEGGGSEPTQR		
TEEELKELQAER		
IQTLDALNDTLEK		
ASLQASTTAPEAR		
LEKQGAAGSPGGPR		
NFNLPQLCIWK		
RDITYQYKYPEGSSEER		
GLGTDESILIEVLCTR		
IQKLAGCVGSCLYSQLQK		
LLHTADTCQLEVALVGASPR		
HPSSPSALRSPADPTDLGGQTSPR		
GSEGKPSLTLPASAPAPEEALTTVTVAPAPR		
GMDTINTTFGTAVIK		
GNYDAAKRGPGGVWAAEAISDAR		
ASGFEFSQVLALSGAGQQHGSIYWK		
EQDAEGQDYCTLTAFTLK		
SQVIAEKEPEPDLMSPTR		
DTSMSTAYMEISSLR		
SLFHPEQLLSRKEDAANNYAR		
VILQPIEGIMGSDYINANYVDGYRR		
QALSALEEAGAPAPGRPSPATAPVPSSQPK		
LEWMGWINTGNGNTK		
LCASGAGATADTAIEEIKEK		
SDNPVVPSLFK		
LYKWISQNDLLGHPK		
TKLEDYANLK		
AEAPQSCSCENPR		
AAGQPGSELLVVTIGLDGATR		
SKANGGTTDYAAPVK		
TQWLEVDTR		
RVYGDIIYTPAKDR		
SSTGPEPPAPTLLLAER		
QKLQEQQQQMEAQVK		
SFFSLTEIVR		
KGDVKPLAEQISITAGCK		
ADVWDAGHYTCEALNQAGR		
SETAPAAPAAAPPAEKVPVK		
SAAEIVQEIENIEK		
IIEDDEKPVDLTAGR		
EKSNDILEEGEKNLGNIK		
ELKEAPQGAHFLAR		
KVPAQRLQEAGILSAEELQR		
SEQVHGVINLGNSLIER		
MSLPLGIYR		
IKMVAVGICR		
AALAGGTTMIIDHVVPEPGTSLLTAFDQWR		
KLEMDLKDLEAHVDSANK		
GIPFPSIEVGPEDVEEAR		
NGYLHVFYDFGFSSGPVHLEDTLK		
ANGGTTDYAAPVK		
SEGLPSDDLSIENALVIIQSR		
SPSVVLSEPSQESK		
KGDEVDGVDEVVKK		
WETLNDAGFTTANNIAK		
EPSDTSAAFESTAK		
VDIKGPQVDVK		
VWQTVSPVESR		
EAPQGELVPEAR		
SAVEAQNEVTENPKQEIAAESSENVDCLENPK		
CLKNEYIENR		
LVPDLLAIVQHK		
SAGGGTYYADSVK		
FNQENIKER		
YKSDSDNQQGSGVPSR		
DDCNRLQEQFDEQSKENENIGDQLR		
GISSQPFPEQHCAALK		
KPEEGLQVEQLSGVGIPSGECLAQCR		
LMIYDVSNR		
HNDLLSWFEDCK		
DVFGQEPHPVEDDLYKEPTR		
LPLALPPASQGCSSGGGGGGGGGSSAGGSGNSRPPR		
STESLQTNVQRLK		
RLPDGQLQVTWEDR		
YSAQADITDDSLDR		
SEDGTPAEDGTPAATGGSQPPSLGR		
IHLDTSSFMEELPGEK		
TEALNHHNLLICSVTDFYPSQIK		
EAFGTEDGLQR		
SSSFSHRSELLHGDLASLGAAAPPQTASPR		
SRGPGAPCQNVDECAR		
LYLSKNQLEELPEKMPK		
AELLQDICHR		
KFDFQGTCNYVLATTGCLGVSTQGLTPFTVTTK		
KAEEAMEAQEVVEATPEGACTEPR		
DAYDNVTLDVELAHR		
ELNESLQVAER		
NKQTLEKENTDLAGELR		
QIMGTYLVR		
DFHFVYRPLDGGGGGGGSPPCLVVR		
QCLQLSTVPGAEPQR		
IGTAEVEKPAGLLFQQPNLDSALQIAR		
FFQQRLDHFNFQR		
ALEDVFDALEGKSIKS		
TLSDCPALEGSQNGCQHENAAAVR		
QTVQVDEHARPQTTLEQLQK		
DKPELEVVLTEDALKSLENQTYFR		
VEGDLKGPEVDIRGPK		
KEEEEEDDDDDDSKEPK		
LIPGVEYLVSIITMK		
WTGTAPILQQYYNTK		
QQQDYWLMDVR		
ITGSIANGTDGFVINLGQGTDKLNLHFNPR		
GGEKEEGNDGQDLRR		
VLASCLTPSGAEALQR		
ASQGLPGPTGSVVSTGTSFSSSSPGLASAGAAEGK		
VDSAGFGDSVVQYANSR		
ELQTCLQALELGAAEKEEDYHTALR		
PLLQAQGLTPSER		
LMLLNTPGQLPQTLSSPSTR		
MKLTENPEKQTLPGSK		
FELLSEPQFGDLTSVTLMK		
DNAKNSLYLQINSLR		
GTAAAAAAAAAAAAAAAKVPAKK		
MSGDEAVNQGEASQTLK		
GTAAAAAAAAAAAAKVPAKK		
TVLTGTKDIVCSGVTGAANVAK		
YTYDDFKK		
KQIDQFASEVER		
TCSLSYVAGAPQYK		
MKDVNVENVNQHR		
LLSTCGLVQSIELQEKPDLAESPK		
DSQIYAVDYETLTR		
DSSAMAVDAICTHRPDPEDLGLDR		
KHEAFESDLAAHQDRVEQIAAIAQELNELDYHNAVNVNDR		
NILGAQVSEVVPLPEHGVSVVFVNLGNTK		
SYGLPDGQVITIGNER		
ACLGSLHELESEPVIQVTVGSAK		
ALYEVFSHPVER		
KALDSNSLENDDLSAPGREPGDFNPESR		
QMREENQEEAAKR		
QSGICMDSGGFR		
TSDMAPSKETEMALAKDMALATK		
MYALISDAQPLLLSTFSGDR		
PSFHPVSDELVNYVNKR		
DKLGLQILPVDGNPHK		
AGDMAVYYCAR		
ENQEAEKLEDDIR		
MDATANNVPSDRYKVEGFPTIYFAPSGDK		
DLGDLIEATGFDR		
GKCEEAEECPYQVSLPPLTIQLPK		
STGQLNMNPGTTSSNTATAER		
MSKDALNLVQMQEQTLQLEQQSK		
ELEIMQILTR		
GELFWDDGETKDTVANK		
NNEEYLALIFEKGGSYLAR		
KIDLTTIVKPEAPFDLSVIYR		
VILNYPSPWDQEERPAQR		
LCFKENAEQGEVNMESHR		
LRETQDPTAQSLAASLSTGQLLR		
FIAVNGATAHPHYDPDGTAYNMGNSFGPYGFSYK		
DRDGGMHSDPVTLNVLYGPDLPSIYPSFTYYR		
IHEDEVDDMEEN		
EELLAEFGSGTLDLPVLTR		
NAMAHGNSTHQNSLEAQK		
VVEKDNDVLLHWAPVEEAGDSTQIIFSKK		
TQAAVYLQAAWR		
TILTLTGVSTLGNVKNNQESDCVSK		
AEEAPEQSASVEVPSSNVQQHQK		
SGDRGETGPAGPTGPVGPVGAR		
NYGYIYVGTGEK		
LKAKLPEATPTELAK		
EIMQNGPVQAIMQVHEDFFHYK		
FDPQFALTNIAVTK		
CGCYVEDTHYPPGASVPTEEICK		
VTDGTECRPYSNSVCVR		
MVSGAYRQEFGQSKEITSAIK		
LALKLHPDKNPNNPNAHGNFLK		
DELLAQHAAGALGLPNLVAVLTR		
DLHQEAETYR		
KTLINESLNFK		
MYYSAVDPTK		
FQNDHLSVLK		
ENGQLAGSLGPCIR		
ENTIYINEVLCMQMR		
HQAQGDMATMLQLVLLLK		
ADPPKTHVTHHPVSDHEATLR		
CVVALAIDPNILSLSGK		
TLQLAVAINQEPPDPK		
LEEQDEFEKIFK		
MEEKHNQPSEFTIESLENTAVDLFGAGTETTSTTLR		
SEVTELRRVFQGLEIELQSQLSMK		
SFFSLTEIIR		
EADLTEEIEENLR		
LLIYENNKRPSGIPDR		
GCFQAEIVPVTTTVQDDKGTK		
RRECDNPAPQNGGASCLGR		
HVWSHHTLPITDLHCGFGGPLAR		
LSCAVSGFTFSSYAMHWVR		
GDSEPTPGCSGLGPDGVR		
AACSATAMEEDSEASSSR		
TPEVTCVVVDVSHQDPEVQFKWYVDGVEVHNAK		
ACQNVSVVIHTACIIDVFGVTHR		
KFFGSLPDSWAR		
ASQSISTWLAWYQQKPGK		
SSFGLQVLNVHFGGER		
AVHEEVRPVDFK		
TALALLDHPSEYAAR		
ASGYTYTDYYMHWVR		
MKLTENPEK		
AAAGDLGGDHLAFSCDVAKEHDVQNTFEEMEK		
CTLHLGIEPLDSVR		
GCIDMNECWASPGR		
VTITLTDVNDNPPKFPQSVYQISVSEAAVPGEEVGR		
GILEGELEGICGAGTWK		
PMTLGYWNIRGLHSRLLEYTDSSYEEK		
PSFHPVSDELVNYVNK		
ALFNYNPNEDKAIPCKEAGLSFK		
LLIYDASVR		
EVAVGDSTGMALAR		
DNATLQATLLAAR		
KLESQAGICLGDSQGTSER		
DRTQIAICPNNHEVHIYENSGAK		
YKETLQLIDSTTSYGLTGAVFSQDKDVVQEATK		
VNVYHHLVETLKFAR		
FPSLPILSPALMDVSYR		
CFYQLQPAMTQR		
CPEALFQPCFLGMESCGIQETTFNSIMK		
QFCVPGFKNNKGVAEVLR		
QGCGEDKICQSNLQLVHAR		
VEPKYGPPCPSCPAPEFLGGPSVFLFPPKPK		
VDVEYPDVNIEGPEGK		
LTPPAGISATEIAK		
SEGALQVLYGEVGSLDGTPQTR		
HGIILNSEIATNGETSDTLNNVGYRGPTK		
HITSNTTAAEFIMSATPTMGNTDFWK		
LEQQLVHVERPVLR		
WISAMEDQLQSDDPGKDLTSVNR		
NGNTALHYSVSHSNFSIAK		
SVGGSEHPPQWSPNGVLLSPEDEEELTAPGK		
TGCSLTGASVDSTLAFNTYVHFQGK		
GCPVTSASVTAPSTPSGR		
ASSAAAPHTVSYPDNLNYR		
GPYEMSPSLLDYLTMDIYAFPAGHASR		
LGTWGFFSTGDEHSPGNWGHLDQVAALR		
GAVALSDVMIPESPEAYVK		
ALLNAESLPTHR		
EVTVNVLSPR		
YFSTTEDYNHEITGLR		
TSLNEQTYTR		
KQGSTTDNACHLFAELDPNQPASAIVSFVSK		
SLKVELTEDKIDYTK		
IGLVTEGETCGNAEK		
VGLVASQKNNLDAVALMHPDGSAVVVVLNR		
FPSVSLQEASSFFR		
DPGLEPGPDSPGGSSPLR		
LYVELHRGQELGGGQDPVQLLSGFPR		
LMKEGLEAAQLK		
KFQTNLVPYPR		
FIAPAASLGFR		
LSGLIYEETRGVLK		
TQVNTQAEQLR		
GYNQFAYDGKDYIALNEDLSSWTAADTAAQITQR		
ASEAEAPDKHGSSFVSLLK		
HNYEVGYR		
CLAGYYGDPIIGSGDHCRPCPCPDGPNSGRQFAR		
AAMPIVNLKDELLFPSWEALFSGSEGPLKPGAR		
QNADQQDTEAMPDYKK		
GHDQLAYDGKDYIALNEDLR		
GGSGGFTAPVGGPDGTVPMPMPMPMPSANTPFSYPLPK		
NLGIDFEDIK		
FPPEEALYTLWQHNK		
SLSETCLPNGINGIKDAR		
VAQIQTDYDALKR		
ELLLDGDYLQR		
HEGQYLRPGEDER		
SAGVLLLVVDPCNVPFR		
ALELAGQANR		
MEVLEAFVITQSINMLR		
IGCSLSEVCPHASSVLGNLDPNK		
PQATQALESQEWTHQQR		
TQTDSEAQESTATSDETK		
ELNESLQVAERLTR		
TLFDTSIGPLVYSDQYLQISAR		
KEFLEPDSWETLDEQQFFTEEELKEYENIIALQENELK		
IQPEDMFVYDINEKDISGPSPSK		
IGELEDESLNR		
LHGHLYTPGQEITNDCK		
ESGMTTAFIHVLER		
MTNTTYSEPAQNSK		
NNCLQGTGFLEEETTR		
CAPGVGPAEADIDFDIIR		
LGVLHVGQKLEEQDEFEKIFK		
DKDVEDEQEHYISDDLDIETK		
AELSRSDLSLIQQQQQQQQQQQQQQQK		
FVCNPLGSTHPEATLK		
AQVPGHQPEATNLIPVAVK		
TYRPLNEVHIK		
AQFDKVEICNLTPDALK		
EEYARFDSDVGEFR		
FEIGEGEKLDLPYGLER		
GHEVNLEALPK		
AEVQKLQALANEQAAAAHQLEK		
KPAFNLSAFGTLSPSLGNSSVLK		
VSIAELAQASNSLITWGR		
LVLSTFSNIREELGHLQNDLTSLENDKMR		
LGIHSTLLDEKK		
LPLDINPMVHPHGHIFK		
EGTPGSPSETPGPR		
SCATEEQYKGTER		
DIVSYVMDHFDIEIMGGLGPSTGK		
QQSAPEVAVNGHR		
LAGSEVPQDR		
QEEIISILEEK		
ELPELEATAQLLPLEGPK		
NPWSMDENLMHISYETGILENPK		
QLGQDLLNSYTENEGK		
ESAARGPTIL		
SLQSPQEQIILAPSLAK		
TTQNIATGTKNTFGSGVTGAANVAK		
VVNVEIVEEPVSYVSGEKLEEFSVPFK		
KYAYWYQQKPGQAPVLVIYK		
PTLLHLTHGK		
GKDLSMIVLLPNEINGLQK		
YLFAVTGNGLVNQGNNPEVQVDTSKPDILILR		
KATLELTHNWGTEDDATQSYHNGNSDPR		
YGLSAAAAAAAAAAAVEQR		
RENPAEPGAVTGSATVTAFWR		
TPSAAYLWVGTGASEAEKMGAQELLR		
KKLDDQSEDEALELEGPLITPGSGTAVLYIGPLK		
SPFEVYVDKSGDASK		
DYLATYYSFNGSPSPEAEMLK		
DVASLSSQIQDTQELLQEETR		
SDASSDQGPASPQK		
FLILPDAEAQLDREGDAGPETSTAVEK		
EKWLLDGISSGKQQEEMK		
DVNVENVNQHRGEK		
GATYNIIVEALKDQQR		
IKQLLQENEVQFLDKGDENTVVDLGSK		
NFLQTVSSEK		
WLKDEELSPREPVLPPQK		
DAVASAWLTVLGLPDPPEDAEVVAR		
ASLEAAIADAEQHGELAIKDANAK		
GHHTFLTEEVAQEYQVK		
QKGCEENLDEAR		
EIPELEEEKTIPTKEPEQIK		
EGGANGITATNTVSGLMGLK		
KLADKFIHAGVR		
GNAETSASASQTNHVK		
VAKNEVLWHPTLNLPLSPQGTVR		
SQVIEKFEALDIEKAEHMETNAVGPSQSSDTR		
EAEGAPQMEAGKR		
QAFMGEQEKLDVHEK		
NALTGLPSGLFQASATLDTLVLK		
KAEALIQQEHADQAEIR		
KQGPYFEQPLQWK		
GPLEELLHTLQLLEKEPDALPRPR		
EDYDGLKEEFR		
AFSSLNTLPEELRPYVPLFCSILTK		
SEYSSGMEADVAK		
GDGGITHSEEINGKDSSCHTSDSTEK		
TTQIPQFILDDSLSGPPEK		
NHNSLLSLPQEPYSFSKPAQQAMR		
CLAENAGDVAFVKDVTVLQNTDGNNNDAWAK		
FYIPHVPVSFGPGGQLVR		
ELGLVPLTDDTSHARPPGPGR		
ENVAFEQEKEGQSNEK		
KVGTASENVYVNTAHLK		
GCATQPCHHGALCVPQGPDPNGFR		
EKLHSLTQAKEESEK		
AEADVSLPSMQGDLR		
LLESVQQHSLDAVLAR		
GCFQAEIVPVTTTVQDDKGTKR		
GFSQEELETCMINQAPGCPDYSILSFTGAFHGR		
YIYNRQEYAR		
SKLPAAIEQLIVPHLAK		
NLDKNTMGYLQWR		
ALSPPHDTENPYSAK		
RAPYPNYDRDILTIDISR		
DSTTVHEPISKPFMLPSLADVSK		
GAPAGAGSGTQTGTGTGAR		
WCQSMQDPSLNLR		
TSRPRGSSVSQDSDSQGHSEDSER		
NNFPAAAPHPVNGLEK		
NRYEVPVPLNIPSMPSSTPQGQLYDVLIK		
VEQIAAIAQELNELDYHNAVNVNDR		
EIYLEVIHNIPDFELLSANTLEDR		
VPSSDEEVAEEPQSR		
LDSAQLEGDLSLANKDVTAK		
SQQTIPQLHSTVHLIEFAR		
QQPNPGSELCYK		
GPGGVWAAEAISDARENIQR		
CLFDSLQPER		
AINSCHTSFLATPEDKEQAQQMNQKDFLSLIVSILR		
TVALQEGLR		
NGTAGGPRPAPTDGPR		
MFAKEEAELTQEMSPEK		
ISQTYQQQYGRR		
KSEDGTPAEDGTPAATGGSQPPSLGR		
VSIACLAPGSGPITLLLR		
DRYWMHFCGGSLIHPQWVLTAAHCLGPDVK		
SYGLLVVPEPAGCTPELPGEIIK		
GESPVEPAEPCR		
LQNSEPSAPLAGLEK		
ASDTAMYYCVR		
IASSYYPEGDGDSSHLLAK		
EGQIQGAVHTQCI		
ASPLLAIGQTLAR		
LSAELGLQQPAWLR		
DTLMISRTPEVTCVVVDVSHEDPEVQFNWYVDGMEVHNAK		
DALPELLGLEAGIR		
EAALPPVSPPK		
MDALATSINQFALELSK		
KYDYYYNTDSKESSWVTPESCFYK		
ELLTDHRVPSLLLEAMK		
HPPQPQPQPQPQPQPQPEPEPSPWGPLDDVR		
FGQDIISPLLSVR		
NTKLELQDPGQVEK		
TEEAILISLAALQPGLTQAGAR		
WELLQQMNVDTRPINLEPIFQGYIDSLKR		
KLDSVFEEPLSKK		
VKISTEVDITNVDLSTVDKDQSIAPK		
ILIGGFSMGGCMAMHLAYR		
LKEVFPMAALMPGAEK		
KRNTLSLAMLK		
VIAETEER		
TTDLSIPLPSADLVVQAGQVDMK		
VTITCRASQSISGYLNWYQQRPGK		
FNELMVMFR		
AAFTECCQAADKAVCLLPK		
SATSLESESDNNSCR		
MAPCEFGVLNNLANVLSQHLNQK		
MSNWQGAIDSCLEALEIDPSNTK		
LTGHGAEDSLADQAANKWGR		
GSSFQSGRDNTWR		
ADIAVVICDTPQK		
ASGGTFSSYTISWVR		
SQNKEDYDGLK		
GSWGTVCDESWDTNDANVVCR		
YNGDIEDIKR		
EILSVDCSTNHPSQAK		
IHHDQPVKPLER		
YQTPTGIK		
TAVGSNPDTPHFPR		
RDAEEWFHAK		
ESESVSKEEKEQNYDLTQVSESMK		
SRNWEDVEESSK		
YSSSGSAANSFHFK		
NEVQKTSNSEDGSMGSFSEK		
IHTGKKPYQCNECGK		
ILEDMKEEDYLNFILFSGDVSTWK		
LAAAQGQAPLEPTQDGSAIETCPKGDEPR		
PGIPGGTASLLEPTSGALGLFQGSPAR		
VPLGGLQSVSLTIWK		
SFQGPVLIGSSHGGVNIEDVAAETPEAIIKEPIDIEEGIK		
ALEQQASTPPPPPPLLPGSSAEPPPPPPPPPLPSVGAK		
EGHPTSLSCECR		
FPVIVGHEATGIVESIGEAVTTVKPGDK		
KNVSIEFPVIDR		
ELKNGNLEVGVHIADVSHFIRPGNALDQESAR		
EGQGEGETQEAAAAAAR		
ERADEPQWSLYPSNSQVSEEVK		
ELLGISDECR		
WTAVVVPSGEEQR		
QQHMVQGESETADVSPNNMQV		
GAVALSGDHSALESQIRQLGK		
DLEAEHVEVEDTTLSR		
IIWDLREEVEK		
FKFTVGDHSR		
VVASGPGLQHGK		
LKICIDAMHGVVGPYVK		
LLAAEGSHVTANVVDPGVVNTDLYK		
EEYVRFDSDVGVYR		
IEPHHTAVLGEGDSVQAENKDPK		
ITYEELPAIITIEDAVK		
DVIPMDALGPDGYSTVDQR		
RLQAEPGIEAPSGTEAGALLLCEPVGPVYTAGLR		
LNGQQTALASQYR		
EHDVQNTFEEMEKHLGR		
RFQTIDIEPDIETLLSQGPSCA		
GVESSGQPENNYKTTPPMLDSDGSFFLYSK		
SQVMDEAMALQLR		
MSGYPIPK		
KAVLDEAVVVLQAAFR		
TLLPEDTQKLDNFLGEVR		
VSQMNSLEEELETIHLENEGLK		
SNGPSAALVTASTPSALPTGEK		
MKGTAHYHSLPAQDNLVLKR		
VRDVFDFYNVPIQDR		
PSGEPGCSCAQPAAKVAAPGWAQVR		
DPTVKFPPDLCSR		
QYDQFGNDKSQAAR		
VLGLSIVGK		
RTTRLQQQHSEQPPLQPSPVTTR		
GDEASEEWQNGSSPK		
DHRPQMVWDSQVSEHFFEYKK		
ETFGVNNTVYGIDAMNPSSR		
APSPLYSVEFSEEPFGVIVHRQLDGR		
EKEEETTRELLLPNWQGSGSHGLTIAQR		
MYYSAVDPTKDIFTGLIGPMKICK		
SLENCLLDLR		
VLQQLTEEAALDEASGFNIPAEQASRPWTQPR		
EIFSACAQSVHEYLR		
GFGSYHPSAYSPFHFQPSAASLTANLR		
DAPQGEDMLNAIR		
CLSLQAQITALTK		
PGGDGEGDPNHIER		
GLVEVTIQNLSEEDKGSYTAQLQDGK		
ETLLNHFLYEVAR		
AHRLHQLAYDTYQEFEEAYIPK		
QVFYGEEEQLK		
ESGIDPSQVGVHPSPGAR		
RQCDNPAPQNGGASCPGR		
CKYVSLIYTNYEAGK		
TIHDAFCVFEQNQGLPLR		
SVQELKKYFELEPLAR		
DKEFHSNQELER		
WNETFQKEVLGSRLETTQLLAK		
QGTLTEYCGTLMSLPTK		
WIQHDHVYLDNMTAK		
KTHTVVQPSVGAAAGPVVPPCPGR		
YWMHFCGGSLIHPQWVLTAAHCLGPDVK		
TPLEDYSGECFQK		
QTATLTCTGNSNNVGNQGAAWLQQHQGHPPK		
KQPFEDVTNPLQIMYSVSQGHRPVINEESLPYDTPHR		
LPDTALPTLQNGAAVTDLAWDPFNPHR		
ASQSVSGYLAWYQQRPGQAPR		
KVLLDGVQNLRAEDLVGK		
DPQVGHPAAQMEPEPAEPLAAAVEAANGAEQTR		
KAEESMGIGSEEKPGR		
VVAKLQAGTCFINNYNVSPVELPFGGYKK		
TVVQLEGDNKLVTAFK		
GYQSLSDSPPGAR		
TFEYEAEKNPK		
STSDCGGPKDHPLTCDHPQLSGLFL		
SIKASVDVSPPKVEADMSLPSMQGDLK		
AVDVLSELSFAPMTPDHFPSLFCK		
TIEGSSPADNRYSEYTEEFSK		
NVIEDLVPIEDIPDVHPDLQK		
ILGAFMQIITFR		
EKSSQESGEEAGSQENHPQESK		
LEGILEGLGLR		
GDFAAAAANLQTCLAVLGR		
VEFAPLFVPWER		
CPQALFQPCFLGMESCGIHETTFNSIMK		
DKNNKEPTIEDILNLESSPTASGSSVSPGLYSK		
AGSEVLAAAGAVFLPGDSCR		
RYKGIVDCIVR		
LKECVLHDDLLEAR		
WDYHTTHINQLQLLSTIDESPIFK		
KSCCSCCPVDCAK		
NLQTQQASLQSENTHFENENQKLQQK		
VLEELSMSSGELAFGK		
GPILLELQTYR		
MIVSDVMQQAQYDQPLEK		
KVSVVDYVEPSPQGTRWGLGGTCVNVGCIPK		
RTFEYEAEK		
EKLCYVALDFEQEMATTASSSSLEK		
QPSNLPGTVAVHIISSTSLMAV		
SVHWYQQKPGQAPVLVIYYDSDRPSGIPER		
GYNQLAYDGKDYIALNEDLSSWTAADTAAQITQR		
KPGRLPDTALPTLQNGAAVTDLAWDPFNPHR		
GCELVDLADEVASVYESYQPR		
TSPLGTQLVLGPGNSALLGCPIK		
YPEDLPITLPNLLR		
LIDGEYKDYLASHPFDTGMTLGQGMSR		
TEGDSSATAIFPQTHK		
QLAAGWGPCEVLLSNALSR		
SLALRSELLVDKTK		
ESGHSNWLADPEEPLTGFSWR		
VQSGSESVIQEYVDLRTR		
SLEGSNDAVLLQR		
DELEEGAPSEAMLR		
DNLLETIPNHQPGKPLLGMK		
CIHNTDGIYCDQCK		
APSPLYSVEFSEEPFGVIVHR		
KNEINLESELKSEQVTE		
APSACAPEPGIPGETR		
QSSNDLFQVNSTSDDEIPR		
RTFEYEAEKNPK		
DPSFFSNPQDFNPQHFLDEK		
ITTTTSEEPCR		
DNTELPYHGK		
EVLKESQLPTVMDFR		
NTEDSLLVSWEPSSQVNHYLLSYYPLGK		
DLPGFPLVR		
IGRPVHEFMLQPGDLLYFPR		
MSGCDVGPDGR		
VDLKGPQLDVK		
GAVALSGDHSALESQIR		
VVSPFPLCQPAGEPSR		
INENIAAASSTLFSSPVNLSTSGR		
AEQIASVQNAQR		
KKNEPEDEEEEEEEEDDEEEEDEDEE		
NTVYLQMNSLRAEDTAVYYCAR		
SGASGASAAPAASAAAALAPSATRTR		
EGQGEGETQEATAAAR		
DRDGGMHSDPVSLNVLYGPDLPSIYPSFTYYR		
HQTFAHEVDGRSEQVHGVINLGNSLIER		
FLILPDAEAQLDREGDAGPETSTAVEKK		
YLCGAHSDGQLQEGSPIQAWQLFINEESTIPR		
AEDEENEKETAVSTEDDSHHK		
KLAAQEGQFTEPRPEEPPQEK		
QKLTAEFEEAQTSACLLQEELEK		
NTWDLHPTSSK		
RPALNYPVYGEMTQVR		
QTLEKENTDLAGELR		
IGAAIQEELGYNCQTGGVIAEVLR		
LPDTALPTLQNGAAVTDLAWDPFNPHRLAVAGEDAR		
REVGTSDKEILTSR		
SLGNIIMVCR		
DRAEAYLIEQMYDEAIQDYETAQEHNENDQQIR		
GPHDGPSQPTGPR		
WSETSVEHR		
QFRFDPQFALTNIAVTK		
SALSGHLETLILGLLKTPAQYDASELKASMK		
LEPPWINVLQEDSVTLTCWGAR		
AAESPDQKDTEGGPKEEESPV		
IAKDPSWIIR		
SQEAEQKDVIQER		
SSQSLLHSNGYNYLNWYLQK		
FLFHPGDTVSSTAR		
TEITGATTMTSVGHQSMTPGEK		
EIPENSAVDQEA		
AEAPGSPAVVLPGR		
HRPQVAIICGSGLGGLTDKLTQAQIFDYSEIPNFPR		
CQEVVSWLDANTLAEKDEFEHK		
HVGSSETNLLQHLLEACGR		
VELQDWAGNEAYAEYHFR		
DNWNRPICSAPGPLFDVMER		
GVSMDECVLCAQAFGQR		
IQWVDDTHALGIFPCR		
TLSEDELKEIPAEQMDFR		
VLPKPESASVSAAPTPPVSLPLAPSPVPTLPPK		
QRAQEALLQLSQALSLMETVK		
CVDGHCVCNPGFTGEDCGSRR		
METFAPTELPELLK		
IPPGDLVFDPDQRGDVVLPFQR		
IHPTATHHITNEGVPASLPCVASGVPAPTITWTK		
LINLGGENIR		
LEMDLKDLEAHVDSANK		
TLLNTGLEK		
QALDNMFSNK		
VLYGPLEGCLAPSGR		
KVYGLQSELQYK		
VPGDQTSTIIRELEPGVEYFIR		
SAVDEDRKMYIQAAIVR		
EAVSSSQGPSDPTDR		
CDAEAPEDQCTVTR		
QADIVTFPEINLMNESTELHTQLAK		
AAAGLPLVPR		
DDVVPWHTSMQVADR		
EAPPAKVPEVQKR		
ENYLTVGLTVGQVRPLVPLQPVTQNR		
VPSFETAEGIGAELKAPLK		
VIPIQAHQIVNGAPPAR		
TISEGNPSPR		
LDHKFDLMYSK		
LSCAASGFTFSNYALSWVR		
GEQGEDSSEEKHLEEPGETQNAFLNERK		
LDGAQLQGDLSLADK		
FFDDNLLVSTSR		
