peptide	gene_symbol
VGVVQYSHEGTFEAIQLDDEHIDSLSSFK	COL6A2
LINLGGENIR	COL6A5
ITNNMFCVGFLER	PRSS2
VSVAIEEDLEPENGILELETK	AKAP12
AQLNVGNVLPVGTMPEGTIVCCLEEKPGDRGK	RPL8
DLMTDPSWPQK	COL15A1
TQEACVHQDTQAHHALLR	PCNT
NLPAGTLAAELQETFGR	RBM19
QAQVTLIDATTCNEPQAYDDAITPR	TMPRSS11E
LTQTSGESTHTDKEPVGEGK	MKI67
EDTVEVLAIDNTSVR	MMUT
ASSEGTIPQAQR	UTP14A
HQGHRDEEEDEDVPTER	HRC
CESCAPGYEGNPIQPSGK	HSPG2
VLIFQEENEIPASVFVKEPVSGAVEGK	CAVIN2
VLKEQALQEAMEQLEELELER	SWAP70
FLEENADPSASEIREELEQYTTEIVQNNLLGSQGAHVK	POLR1A
SIEASVDVSPPKVEADVSLPSMQGDLK	AHNAK2
VGALHGILYVLECDLLDDTAK	HTT
NNDVINSSSYR	ACSM5
LGITPEGQSYLDQFR	WASHC4
TLYQLQAQR	UAP1L1
LYKWISQNDLLGHPK	UGT2B11
KVLLDGVQNLR	C3
DGMTLTWYPPEDDGGSQVTGYIVEHK	TTN
HSGIGHGQASSSVR	FLG
EGQNVNMENLYTALQSIDRGEIVNMLEGSGR	ANK1
LNNISIIGPLDMK	TMEM106B
QILLSADHIIIATGGR	TXNRD2
EEEVPAGEAAASQPQAPTSVPGAR	POLE4
QGGPPGPTRPLTSSSAKLPK	ASPSCR1
NEVQKTSNSEDGSMGSFSEK	EMC1
SVLTGTKDTVSTGLTGAVNLAK	PLIN4
GTAAAAAAAAAAAAGEGAR	NIPA1
EIELQQQTIEALK	KANK1
SYSYSYSNGPGPFYDK	PEAR1
YCADACGELDLER	ACOT4
TSLNEQTYTR	SP100
NALENYPNFTSVVDPPEIVLAK	NEB
WEWGTPHNFLYK	PLA2G4C
TGCSLTGASVDSTLAFNTYVHFQGK	AGT
QITLHALSLVGEK	PARP4
YSTTALLEQLEETTR	CEP55
LKAFAKLPPNVLR	ECI2
MGAQELLR	GSN
CPTSITQESSFGSPTGNQLSSDIDEYKK	SPECC1
ASQSVSSNYLAWYQQK	IGKV3-20
GGPDDDGGYAADFDLRPSR	RBMXL2
YFHTAMSRPGR	HLA-B
AVSFGLMAPAPSGVAVGLGVAR	FCGBP
NRYEVPVPLNIPSMPSSTPQGQLYDVLIK	MGAM
ELVDDSINNVR	PCMT1
AYSPELIVHPVLDSPNAVHEVEEWLPR	NAXD
LADKFIHAGVR	CPPED1
RSIEDCVQEEAR	CYP2C9
TSVAIGGIIK	MYO7B
RLVVQQAGQADAGEYSCK	OBSCN
TTYTENGRVK	ENPEP
QDALVCFLHWEVVTHGYCGLGVGDQPGPNDK	PSMF1
TQTVEVPCPPPSPR	KLHDC4
SLDLDGIITEVK	KRT7
AIMLLEGQKVIPR	SDR39U1
ADDKVYPGKQYTYMLLATEEQSPGEGDGNCVTR	CP
ITHSPQAHVNPQEK	EFNA1
AESGPEKPHLNLWLEAPDLLLAEIDLPK	PIH1D1
KVQVAALKASPPLDQDDR	TJP2
TSGLAGEPEGELSKEDHGNTEK	MIA3
TQSGESQERPLTQADLGR	ADPRHL1
GNPVPILVPCHR	MGMT
MAGKPTHVNVSVVMAEVDGTCY	IGHA1,IGHA2
VLFPGCTPPAYLLDGLVR	MAP1S
KVGTASENVYVNTAHLK	CTSC
VLPFNAETCNATVSGPDLEFSMHDGTIR	WDR47
INAFNQDITALMQGEETVGEEDIR	MX1
EGHPTSLSCECR	HMCN2
AVQDKLNQMVFIWENIHTLVEER	DST
EAAEGLGSHER	CAPN2
LTENPEKQTLPGSK	NAPRT
QFLMEIMEINEK	HSCB
LEDEEEMNSELTAKK	MYH6
AVDSKYTAIPIVGQVFQSQCK	MTTP
FELTMPCSSLEINIGPFL	FARSB
SQQQQQQQQQQQQQQQQQQPMPR	NCOR2
GATYSSEIPK	LMO7
KEEENASVTDSAELQAYPALVVEK	PRKDC
GFPCSLEHAFSSSPDPVSYIPR	UGT1A6
DAVASAWLTVLGLPDPPEDAEVVAR	OBSCN
AQSLQKAAHQELNTLK	FYCO1
ADSGVHLCVIDDSNEHMLTVWDWQK	EML4
EGQNVNMENLYTALQSIDR	ANK1
AAAPAPVSEAVSR	CAST
TPQEWAPHTAR	TOR1AIP1
FENEEAQAVYWHSSAHIMGEAMER	TARS1
MRESALEPGPVPEAPAGGPVHAVTVVTLLEK	CAVIN3
ADPPKTHVTHHPVSDHEATLR	HLA-B
IGRPVHEFMLQPGDLLYFPR	RIOX2
MSGDEAVNQGEASQTLK	CFAP46
AEADVSLPSMQGDLR	AHNAK2
QALLQAQLEEQLQDK	CROCC
EPLGVNAQGQQVFLK	ACO1
KDPTVSALLTSEK	GSTO1
GGEKEEGNDGQDLRR	AKAP13
SSSQYIESFWQSSQSQNFTAHDKQR	TOR1AIP1
ELLGISDECR	FNIP1
EQQNDTSSELQNR	ZFYVE16
GLSEEDIFTPLQTGSCVLEH	OBP2A
LLIYDASVR	IGKV3-11
LHSLTQAKEESEK	RRBP1
NFGAENPDPFVPVLSTAVK	HEATR1
AEEGGETEAQKEGSEDAGNLPEAQEK	SH3BGR
DNAKNSLYLQINSLR	IGHV3-48
GSPDTEFK	SIRPA
ASGVPDRFSDSGSGTDFTLK	IGKV2-40,IGKV2D-40
KSVEEYANCHLAR	TF
DLAVDSASPVYQAVIR	LDB3
IVEAEAQEDLEGLRGSQNEGAGR	APOBR
KNWMVGGEGGASGR	UQCC3
ALGALDSCAPGLCPDWDSWDASKPVTNAR	FLNA
STSLMEPEPAEPLAAAVEVANGAEQTRVNK	SMTN
EMLNSVMQELENYSEGGPLYK	RGPD3
HLMPMNPNDDSLFK	PLS1
SSFYSLTSSNVSK	NUP133
HCYPLIGSMTYSVK	NXPE4
LDHKFDLMYSK	TUBAL3
GMAGPAIGTEGILTR	NRAP
ALGYVTGDMKK	SLC14A1
ENEQGEVNMESHR	CD99
NGATQGWDAPQEVPYAYQGNVWVGYDNVK	CHIA
AQFDKVEICNLTPDALK	CAPN9
AINSCHTSFLATPEDKEQAQQMNQKDFLSLIVSILR	PRL
LLTQDEGPALVPGSR	IBA57
NPILWNVADLVIKFPEEEAPSTVLSQNLFTPK	RPN2
LEGLDTGWDALGR	SPTB
SRNWEDVEESSK	STYXL2
SSEEELHR	SERPINA5
LQFKDHIVLTVLPDQDQSDETQEK	RIOX2
AGALNSNDAFVLKTPSAAYLWVGTGASEAEKMGAQELLR	GSN
TPSAAYLWVGTGASEAEKMGAQELLR	GSN
NLHMAEAPANLEQPTSSFHVGTCFANAQR	LAMA2
GEEVEGAGWMPGREPTTHAEAQGNEGDGEEGLQR	AHNAK2
TVLEINTPKVEQVPIVDIMFNDFGEASQK	COL5A1
LSVADQEKVDKFMIELDGTENK	ENO3
ASLIEEDEPAEKENSSKK	CEBPZ
LQNAFWEHGANR	PPP1R13L
IYDPNKNRYEVPVPLNIPSMPSSTPQGQLYDVLIK	MGAM
ELIHISDWLPTLMK	ARSB
SSHGSGKPQEVPQSVTATAASK	NBEA
GYEAMYTLLGNANGAICAFPFKFENK	MRC1
ASGSFAPISQAPPSFSPPPPLVPPAPEDLR	SORBS1
NWGSSFSQDSDSEGHSEDSER	FLG
SDINVTVLIGCK	RINT1
YFHTAMSR	HLA-B
DPTVKFPPDLCSR	DYNC1H1
ALSCQTLAAGYYHTECVSGCVCPNGLMDDGRGGCVVEK	MUC2
AAGQPGSELLVVTIGLDGATR	TEP1
VLIYWASTR	IGKV4-1
ILPNDECEK	KLK1
TYGLMDSHTVLQISSAK	HSPG2
CPDYTCPITFSSPADITILLDGSASVGSHNFDTTKHFAK	COL6A1
KPIEEKPSQPYSAR	FAT1
QQNVDHVVATLQGEGLSVTGTVCHVGK	DHRS4L2
DPAGMPHPQTGKDLYEPSHGAK	PAPSS1
MKLTENPEK	NAPRT
AAGSDVNIDMAFILDSAETTTLFQFNEMKK	COL6A3
VLIYDRFGQDIISPLLSVR	SCFD1
KEEEEEDDDDDDSKEPK	CHD4
SLEHSEGPVGRDPAGPPDGGPDTEPRAAQGK	SLC38A10
GPEVDIRGPK	AHNAK
HTGSGILSMVNAGPNTNGSQFFICTAK	PPIAL4E,PPIAL4F,PPIAL4H,PPIAL4C
HQSPIDILDQHAR	PTPRG
VFHFLVFQLNTTDLDSNEGVK	MRPL37
KGLASPTAITPVASAICGK	SVIL
NTEDSLLVSWEPSSQVNHYLLSYYPLGK	TNN
AMVGHLNELLVK	TRAP1
YANLSSPTSTVSESQLTKPGVIRPVPVK	MLIP
LSPGSGGPEAR	PCNT
REVGTSDKEILTSR	PNPT1
QEDKDLEAAMLSK	MICAL3
HPSSPSALRSPADPTDLGGQTSPR	SORBS3
IKFPTVVAGFDLVGHEDTGHSLR	ADA2
MQLKPMEINPEMLNKVLYR	UCHL1
EEISVEDEAVDK	GANC
VPNLEEGK	TTN
QQSAPEVAVNGHRDLEPESEPQLESETAGK	EPS8L1
WESPYDSPDQDLLYAIAVK	SORL1
CQCPSPGLHLAPDGR	NPNT
IEDYNRMENVAK	VCAN
KSEDGTPAEDGTPAATGGSQPPSLGR	MYBBP1A
ESGPALVKPTQTLTLTCTFSR	IGHV2-70
NVWIPMKPYYTK	ATP5MJ
DREAAEGLGSHER	CAPN2
IAPESIPSLEALNR	SFTPC
AVLMGGSALSPATVISHER	TG
AFDQGADAIYDHVNEGK	UQCR10
LSGLIYEETR	H4C6
SMGSKEDLIWELLNQAQEHFGK	TF
AALGVQSINWQK	TGM3
SQQSVSAEDEEEEDAGFFK	FNDC1
EAYFSVGLQGIVEKDIETVR	PITRM1
AEVTAPDVEVSLPSVEVDIEAPGAK	AHNAK2
MSGDNPSQLTK	CLIP1
ERPQVSENLQKTELSDGK	NCOA7
QVEEEDGSR	COPG1
EIAAVISPELER	RNF213
NPLLDLAAYDQEGR	NUP210
GELFWDDGETKDTVANK	MGAM
QTRPDSLQER	MYPN
IMQDQSEGNSLQNQALQTLQER	GOLGA5
EGVYELAVFQMKPGGPGLWGDAFER	NIPSNAP3B
HRETLDPSAPR	CYP2B6
NGYLHVFYDFGFSSGPVHLEDTLK	LAMA4
LIVQPNTHLEGSDVQLLEYEASAAGLIR	DPP3
VVNVEIVEEPVSYVSGEKLEEFSVPFK	SYNM
LHEEEIQELQAQIREQHVQIDVDVSKPDLTAALR	VIM
VMFVGGPNSR	HAAO
NEETPAAPTPAGATGGSSAWLDSSFENR	MAVS
SETVPAASASAGLAAMEK	H1-6
ENLQLETR	PPL
LTPVSAQFQDIEGK	CYP20A1
DSAASHQTEPEAYER	PRAG1
ISLLDDTVYECVVEK	EPB41
ISNSAAYSGSVAPANSALGQTQPSDQDTLVQRAEHIPAGK	PDLIM5
HWLEGELLYLELTAR	RBP5
AINLNRPILYGEQEESTVHVGR	LRRC34
ENTDLAGELRVLGQAK	MYH11
DSSVFILGNTDRPDASAVYLR	PLCG2
LQSTGNKAEDTKGTECVK	ZFR
DLPGFPLVR	ADAMTSL3
SIQTPQSHGTLTAELWDDK	PRRC2C
VELGVIGNSVHMEGLPGSSTSIR	SYNM
QGSTTDNACHLFAELDPNQPASAIVSFVSK	TNS1
ISNSAAYSGSVAPANSALGQTQPSDQDTLVQR	PDLIM5
MAQWGNKPIC	GSTM3
DLCEEQFMSGDDYPFCVDCYNHLYANK	FHL5
ATVEQEMELR	ATAD3A
SDFVSESEEAACR	TEP1
DKQVNSQLYSK	ATP9B
NFDREIGHNNPSAMAVESFTATAPFVQIGR	TMEM43
TQSTFEGFPQSPLQIPVSR	MAGEC1
AELLQDICHR	VMAC
LIVPSQFKPTSPNR	SLC4A4
FPQSVYQISVSEAAVPGEEVGR	CDH11
GPEGGEGAECGGASEGGEGGQNGGDAAPARPPAGEPR	ZNF579
PQGSSWQGALLSTAQGAISR	EHBP1L1
VSEGKNVLLLVHNLPQNLAGYIWYK	PSG4
GPTGVQGPR	COL28A1
GVGAGGPEEGAPPATSAQR	TBC1D12
VCSILASLHALADQYEEAEYYFQK	IFIT2
HSQSGQGQSAGPSTSR	FLG
TSDYEQSETSKPALAQPASAK	NEB
RDTVNPLYDETLR	SYTL4
GSTYALQTGPLLGQPDSLELQR	RSPH3
APQQGRAPQAQPTPGPGPAGVK	BSN
VQLPTESLQELLDLHRDSER	GBP1
KLDSVFEEPLSK	MMP9
MRPWEDPPSDLLLLK	F5
GQTGAILQNTVESLSK	BCL2L15
VQSNCPLSPTK	VWA5A
DGDIHQGFQSLLSEVNR	SERPINB8
ELTAIVQNQQSLIHSQR	IQSEC3
AGPLGLGPGDGCFTLPGHR	ARVCF
QPLAPLAQPPR	LMTK3
MPLVEQSPEDSGGQDYVETVIPSNR	EIF2AK4
MPTQEPTHREPTR	KANK2
GFPEISFQPSSAVVVTWESMAPYQGPSRDPDQK	NID1
LDSARLEGDLSLADK	AHNAK2
LHFFMPGFAPLTSQGSQQYR	TUBB8B
VEGFLEEDKR	NLRP2
AQPHYSNPLVAVK	ATP4B
SMPESLDSPTSGRPGVTSLTTAAAFKPVGSTGVIK	PDLIM5
SRPPGCYTCADCGLNLK	PDLIM2
TTQNIATGTKNTFGSGVTGAANVAK	PLIN4
LLRGYNQFAYDGKDYIALNEDLSSWTAADTAAQITQR	HLA-B
NLYEKLQHETR	PCNT
VAPDEHPILLTEAPPNPK	ACTBL2
RLPDGQLQVTWEDR	TXNRD2
MEEKHNQPSEFTIESLENTAVDLFGAGTETTSTTLR	CYP2C9
GLNDYAVVMEKEEVEELFQR	CAPSL
MFGCDLGPDGR	HLA-C
DLCEEQFMSRDDYPFCMDCYNHLYANK	FHL5
TSSVQLHVAGLQPVLLQDR	TMCO4
AENNLLALGLK	YY1AP1
IDVDKDGFVTEGELK	CALU
QTVQVDEHARPQTTLEQLQK	ACAA2
GAPAQRPPSESPGAPPPGPADAGGAMAAK	C11orf96
TESLTPHCALENRPLTR	SBSPON
LFVLSSSSGDFAATEFVYPAR	SVIL
TSFRVPNLEEGKSYFFR	TTN
ATEVPVSWESFNNGDCFILDLGNNIHQWCGSDSNRYER	GSN
SPYEPPPTGLFDDDDGDDDDDFFSAPHSKPSK	WASHC2A
NAAHEDGGIYSLTVENLAGSK	TTN
MSGCDVGPDGR	HLA-B
RFQTIDIEPDIETLLSQGPSCA	GPX1
VHIEFTEGEDKITLEGPTEDVSVAQEQIEGMVK	HDLBP
DAVPAEAALQAR	JSRP1
VEDPPLDLWLVPHSCGQVCER	NFXL1
AGSEVLAAAGAVFLPGDSCR	TYSND1
ALREWEEAER	MAP7
VHLAPPPTWEGYDPSWN	MGAT1
GTAAAAAAAAAAAAAAAAK	RPL14
VVYALLNLYEHHHSAR	LSS
RSPESLPAGPGAAALEGGTLR	CYS1
WLDLTVVEAK	THEMIS2
SSSYSGEYGSGGGKR	ZG16
YAGEFEHVFEASTAGITLQAPQLDINTVAAGGGSR	OPLAH
SVEDSMDVSAPK	AHNAK2
ISVPDLDLNLKGPK	AHNAK
NPDSSTMGPWCYTTDPTVR	F2
GLCVLCPNSNNSLLAFPGTHTGR	WDR45B
NTLSNIAMRPGLEGYALPR	MCM5
AALPLPAK	NOLC1
DLIATLAK	SENP8
YWCNDGKNPGAVNACHLSCSALLQDNIADAVACAK	LYZ
HASSGSFLSSANEHLKEDLNLR	GLRX3
DIASTPHELYRNDYATMLPDSTEINQDTINRIIK	COL6A2
GLVVHDVSPEDAGLYTCHMGSEETR	OBSCN
DLSVKYPEDLPITLPNLLR	TXNDC11
GHAEQGDPGAPEQTGPQR	AFDN
TAGFVKPFTEAQLLCTQAGGQLATPR	SFTPD
NEPVVFPEGPEISEELKDLILK	CAMKK1
AGPDAVTHDSEWEMLSPQPVQK	PRUNE2
EAESCDCLQGFQLTHSLVGGTGSGMGTLLLSK	TUBB8
VNVYHHLVETLKFAR	GGT5
WNYIASSECLPFWPENLSGK	VPS13C
QAQVLGTER	APOBR
VGNTVPFGAGAAVGGGGGSSSSSENVK	IRS1
DMAYVFSGAYVPLSCR	VPS33B
IGQPTLLLYVDAGPQTMTQR	AK1
MSNWQGAIDSCLEALEIDPSNTK	PPID
QTATLTCTGNSNNVGNQGAAWLQQHQGHPPK	IGLV10-54
TLLLDVPPGVEK	PTPRC
EFVEEFIWPAIQSSAPYEDR	ASS1
TSRNWGSSFSQDSDSEGHSEDSER	FLG
IHTGKKPYQCNECGK	ZFP62
ASQSIRSYLNWYQQK	IGKV1-39
SEDVQSIEVQVK	PARP14
KILGEVINALK	PDLIM5
MSLSSVEVDVQAPR	AHNAK2
TVTISCTR	IGLV6-57
IAGMDPVVHSALREER	PANK4
CPEALFQPCFLGMESCGIQETTFNSIMK	POTEE
FNELMVMFR	COQ7
DHRPQMVWDSQVSEHFFEYKK	CHID1
DLYHYITSYVVDSQR	PSG8
AVTELGRPDAEYWNSQKDILEDER	HLA-DRB5
LEGPDVSLKVPGVDLPSVNLSMPK	AHNAK
RGLIEVKTDEFPR	ACAT2
KTGEMFVNDRLDR	PCDHGC3
SNGPSAALVTASTPSALPTGEK	HIVEP1
GTQVVGSDMTVTVQFTNPLK	F13A1
TVMQRGSLGVDSVSASQVTK	EFHB
VDIDAPDVDVHGTDWHLK	AHNAK
VIPIQAHQIVNGAPPAR	GFAP
LQPHSNGKVDLNLPNIGIK	MVK
TPDGFDSVPLKTSSGGPDMDL	ELAPOR1
HLELEWSVGPIPVGNTWGK	MAN2B1
LPLALHDTPPIPGQPEEIR	P2RX7
GVGGAVPGAVLEPVAPAPSVR	PKP3
DKTPAPLQHLNTLLDGTYK	BBS9
LLLTNDPLEAAHGGNVLITDTWISMGREEEKK	OTC
ALDRPYTSK	NANS
CSCPPAAACHHVTGACR	MEGF6
SDEEARQSGGSSQAGAVTVSDVQELMR	PSMD9
SIAASVDVSAPK	AHNAK2
DKLDHCLQEASPCYK	GHDC
LTLQALTEK	CKAP4
EVTVNVLSPR	ICAM1
VVYSTLAGEQYHEVLVPK	TNR
WQEGNIFSCSVMHEALHNR	IGHG3
ADEPQWSLYPSNSQVSEEVK	CHGB
RASAILPGVPGSETLSNEVFQESEEEKQPEVPSSLAK	NIBAN1
DKPELEVVLTEDALKSLENQTYFR	AKAP9
HALSYNQGQLK	SMC6
LGAAVAPEGSQK	DMAC2
DFELTEEQYVK	PIBF1
QEVPMCTGPEPR	FAM120B
RDYEAIGIQVLLAQCNPSVR	SLC26A2
IFLCCPGWFQTPGHK	CD55
LLESVQQHSLDAVLAR	IGHMBP2
ANGGTTDYAAPVK	
RGQSEADSDKNATILELR	DSP
EIPELEEEKTIPTKEPEQIK	PRUNE2
QLGCGWAVQALPGLHFMPGR	CD6
EADECIVSEDK	OLFML1
KSFPGLNHFK	FMO3
GDTLMASTLGQHK	GALNS
YIELFLNSTPGGGSGMGGSGMGAYGR	HNRNPH3
LKGDIDSNAAIDLSNKASLAFLQK	PLA2G7
TESSGIETESTVHHLPLSTEK	EPB41L3
WISAMEDQLQSDDPGK	SPTB
SDFSWAAGQGYCQGGFSAKFTK	ITGA5
KAENSSNEEEASSEGNMR	SPARCL1
DVGEWQHEEFYR	TRAP1
VKGDVDVSLPKVEGDVK	AHNAK
NTMGYLQWR	DNAJC11
ALASYVAACQAAGVVIKDWR	FCGBP
HVVCSLSGGVDSAVAALLLR	TRMU
VLIVYAHQEPR	NQO2
TVLTGTKDTVCSGVTSAMNVAK	PLIN4
TTESPPSPGTTTLGHTR	MUC5B
VVAKLQAGTCFINNYNVSPVELPFGGYKK	ALDH9A1
HRPQVAIICGSGLGGLTDKLTQAQIFDYSEIPNFPR	PNP
NSLNVLDDNQFVDISK	CTNNA3
LSGVGNVTPAR	CTRL
EQLMQLLGLSK	TRMT5
GPCPFHCR	HRG
GKPVLEFVETPSYQASK	NEBL
LEMDLKDLEAHVDSANK	MYH9
VSVAIEEDLEPENGILELETKSSKLVQNIIQTAVDQFVR	AKAP12
QTWTDEGSVSEQMLR	ERAP1
ASHQWMNTQGGHLALGVYQHVTGEMMGGHAIR	CTSB
SKDVINFAAEK	MOCS2
YFHPYIAYCSNEVYQQR	ARHGEF16
LPLDINPMVHPHGHIFK	TTLL12
NAAGSTSVAFLVEIHTVPTIR	HMCN2
TYLDLLCSMCDLSNASVKTTAKDIQQTEQTIEQR	SYNE1
SSSFSHRSELLHGDLASLGAAALQPQPAAPPQTASPR	CTBP2
IDWDDEKYYSTSLK	IGHV2-70
SVVIEEVGGGDPGEEAAK	CENPVL3
TLSTDSIQYHLQMQDKNGR	FNDC3A
GTNCVTSYLADCETQLSQATR	FAAH
VTITCRVSQGISSYLNWYQQKPGK	IGKV1D-37
GSPDVTCVFLNVER	GTPBP6
AGHFDKEIVPVLVSTRR	ACAT2
AAEGPGSWSHTAR	TMED8
IAPPEAPVTGYMFGKGIYFSDMVSK	PARP1
VEQGPPGGIGTAAIRPK	MLIP
LHVSQIPTMAVK	PCF11
LQGHTPGEDHGEVVSQDR	ZSCAN2
KQWDLDVGSGCLVSSSLSKPEVFGNK	EIF2AK3
MLLQGSGCLAGIYLEDTK	PLEC
EEERAPESSANQTVNK	GPATCH1
FLGQILTAFPALR	GEMIN4
CQEEYYGYRPK	CACNA1S
GDQPNTHQLLAMASR	NAALADL2
DRPLEADGQEVPLDSSGSQAR	CAMKK2
MLEANDGSGMLDEDEEDLQR	ATXN3
YLLAFLADDLGR	CARD19
IETAFMDIEEQKANIYEMGK	PPP2R3A
TCSFDFTGAVEDISK	GOT2
NTLYHQMNSLRAEDTAVYYCAR	
YPVDTLPTSK	LCLAT1
EQGTATMEVQLSHADVEGSWTR	OBSCN
VPVTQATR	SEC23A
FSASAVETRPSIWGECPPK	MYLK
TSRDGAEQQGPEATVEEAEAEAAAFGSEK	PALM2AKAP2
LPEGHLPEVAGLK	AHNAK2
RQELEEAEQVGAGLSEMEQQIR	LAMC3
HDPIPAADTFEDLSDVEGGGSEPTQR	ASMTL
GTAAAAAAAAAAAAAAK	RPL14
QAADFALK	QPRT
LATGSDDNCAAFFEGPPFKFKFTVGDHSR	WDR1
SIEAMVDVSAPK	AHNAK2
AQQEQLLLQQQLQQQQQQPPSQLCTAPASSHER	PALM2AKAP2
DSVEGDALVNGAR	MIA3
AEPEPEPEPEPEPENDYEDVEEMDRHK	HCLS1
AKLDGAQLQGDLSLADKAVTAK	AHNAK2
VPSSDEEVAEEPQSR	TNKS1BP1
HLEEPGETQNAFLHER	CHGB
ILKPAEGNPTDEAGFSEDRDFGYSVGLNPPEEEAVTSK	ANKLE2
AEEEQAGSAPGAGGTATK	ARHGAP45
PGSSPTTVIYEDNQRPSGVPDR	IGLV6-57
MCINTEWGGFGDNGCIDDIR	HKDC1
ELLVPQHTVQLVGGLFPLSSPSDTK	ACIN1
LRDEQLNSPYSCQAEGPCLTR	TARS3
VLQEGSVEAR	CCDC124
STSLMEPEPAEPLAAAVEAANGAEQTR	SMTN
ALMDEIEHDITK	CNPY1
AEIGVIEGDK	AVIL
AEGEEDEVK	SART3
NSGEEEIDSLQSMVQELR	ARHGAP25
PVLIGNEPSLGVSQPR	BCAT2
LLSTCGLVQSIELQEKPDLAESPK	RRP7A
EKQATSDVQESTQESATVEK	SYNE2
RDLHDQFQHQLR	VPS11
TKIEGLDIHFIHVKPPQLPAGR	EPHX1
QDLSILVAK	NCAN
AEDEENEKETAVSTEDDSHHK	SPARCL1
GKNLSMIVLLPNEIDGLQK	SERPINB3
VATGALGGPEAGVQCSDAYR	GLTPD2
EEQPPVPSSPTEEEEEEEEEEEAEEEEEEEDSEVQGEQPK	PRKCSH
AKEEIGAVSSK	TRDN
TFEYEAEKNPK	DENND2B
AEVLGHKTPELAPR	SEPTIN9
KNPDSHYGELIEK	CMPK1
SSPCHSQLLEAQSPEASQASPCPAVTPSAPSAALPDEGSR	TNKS1BP1
MEQEDFVMEGHGK	TNRC6B
GDAADLVDDGEDESAEHDEYIDGDEK	CWC27
PGQSPQLLIYEVSSR	IGKV2D-29
RDAEEWFHAK	KRT13
TGDEGKAGNPETVPTTPGPAADPATPETPAPAAR	FAM110C
MAPCEFGVLNNLANVLSQHLNQK	HLA-DMB
LTGHGAEDSLADQAANK	SAA2
QYTDSTFHVPVERK	CP
LLSLGAGEFR	F5
LQFIDDAFSLSK	LVRN
IQWVDDTHALGIFPCR	R3HCC1
ENAEQGEVNMESHR	CD99
ADEPQWSLYPSNSQVSEEVKTR	CHGB
VPSFETAEGIGAELKAPLKQEPLQVR	SLC30A9
GVGGAPPTVILLR	LRP1
ERAELAATAVGSSTTSINVPAAASK	TUBGCP2
DGPHGSVLEEGLDDYLTHLIEER	CEP120
RLTAIIEEAEEAPGARPQLQDTWR	EPPK1
HRPSAGGPDSAGHK	PLCB3
ALNVPPSLDCR	PCM1
GAVNVVVAETDYQSFAVLYLER	C8G
EADLTEEIEENLR	L1TD1
NLFLKPGEEHEVIVSFTPK	CEP192
TTSAPTTSTTSVPTTSTISGPK	MUC5AC
LKTEPEEVFIEDSAQSDLKEVMVLNATESFVYEPK	IFI16
DLCLLECSQHEACLITTLQTQPGAVR	TG
NQTAEPLAPEPPAVPSEVELQHLR	GOLGA8N
KLADKFIHAGVR	CPPED1
LDSSPVLSPGNK	MINK1
YRLPPGVDPAAVTSALTPEGVLSIQAAPASAQAPPPAAAK	HSPB6
DAYDNVTLDVELAHR	PRODH
YGMHTLEINACDFEDTAQYR	MYOM1
LEQNLSGEEHVQELLK	GOLGA1
TPSETPGPSPAGPTR	OGFR
EAEASLDK	ATP10B
YIGAIAMTEPGAGSDLQGIK	ACADL
GCPVTSASVTAPSTPSGR	MUC5AC
EATSVPHIYAIGDVVEGRPELTPTAIMAGR	TXNRD2
FISGHTSELGNFR	MOGS
NLVGNAGALHYSDEVEIIQGLTR	
EGQGEGETQEAAAAAAAAR	EPPK1
NQVVLTMTNMDPVDTATYFCAR	IGHV2-70
NLLDLLSPQPAPCPLNYVSQK	GGA2
NSLYLQMNSLRDEDTAVYYCAR	IGHV3-48
QCDNPAPQNGGASCPGR	C8A
ANYHGGEIR	UQCRC2
AEGAQNQDKKAEGAQNQGR	RRBP1
YELARGMLEPVQRPDVVLVGAGYR	HSPG2
VVEHPEFLR	GSN
DNSQNTVFLQMNSLR	IGHV3-23
SGSFLYQMSTHEQSESAHGR	FLG
EVHDSYALLLAESWR	SYNM
QVEEEDGSRDSPLFDFIESCLR	COPG1
EVPEAPPAACPEVSQAR	NACAD
DSMPDESSQTSLQK	XIAP
SMDSYLNQSYGMNNHSGGGGGSR	ZNF326
FLEVQYLTGGLIEPDMPGRVPLDEALQR	PLEC
AIHLNLEEYR	CNDP1
LEQQVDDLEGSLEQQK	MYH6
SASALSVSGGEEK	NEB
LAQASHTCGSPPEDFCPHVGAAGAGAQCQR	LAMC3
STDTSCVNPPTVQNAYIVSR	CFHR1
ISELTSELTDERNTGESASQLLDVETAER	MYO18A
QSHACGYSNSSGCGRPQNASSSCQSHR	FLG2
DLYHYITSYVVDGQR	PSG8
DLVLLSEIEVAQANDIISYTEISSAEK	MAP4
ELDAEGLEAVR	CFAP410
GFYPSDIAVEWESNGQPENNYKTTPPMLDSDGSFFLYSK	IGHG2
ENQVVKPCNELQDLSESECLR	FMR1NB
GWRPSSWEDSLEAGLPLQVR	CHGA
TQCTEFFLAPVKTEVPLAENQSGPDCAASLKEETGPSYQR	SYNPO2
IPSSMDSNYQQSSAGQPINAK	MYOT
HIYNREEYVRFDSDVGVYR	HLA-DQB1
PYCNHPCYVAMFGPK	CRIP1
ELVLTQTGQCGNQIGAK	TUBB8B
QSGGSSQAGAVTVSDVQELMR	PSMD9
EAPETDTSPSLWNVEFAK	MRPS31
GTQDSSAVPSAAHQEAPVTSGPAR	SPEG
EAPQGELVPEAR	CCDC88B
DADAGDEDEESQEPR	OGFR
CVGEAATRPGR	P3H3
GSWGTVCDESWDTNDANVVCR	DMBT1
DLTAEGIQWPR	GDPGP1
TPGAVEHELVLHQLR	MYH1
IQFEMPLCDEESSSK	SYPL2
VNSMQTVFVGYGPTFK	ENPP2
GYNQLAYDGK	HLA-B
GPTVGGGLPGTGVQGLEGNLQMPGIK	AHNAK
LLVNLADR	KANK4
ASQSVSSSYLAWYQQTPGQAPR	
RLVVQQAGQADAGEYSCEAGSQR	OBSCN
VLNSQSESSALTNQQPQK	TNRC6A
MVQQPTVQHR	MATN2
RTFEYEAEKNPK	DENND2B
DLQAALTPGALTAAAAGTGTPGPR	RRAD
VEQMPQASPGLALR	MICALL1
ALEWLAVIDWDDDK	
EANHSEGQEGSEETDMR	NEK1
RSGEAGISNTSR	PHIP
ISQTYQQQYGRR	ANXA4
KALDSNSLENDDLSAPGREPGDFNPESR	LRRFIP1
CPEDVELCHR	NARS2
DNAQNSLYLQMNSLR	IGHV3-33
KPGRLPDTALPTLQNGAAVTDLAWDPFNPHR	CORO7
PMTLGYWNIRGLHSRLLEYTDSSYEEK	GSTM1
ESGMATAFIHALER	DENND4C
EQPGSPEWIQLDK	AIP
MKLTENPEKQTLPGSK	NAPRT
SILDQSISAFMR	SULT1C2
KAEPELDLR	CAST
ERQEDKDLEAAMLSK	MICAL3
TLHQGMAEVYNFDFITMK	PLBD1
ATDTLDSTGK	TRUB1
HTLSFVDVGTGK	SDHA
ANSSATETIK	DSP
AVSYPAAVR	TNXB
KTKAAAAAAAAAPAAAATAATTAATTAATAAQ	SRP14
MLKEEQEVAMLGAPHNPAPPTSTVIHIR	IFITM2
ENLLLSDSPSCRENDSIQSR	ROCK2
AVATSPSLEAPAALHVFPEVTLGSSLEEAPSPVR	GPRIN2
TGQEMIEGGHCASDNVTTR	SPTA1
SLQEEQSRPTTAVSSPGGPAR	SLC4A1AP
GTTIMALLTSVLHDDR	CYP2C8
KVTPVSSIPVETHR	ATP13A1
DGQYFEPVVPLPDLVEVSSGQENEQVVFSHR	RGPD3
APQAQPTPGPGPAGVK	BSN
QAFITAQNHGYALDNALPAGWK	CPS1
RGVEIEEGVVK	SEPTIN1
DTVCSGVTSAMNVAK	PLIN4
TKSQLMMPVSRPMGPVPNPQPIDPASLEEFK	PLVAP
CQAGFMSSRDDPSAPCVSCPCPLSVPSNNFAEGCVLR	LAMA5
EFLEPDSWETLDEQQFFTEEELK	NUCB2
GYEAMYTLLGNANGAICAFPFK	MRC1
ETVIVEEQTEK	NEFH
GRVSIAELAQASNSLITWGR	DDRGK1
CLFASGSPFEPVK	ME2
SFTFVQAGQDLEENMDEDVSEK	NUDCD1
CPPQCPGQCPATPPTCAPGVR	CCN3
FNLSQESSYIATQYSLRPR	LBR
TSGSKMALSTGDVVEVVEK	NCF1
TFQALEIDLQAQYSTK	KRT23
GGGPAEDSAGPPAALPQQTATPETSVK	MYLK2
DTLMISRTPEVTCVVVDVSHEDPEVQFNWYVDGMEVHNAK	IGHG2
LVEECDGRR	ABHD16A
KTLINESLNFK	LRRK2
LDSAQLEGDLSLANK	AHNAK2
DLEEATLQHEAMVATLR	MYH3
VNGTWLQAGVVSWDEGCAQPNRPGIYTR	TPSAB1
EEYVQEDAGILFVGSTNR	TGM3
FLSTLTIDGITR	KDR
LQLERENLQLETR	PPL
LPLPCPECGHR	REPIN1
DAAYPPGPPSNLHVTDTTKK	TTN
LAPRPQSEEDLAALFEASMK	ADHFE1
GALNGQGALNSQEEEEVIVTEVGQRDSEDVSERDSDK	AKAP12
HLGGIPWTYAEDAVPTLTPCHFTGSEIR	UQCRC1
AKLDSAQLEGDLSLANK	AHNAK2
AQVLALYR	LYRM4
ELELLHASLEHQR	KANK3
IPQDTTQTNVTSAEGWWDQESNCQDGYRK	HERC1
LAAAAAQSVYAFSAR	GPX1
EQCTAGAVCCLQPATGR	TNC
GCEENLDEAREQK	ADD1
AVENINSTLGPALLQK	ENO3
ENVAFEQEKEGQSNEKNDFTK	LACTB
PQATQALESQEWTHQQR	CROCC2
NANSQEDAEELKATTR	JCAD
QDSDALPSPELLPQDQDKPFLR	ITPKB
LIDSISNSHPLLPPELRPLGSQVQK	HIVEP1
LGELTMTDATPDSLSLSWMVPEGQFDHFLVQYR	TNXB
DPADATEAHESSSRGEAGAPGEEDIQGPTK	CHGB
NEPVVFPEGPEISEELK	CAMKK1
TYLGKDAGFHSEIFKR	MYOM3
ILGEVINALK	PDLIM5
PSSWEDSLEAGLPLQVR	CHGA
LYVELHRGQELGGGQDPVQLLSGFPR	UBXN1
IKNVDCILLAR	MTAP
EWQELDDTEKVQR	PSMD2
LHVSLMENYPGTLEALGEPIR	OBSCN
SPSSSSVGGRRDELEEGAPSEAMLR	PCSK1
RQCDNPAPQNGGASCPGRK	C8A
NHFLVVGVPASPYSVK	POMGNT1
GETGPAGPTGPVGPVGAR	COL1A1
EDEETLAHR	CWF19L1
TLEKHADKEDLVILFTDSYDVLFASGPR	PLOD1
NLTVSQNQSEEFYHGPNR	SLC16A4
SVEDSVDVSAPK	AHNAK2
VSPGLPSPNLENGAPALGPVQPR	LIMD1
ECVLHDDLLEAR	ARHGAP45
GEADDLKSEGSYFSLTSTEQSVK	NID2
IKQLLQENEVQFLDKGDENTVVDLGSK	FGL1
VVYPSKADLATAPPHVTIVR	LRRC47
TSAFPIVESVVHEGDLHDPSR	AHNAK2
APSACAPEPGIPGETR	TPO
MLSFGVSAPGK	AHNAK2
CGKTLTSGGHAEHEGKPYCNHPCYVAMFGPK	CRIP1
TASEDVKPGSK	SVEP1
SLQSPQEQIILAPSLAK	SLC12A8
VLAFLSLAEVGQVAGPGPQRELK	CAND2
SGGSAGGLAEGAGVLAPPPPPPQIK	ERF
EATSDPSWTPEEEPLNLEGLVAHR	TNS1
AEQQQQQQQQQQQQHQHQQQQQQQQQQQQQQQHLSR	ATXN1
LPDTALPTLQNGAAVTDLAWDPFNPHRLAVAGEDAR	CORO7
QYTDSTFHVPVER	CP
FFDMELENLER	STK10
IQENMHYGCASGYK	F13B
TEASTELAGTVAHELQGVHQGEFGSEKK	PCNT
RENMDFSISISNITPADAGTYYCVK	SIRPA
MAPGEIKVDDAK	NDUFS2
KVEQGPPGGIGTAAIRPK	MLIP
QMREENQEEAAKR	RRS1
DQALAEHCLAALTECAASGDGNILALAVDASR	MMUT
EIFISNITQTNPGIVTCLENHPHK	UBA6
EDYDGLKEEFR	GSTO1
QIFHVLMNSPTITYQQMKTK	PALB2
ECEPPSAGAAVSAR	LNPK
SQDLSLQEAETEQSDTLDNK	ARHGAP21
AGVAAPATQVVQVTLQSVQR	PLEC
ELLVSALQELQSSTSNSPSNK	COG1
SMPESLDSPTSGRPGVTSLTTAAAFK	PDLIM5
RECDNPAPQNGGASCLGR	C8A
ASQSISGYLNWYQQRPGKAPK	IGKV1D-39
DMYATHLASGMLGVR	MAN2B2
TEVPLAENQSGPDCAASLK	SYNPO2
TYRPLNEVHIK	PPIL3
VSYGIGEEEHDQEGR	APEX1
DEPLHALYDNVEK	ASNS
CASIPDIMQQLQFIGVK	MOXD1
VEEEGVGEGAGGEAGADK	KCNJ9
EKYLTWASRQEHSQGTTTFAVTSILR	IGHA2
VLYGPLEGCLAPSGR	RALGAPA2
VGSHDLTLVNLHLAALTLLGSENSSK	EEPD1
GLMESISAGSFSFPGGHK	GBP6
RDFHFVYRPLDGGGGGGGSPPCLVVR	RIN3
KAVTDFTSEVTYDPPGR	WARS2
ASYFICHDQDTIK	PGM2
DLEAHVDSANK	MYH9
IEPHHTAVLGEGDSVQVENKNPKR	PIR
MEISAELPETPQR	UBR1
AEAPQSCSCENPR	KLHDC7A
EHFNYYSLDTALGHLVFSLK	RAP1GAP
MAPYQGPEAVPGALDYK	ACTN4
LSEPAEITDAVK	KLK3
QLLQENEVQFLDKGDENTVVDLGSK	FGL1
TLDPNSPQDFIDSFLIR	CYP2A7
VSGSSGELPLEDGVSHK	HMGXB4
GCFQAEIVPVTTTVQDDKGTK	ACAA1
TSVVIKWESPYDSPDQDLLYAIAVK	SORL1
GGGPAATLSR	ARVCF
HSTLGTEIEEQR	KIF16B
SYEQHNGVDGLANHGQTR	MTA1
MNTEPERKFGVVVVGVGR	BLVRA
TTSEGSISTK	RFTN1
DWNSNQVSK	CELA2B
SYGGPCGTAPVWGTPPSYGGGCR	RBMXL3
LQDEELDPEFVQK	GBP1
ASLIEEDEPAEK	CEBPZ
AVVAEKPSNQLQK	EEPD1
EHPVPLLPIRQTLPEDNEEPPALPPRTLEGLQVEEEPVYK	HCLS1
PGIPGSTASLLEPTSGALGLFQGSPAR	WDR62
ILDCGSPDIEVHTYPFRWYQK	TG
RDELEEGAPSEAMLR	PCSK1
QNPATQNVPR	MYO18A
MVAVGICR	ADH1B
TLSTPQEER	PRRC2C
LLNVNASDPPPISGK	TBC1D20
RSVSSFPVPQDNVDAHPGSGK	ATG16L1
LQPGAFQLSGDQLVVAGPGEPAAAR	MEDAG
DSPSESDVILLCPK	FILIP1L
HMAGAAAAGAVVGGLGGYVLGSAMSR	PRNP
RTSDPALCPLIVSAAADSAVR	ELP2
SFFSLTEIVR	CR1
DNTELPYHGK	INPP5D
IGNEEQPPHEGKPEVACILEDK	TCEAL2
NPHCTSPEHK	LRP1
TLSTSDDVKDRENEK	EXOC4
EELLAEFGSGTLDLPVLTR	EPPK1
GAHVVAGTAGYCFGNLHIPGYNLPWEDLSFQYPGNFAR	PFAS
GNEIVLSAGSTLR	DYNC1H1
RACQNVSVVIHTACIIDVFGVTHR	HSD3B2
YPVEHGIVTNWDDMEK	ACTG1
LEGDLSLANKDVTAKDSK	AHNAK2
VEFAPLFVPWER	MOGAT2
LTASEPLTLEQEYAMQR	NAT9
VVEKDNDVLLHWAPVEEAGDSTQIIFSKK	TBC1D17
AACSATAMEEDSEASSSR	UBE3A
VLQALGSEPIQYAVPVVKYNR	MYO1C
VYGDIIYTPAK	ALDH5A1
NRPDSGVEQAWK	PPL
EGFSGQIQFTAPLSDKVELGVIGNSVHMEGLPGSSTSIR	SYNM
PGPALWPLPLSVK	HEXB
LSAELGLQQPAWLR	CHST3
ITLEGPTEDVSVAQEQIEGMVK	HDLBP
AQFGDKPSEGRPR	POLR2E
VLAFLSLAEVGQVAGPGPQR	CAND2
QVAAGEDVCLELEVVAEAGEVIWHK	OBSCN
VGEEEILIYINDHENKNEEAFCVK	NPHP4
SARHPSSPSALRSPADPTDLGGQTSPR	SORBS3
LIQLAKGNLNTLVTEMNELLTR	LAMA2
VLEACALQPDVDSFPEGVHTSIGEQGMNLSGGQK	ABCC6
YLCGAHSDGQLQEGSPIQAWQLFINEESTIPR	PIGR
VNDCILQVNEVDVR	DLG1
MADALDNYVVR	PCCA
RGHVFLQTDQPIYNPGQR	C4B,C4A
EHSSLAFSK	APOH
TVGTNTPPSPGFGR	TNS1
VLLLEAGPKDVR	CHDH
GCELVDLADEVASVYESYQPR	MAVS
DPSLPVASSSSSSSK	XPC
KATLELTHNWGTEDDATQSYHNGNSDPR	GLO1
LLSTCGLIQSVELQEKPDLAESPK	RRP7A
GNTDSSLQSMGK	AKAP13
EKYLTWASQQEPSQGTTTYAVTSILR	IGHA2
DCNDTLEEDNTNLETPTK	PUS3
EEYVRFDSDVGVYR	HLA-DQB1
CTLHLGIEPLDSVR	CMYA5
DEIQIYQSK	SCRN3
CGPISDTLLYQQCLLNATTSVQALKPGASWDLKGPR	DMRT2
AQTDREDLRTLLR	HLA-B
VLDTPGPPINVTVK	TTN
NLLASEEGITTPK	MYOM1
SQNKEDYDGLK	GSTO1
NLELGLSQGSFAFIHK	SERPINA10
MEAIPCVVGDEEVWTSDVQYQMSPFNHGHK	ALDH4A1
SLDPMVYMNDTSPLTPEK	PTK2B
EIQVTELLNK	CPB1
LIDGEYKDYLASHPFDTGMTLGQGMSR	ITIH5
YLETPEFSGDGDHALSR	VCPKMT
GAMQTGLNTTQNIATGTKDAVCSGVTGAMNLAR	PLIN4
ETLCQWSTLSYPGLVK	THNSL2
AEGLGMVNEDGTGEK	RYR1
GETISGGNFHGEYPAK	HAL
GCAGVITLNRPK	HIBCH
GTQVVGSDMTVTVQFTNPLKETLR	F13A1
SVDLDLLCGHYNNDGNSPSFGLLR	PPP2R3A
MVGVPASLDMMLTGR	HADHA
VLLDEPPEEEDGLRGGPPPAAAAQAQVQGASFR	TDRP
VLLDGVQNLR	C3
TEITGATTMTSVGHQSMTPGEK	OVGP1
SVFKPFIFGVGVAQAPQVLSPTFGAQDPVR	SCRN2
VGVTALQQAPAVDVVAVGLMSGQVIIHNIK	WDR36
HNQVESIFLSAIDMYGHEFCPENLKK	ACACB
RQLQSLTCNLESLR	GFAP
GAPPSPEAGFATADHSGQER	COPRS
GHHTFLTEEVAQEYQVK	TRIM5
VHPSQMEISETVEK	SYTL2
LLTPLEIAK	DST
LVVQQAGQADAGEYSCK	OBSCN
LDSVFEEPLSK	MMP9
VFAEDQDMQYASQSEVPNGK	SMARCAD1
LNGEIQDLELPQKAEALK	APOB
STFGGGTK	
LSSVSGPSPEPPPLDGSPGPK	CASKIN2
LLPADALANCDLLLR	TBC1D4
RLEELDLGNNEICNLPESIGALLHLK	LRRC1
MVSGAYRQEFGQSKEITSAIK	MMUT
FFTGVMEPQLMQTSEMGILTSTALLHR	FAM160B1
TIHDAFCVFEQNQGLPLR	AOC3
WEVISLGLPFGK	PTBP1
KALPNSEDLVK	OPA1
AIFMDCGIHAR	CPA3
FTFAATRPSSVLVEQLAVCVSK	MDN1
LRPEPSISLEPR	KPRP
SWYSTHSIVGDK	THNSL1
GYDQFAYDGKDYIALNEDLR	HLA-C
GVAEVLRDGDCPAVLIPSKPLAR	SLC44A2
TNLEDIGR	TSFM
SSAGERHGSHHQLQSAESSR	FLG
EQLQQEQALLEEIERHGEK	PLEC
YNVTWYVSSSPCAACADRITK	APOBEC2
MDSKQQCVK	AKR1C3
TGLVEPVNMVDNGDGTHTVTYTPSQEGPYMVSVK	FLNB
ALYEVFSHPVER	TMEM231
SGHSGYHHSHTIPQGR	FLG
QSSNDLFQVNSTSDDEIPRK	BTBD8
AGGSYGFGGAR	KRT6B
HKLYACEVTHQGLSSPVTK	IGKC
EGGQFGHDIHHTAGQAGK	SBSN
GLFDDEDEESDLFMEAPQDR	WASHC2C
NKSTESLQTNVQR	RPL13
GIVDGVILPTETR	ATG2B
MPGAVQQFK	ABCG8
QCQQLQTAIAEVEQR	KRT79
AFFQSHPAPSAER	NPEPPS
LFAYSSWEVLR	GBE1
VSVVDYVEPSPQGTR	TXNRD2
FAAITLTQAGAYHCQAQAPGSATTSLAVPISLHVSYAPR	SIGLEC1
ILEDMKEEDYLNFILFSGDVSTWK	ITIH3
GSSGTQASDSEGHSEDSDTQSVSAHGQAGPHQQSHQQSTR	FLG
FLILPDAEAQLDR	TMEM128
DVCQAIDHGCEHICVNSDNSYTCECLEGFR	MATN2
CQVAGWGSQHSGGR	AZU1
SPAPGSPDEEGGAEALAAGIR	SYNM
TVLTGTKDTVCSGVTGAAK	PLIN4
GLGGLVWQGQVAELTTQMQK	RBFA
VYALISDAQPLLLSTFSGDR	GPLD1
DVIPMDALGPDGYSTVDQR	ARVCF
SDSDNQQGSGVPSR	
SKLPAAIEQLIVPHLAK	DNAH5
HQWGEEEPNSQTEK	SLU7
SNASEFQPSFHQADNVR	CRTC3
EDLLYQSKGYNDDYYEESYFTTR	EMD
KLSEKLDSTDFTSTIK	TFRC
LMIYDVSNR	IGLV2-18,IGLV2-14
EAADTERLTLQALTEK	CKAP4
NLDKLIQLVNAQQAK	MAN2B1
EVVTQHFLGVTYETHPIYYLK	CPO
SPLPWQYR	HSPG2
CQGSSVSQDSDSQGHSEDSERR	FLG
CVSNIGDVVDNEECNMK	THSD4
VTISVDTSKNQFSLR	IGHV4-39
SCEESADAPVDQNSVVIPAAAK	AKAP13
VVTTPAFMCETAVHYIHDGIGAMVR	GATD3B,GATD3A
ACNCNPYGTMK	LAMC1
TAASGVEASSRPLDHAQPPSSLVIDK	PDLIM1
QAQVLGTERTEEAAESQTAGR	APOBR
FFDDNLLVSTSR	PDE6D
FCAMISGRPQPK	TTN
VDDSSEDKTEFIVK	AARS1
SSFGLQVLNVHFGGER	AOC1
FSSPVDMLGVVLANK	NEB
DITTGYDSSQPNKK	PGM2L1
CPKPVGCPEGAR	MUC5AC
FWIPGEPNDAGNNEHCGNIK	CD207
RQGSSVSQDSDSQGHSEDSER	FLG
EDSNIRENSSGAGK	PUS3
VMFVGGPNTR	HAAO
LGCQDAFPEVYNKICK	DHCR24
GGSGGFTAPVGGPDGTVPMPMPMPMPSANTPFSYPLPK	IST1
DAGFHSEIFK	MYOM3
VQLLTSVGTSGLFLGVRVREEGAGMR	APOL4
LGNDAVSQDSSSPALSSVER	CARMIL1
TSDMAPSKETEMALAKDMALATK	MAP4
KYDYYYNTDSKESSWVTPESCFYK	IQGAP2
QDSDALPSPELLPQDQDK	ITPKB
VLFICTANITDTIPEPLRDR	LONP1
RAQQEQLLLQQQLQQQQQQPPSQLCTAPASSHER	PALM2AKAP2
CPSPPMTNLISVGGQHQGVFGLPR	PPT1
NTVLATWQPYSTSK	EIF2A
SEKEDLTNELQK	CENPF
LYEPVVIPVGR	NCF2
AIKPSIEATLESIQR	FAM13A
FPSLPILSPALMDVSYR	AGL
DDVVPWHTSMQVADR	ABHD10
DALPELLGLEAGIR	FAM207A
AAGFEEIEQDLTQRFEEK	DDX58
SVLSIQQQHTNPGAFGK	NUDT6
TLTSGGHAEHEGKPYCNHPCYVAMFGPK	CRIP1
EQELLSQELWQR	PRODH2
FTWALSKPGTAAELR	DOCK9
FVVTITVHPEPHVTWYK	TTN
TIHDAFCVFEQNQGLPLRR	AOC3
AALQELESEHGK	PCNT
ENEQGEVDVESHR	CD99
IEPHHTAVLGEGDSVQVENKNPK	PIR
VPTASTTFAPTTR	MUC5AC
SLKEESIEAVK	NES
WFDVDFPSPGPQGGDKETYNNIIR	MUC5AC
QYNIVGLPTNIDFLLNLSGHPEFEAGNVHTDFIPQHHK	MCCC1
SEDTAAYYCAR	
AFVEWSQALLLAPEGSR	EEF1D
QSAYCPYSHFPVGAALLTQEGR	CDA
LTIYTTLIDVTK	ASAH1
AQALEVFCDMTSDGGGWIVFLR	TNC
KVSVVDYVEPSPQGTRWGLGGTCVNVGCIPK	TXNRD2
TSNSEDGSMGSFSEK	EMC1
KAEGAPNQGK	RRBP1
RGDIFYTSK	AKR1C3
TEPADMNESCK	TRIM33
IAPSMCITKPEVDFALEVFR	AGXT2
LDPAYFSVGYVDR	LENG9
EADECIVSEDKTLAEMLLQEAEEEK	OLFML1
FSLDALITNVLPFEK	ADH1C
VYALISDAQPLLLSTFSGDRR	GPLD1
YATTAYVPSEEINLVVK	A2ML1
VTEELILR	SYNPO2
NQQEIPSYLNNEPPEGSMK	TMEM263
LHQLVPPQTDVLLHVDVAAAQTGVSR	ALG12
LLDDAMADDKSDEWFAK	GLOD4
AEGPEVAAGVR	PRX
NGYSLKDIAVLFTK	SLFN5
KLSVADQEK	ENO3
EAEESTGPDEAEAPESFPAAASPGDSATGHR	SCARF1
YNTEEFITVYPTDPPKNWPVVTLIAEDDR	OTULIN
STHNLQVAALDANGIIVEGPVPITIEVK	CDH17
KLIVQPNTHLEGSDVQLLEYEASAAGLIR	DPP3
EKQQHMVQGESETADVSPNNMQV	ERICH3
SGHIQILLR	TMED5
DDPTAQQIMQLLR	GOLGA2
QEELGAMVDK	HIP1R
SWTAADTAAQISQR	HLA-C
GDGGITHSEEINGKDSSCHTSDSTEK	BCAS1
ALRPDMGYNTLANFGIEK	NEK7
GYMLSEEPYIHANYQPVEIPVSHQPESK	TOPBP1
LAAAAAQSVYAFSARPLAGGEPVSLGSLR	GPX1
TISPAESTALFQGR	CENPC
CVVHEGNQK	P2RX7
MEVLEAFVITQSINMLR	DNAH5
ELTVSNNDINEAGVHVLCQGLK	RNH1
APYPNYDRDILTIDISR	ECM1
GEEIIHNYNLPPDLPQFIQAK	NEB
LQHLLSCYDSGKPVFLGER	B3GLCT
EMVDYVANYMEGIEGR	DDC
GVAPPTLITNSTGTHLVLTVTNK	MRTFA
QPCIPPPQLQQQQVK	SPRR1B
GGEKEEGNDGQDLR	AKAP13
VFPVRPGSGRPEGGADGSGVGAEAELQANPFYDR	ATPAF1
DIDLSCGSGSSK	GCFC2
ACPDSLGSPAPSHAYHR	ANO1
SEDELRPEIDEHTQK	REPS1
SETAPAAPAAAPPAEKVPVKK	H1-2
SGVEVRLPDDLEDLK	LAMA3
GTVSEDDPPGGVIAILSTTDADSEEINR	FAT1
SLEAPSGQQHR	MYO9B
TLNNKFFSFIDKVR	TTBK2
VTYDLVYYVR	FCGBP
DNLLETIPNHQPGKPLLGMK	COQ3
LPQQTADR	STING1
LETMNQCWESVLQK	MACF1
PRPESSQEPAALPK	BSN
ALNSASTSLPTSCPGSEPVPTHQQEQPALELK	TACC3
ICHRPEEITR	MUC5AC
FRPTTAANGLEPLLTK	ERICH3
EAYVSCQNQGADLLSINSAAELTYLKDKEGIAK	LY75
DSLFVLHELGEQLK	SYNE1
TSLSAPPNTSSTENPKTVAK	IFI16
SGPYVPQCDAFGSWEPVQCHAGTGHCWCVDEK	TG
QFRFDPQFALTNIAVTK	HLA-DQA1
ASLEAAIADAEQHGELAIKDANAK	KRT8
HQHVCSNLVTTDDLR	FRAS1
DCGEAAAQWITSFLK	MTARC1
QVPGFGAADALGNR	DMKN
KPEEGLQVEQLSGVGIPSGECLAQCR	FRAS1
AGLRQQSHQESAR	FLG
GLMLSLLAEEPLLGDIAAIEEVYHSSLASLNGLEVHLK	HPS4
EQNQRPLHPVANPHAEISTK	LYAR
LTFFNSTLNTSGPVPEGDALPIPGAHRPGVVTK	ALDH1L1
DSEDVSER	AKAP12
VWQTVSPVESR	MXRA5
VPEPDYTKVPEPGSIK	SPRR3
QQALQALEELR	PLEC
NTVYLQMNSLR	IGHV3-74
EENVCEENSPVDQSDFFYEFSK	TUT7
AVEEELDTEDRPAWNSK	SLC6A17
AAFGGGSDCQMTCENQNPCFPIQLPEEAR	TPO
ETQDPTAQSLAASLSTGQLLR	VWA8
TTDLSIPLPSADLVVQAGQVDMK	AHNAK2
DHVGVEILTPLFGTLHPSFYGSSR	ABO
AQQNLSWEEITK	COQ5
MKGTAHYHSLPAQDNLVLKR	NRAP
TGGAEITGYYVNYR	MYOM1
QSGICMDSGGFR	SCRN2
AREEVPALHPASHDIGK	COBL
DNSKNTLYLQMK	IGHV3-38
ACPSGHHLHR	LTBP4
SMPIPIPK	C1orf116
NRPETVVSR	LUZP1
EMHAFQCSR	PBLD
EAPPAKVPEVQKR	TTN
EHLVQKLQAEANDLQIR	GOLGA3
SLKVELTEDKIDYTK	SAMD9
NYTVQFDVGVQFEEDLR	RBP5
TLTLCHQPGAVFPPGPQEEVLS	TRIM65
LSQPFESYITAPPGTAAAPAKPATPATPGAPTSPAEHR	DMAC1
YWMHFCGGSLIHPQWVLTAAHCLGPDVK	TPSAB1
FPEDFESCDSIPGMNLEAWR	TPO
RPPPASAPAPQPAPQPAPTPSVGSSFFSSLSQAVK	SYN2
VLNDGTVYTAR	DSC3
NGYLHVFYDFGFSSGPVHLEDTLKK	LAMA4
SEESTASHSSQETTGTIVLPAR	MUC12
AEGAPNQGK	RRBP1
GRMEAIPCVVGDEEVWTSDVQYQMSPFNHGHK	ALDH4A1
SRESEPLSK	SLC16A7
STEGDTVIPVLGFVDSSGIK	CALHM6
ISYGPDWKDFYVVEPLAFEGTPEQK	HEXA
DSLGQTVDLGLTGNHGVVHPSLADSANKFEENTYCFGR	ACAD9
LLQAQAAGVDWR	NOL9
EEYARFDSDVGEFR	HLA-DPB1
ENSALFCYLLVNK	C3orf33
WDYHTTHINQLQLLSTIDESPIFK	GLCE
RTFEYEAEK	DENND2B
LDSAQLEGDLSLANKDVTAK	AHNAK2
HSDLAALYTIVAVFPSPLAAQNASLHLNNSVSR	R3HDM2
EKIESLTEVHR	GOLGA4
GSSFQSGRDNTWR	EXOC2
VTITCRASHSISTYLNWYQQKPGK	IGKV1-39
EAATLEVERPLPMEVEKNSTLSEPGSGR	HDGF
TVIPTDLER	STX17
HSVSQEGQDTIR	FLG
ALTEDSTQTSDTATNSTLPSAEVALQAK	FPR1
KREDAITQQNTMQNEAVNLLDPGSSYLLQEPPR	PAWR
QVGDFHQVIIR	CPVL
QMGVHGFGR	PGM5
CKYVSLIYTNYEAGKDDYVK	GSTP1
QLQDAQILHSVAIDSGFR	TYW3
EGCVCDAGFVLSGDTCVSVGQCGCLHDGR	FCGBP
LPNTLKPDSYQVTLRPYLTPNDR	ANPEP
DSTTVHEPISKPFMLPSLADVSK	QRSL1
EEGWLAEHMLVLGITNPEGEKK	PCK1
AWMETEDTLGR	PRAP1
YGLLVGGAVSHR	QPRT
SSPTTSEGTSMPTSTPSEGSTR	MUC17
QECCCTSGAGWGDNCEIFPCPVLGTAEFTEMCPK	LTBP1
TLADHLGMIAGGTGITPMWQLIR	CYB5R2
ADVWDAGHYTCEALNQAGR	HMCN2
AQYESIATK	PRPH
LYLSKNQLEELPEKMPK	DCN
AEDTALYYCAR	IGHV3-20
VAAVGYINEAIDEGNPLR	IQGAP2
SQVLSPPHPPLPQK	SORBS1
ASQKDFENSINQVK	ECI2
SGLGPVDLALLGLSAER	EEF1D
LNVLESLIK	DST
EQLYTTASLK	CD200
FLDRYFYNQEEYVR	HLA-DRB1,HLA-DRB5
DLGEGEEGELAPPEDLLGHPQALSR	RETREG2
YAMAWGVVEK	LACTB
TVALQEGLRR	FTCD
QATSDVQESTQESATVEK	SYNE2
GYEQHAYDGKDYIALNEDLR	HLA-A
VALPDDHLK	RTN3
LMIYEVSKRPSGVSNR	IGLV2-23
TPLEDYSGECFQK	DHX37
LTEDPAERVLLLEAGPKDVR	CHDH
DRLVAGEDDLEQATEALDSISLAGK	WDR81
PLLQAQGLTPSER	BSN
VAVQEGINSGTAMSR	KIZ
TNTFPLLEDEDDLFTDQKVK	WASHC2A
LFSVPSVFTPAIDTKAPEK	CTU2
NNFPAAAPHPVNGLEK	PAX9
DVQEFINNPK	BCS1L
EASDPFSLNELLDELSGK	NCAPG2
SSQESGEEAGSQENHPQESK	CHGB
EAVQQQQNQLVWVSEGK	TJP1
CQVEGGSPR	ICAM3
AAEVAPAVR	C17orf58
LVGVVPGPVEEPADSDK	CARS2
SAVEAQNEVTENPKQEIAAESSENVDCLENPK	LRRFIP1
FGYYGDALR	LAMB1
MTLLNVCSIVNNLNSPAEETGEVHEEELVAR	NTS
AAIDGYVQEK	EIF2B4
SLTIRVIPIQAHQIVNGAPPAR	GFAP
VTQEFLEYHVNR	MAN2B2
SFYYQHPER	LAMB1
AELQTESLTPVPNSGSSVLGSLFK	RAB11FIP1
HWLVTDIKGADLKEGK	PEBP4
GLQIGYCSVDDDPR	NRAP
ALDSNSLENDDLSAPGREPGDFNPESR	LRRFIP1
AVHNEGMQVLSLTESPYSDGEDHSIQQVSESWLEER	AKAP9
ENAEQGEVDVESHRNAIAEPAVQR	CD99
EFENLYIENIELR	WDR37
DLYHYVTSYVVDGQIIK	PSG7
EVIDASDK	PRPF4B
ADSSRHSQVGQGQSEGPR	FLG
EDSQTAGANCGTLGK	DENND3
NTMSLLAANNLLAGLRGELMPSELK	GRHPR
CPDNTLGVDCIERK	NID1
GTSEPVLDPQQTQAFDQLCR	VPS8
FLILPDAEAQLDREGDAGPETSTAVEKK	TMEM128
ELPELEATAQLLPLEGPKEEK	C11orf16
IIWDLREEVEK	KIF13B
AVDVVLDCFLVK	TAPBPL
ESESVSKEEKEQNYDLTQVSESMK	ECD
GERAEGPEVAAGVR	PRX
EVTEFYVQNENSVDTWGK	ACAD11
CVCHVGYELGADGR	MEGF6
KNVSIEFPVIDR	LRRK2
KHPSPANTLFPGNK	NTAN1
HFHNQEELLR	HLA-DRB1
HQIEDNVSK	GOLGB1
NKYEDEINRR	KRT7
YTIAALLSPYSYSTTAVITNPKE	TTR
LQALLQDLSEVSAPR	HEXD
AEAEAGSPRPEPR	EPPK1
EQDAEGQDYCTLTAFTLK	SLFN13,SLFN11
ENIDTSHSDVVFAGDGIEGSPAK	FUT2
FGGTICSGDIWDQASCSSSTTCVRK	C8A
ANFLNSNDVFVIK	VIL1
NFLQTVSSEK	MRPL53
GPKVDIDVPDVGVQGPDWHLK	AHNAK
QVTSTASTFVKPIFSR	NDUFA6
DEGEGAAGAGDHQDPSLGAGEAASK	AKAP12
LQEQQQQMEAQVK	GBP6
NLPAGTLAAELQETFGHFGSLGR	RBM19
VELTEDKIDYTK	SAMD9
ENSHFFVATFAR	TBCC
DTVCSGVTSAANVAK	PLIN4
ESNIQTIGGK	FABP6
SVVSDVPEELDFLVPK	ZNF638
MQYAPNTQVEILPQGRESPIFK	CAPG
APPPPQPTVSPRPR	MUC1
LLEGPVSEGAGLK	AHNAK2
TQCTEFFLAPVKTEVPLAENQSGPDCAGSLKEETGPSYQR	SYNPO2
GKQTVQVDEHARPQTTLEQLQK	ACAA2
AAVDCSVPVSMSTSIK	SPATA7
YVSLENQHCEHCNSCTSK	ZCCHC4
GCFQAEIVPVTTTVQDDK	ACAA1
NIADADATVK	LAMA2
STSLMEPEPAEPLAAAVEVANGAEQTR	SMTN
EKKALQEVHQQALDDLQAEEDK	MYH3
AHSQIDRVDLGTLR	HLA-A
LAAELSATLEQAAATAR	EPPK1
NYLQDENENR	CLEC1B
DSQESWFK	AHNAK2
GANVIAGVWLEEVGQK	PLEC
DSAAAVVVYDITDVNSFQQTTK	RAB6C
ENTIYINEVLCMQMR	TEKT1
MILFAFGSAVAQAR	MRPL37
NEVLWHPTLNLPLSPQGTVR	TAPBPL
LEEQDEFEKIFK	SACM1L
SGAHSFISGLPQGYDTEVGEAGSQLSGGQR	TAP1
VNGEAIYETYTWR	FUCA2
QQPAPAVPHQEQAPLLFPR	CDC42BPG
TMDSCELDLVYVTER	TNS1
LAFEEFQLER	CSMD1
AEWRFLLTGGIGLDNPYANPCTWLPQK	DNAH7
DDCNRLQEQFDEQSKENENIGDQLR	GOLGB1
GDLLSENPQQAASSLGPHR	RIBC2
GRVLLDEPPEEEDGLRGGPPPAAAAQAQVQGASFR	TDRP
MSGYPIPK	TTN
LPAEPITR	MRPL9
LCNTGDNAVCTTK	KLKB1
LKAKLPEATPTELAK	GC
KNEINLESELKSEQVTE	MASP1
SFSGLLTMYQR	LAMB3
DVNERPPQPQASVPLQLTR	CSPG4
SLDYLGEVLK	MMS22L
GTAAAAAAAAAAAAKVPAK	RPL14
TQDEEEQAEALQR	RAD51D
ALFNYNPNEDKAIPCKEAGLSFK	MPP7
GFNPVTVNSLGVLNGAQLFSLNKEELR	EPS8
GQGQSVQMSGAVK	TBC1D5
LQNIQNTIEETGNLAEQAR	LAMC1
LEVLTNKK	GSTO1
TLTYFNYDQSGDFQTLTFEGPEIR	COL14A1
CLIAEVWCPEADLQDLHR	ATP6V0A2
SMPVFLDPADIAALEGISWR	FAM160B2
FLEVQYLTGGLIEPDMPGR	PLEC
AGTNMTMVGVHGPK	FLNC
AFEPYLEILELYSTK	SGPL1
IEPDEAPVVAVLGSGGGLR	PLA2G4C
VLSQPMPPTAGEAEQAANQQER	HSPBP1
PRGSSVSQDSDSQGHSEDSER	FLG
ASAILPGVPGSETLSNEVFQESEEEKQPEVPSSLAK	NIBAN1
QQQDYWLMDVR	ANPEP
ASGYTFTNNGITWVR	
LATEDDLVEMQGYK	MFN1
YGLSAAAAAAAAAAAVEQR	IRF2BPL
AATMPHSVISDSPR	FCRL5
ANYNPSLK	IGHV4-59
GQFVMEHHTLPDVK	FRAS1
WILTAAHTVYPK	C1RL
ELSGLPSGPSAGSGPPPPPPGPPPPPVSTSSGSDESASR	CAP1
QMAQPFHREDQLGLSLLSLEQLESEETLQR	ERCC2
TTYTENGR	ENPEP
FNKPFVFLMIDQNTK	SERPINA1
YVAQAGLDLELLRSNRPPTSASQSAR	B9D2
ASQSISTWLAWYQQKPGK	
VTFFEPGSGNENGTSNKEDEFR	STAU1
VAALNIQVGNLCEFLPQDKVGEFAK	SMC5
VTISCSGSSSNIGSK	IGLV1-47
EIQEAIAVASASTMH	QRICH1
EIMQNGPVQAIMQVHEDFFHYK	TINAG
RLSGLIYEETR	H4C6
IPEAGGDNSVFDIFELTGAAR	THBS1
GWTGQESLLDSDPEMWELLQR	SHMT2
FPSVSLQEASSFFR	PRR4
AEQSEDKPEK	AQP9
GTIFCPPCYDVR	PDLIM7
MNDADSTSVETMYSVASQCLHEK	IRAK4
NGPSGLRGAAPEGDSAALAEESPPAPSSR	RADIL
GFYPSDIAMEWESSGQPENNYKTTPPVLDSDGSFFLYSK	IGHG3
EIPLTPVDQAAFLSEVLQR	SZT2
FYNSEGYGFGLTLYPNSR	MEP1A
MELSQPEVSEDFEEDALGVLPAFTSNLER	PARP4
IYQFTASSPK	SKAP2
NLHTHHFPSPLSNNQEVSAFGEDGEGDNLDLWTVR	SDF2L1
ECINHGDLNNHNILIESSK	HYKK
DGVIGLNPLPDVQVNDLRGALDAQLR	SLC38A10
AELSRSDLSLIQQQQQQQQQQQQQQQK	FAM171B
REPGYTPPGAGNQNPPGMHPVTGPK	LPP
GGGGGIGGGFGGGSSGFSGGSSGFSGGSGFGSISGAR	KRT3
FCGEHAGAMEEEDAR	TRMT13
SSRDQALAEHCLAALTECAASGDGNILALAVDASR	MMUT
LNSVTAADTALYYCAR	IGHV4-39
EKSSQESGEEAGSQENHPQESKGQPR	CHGB
GLRGPLTLNSPLTPEK	AOX1
LQGSVMELLQDVDGVIK	TRIM5
DNPPNIPSSSSSK	OXA1L
DAPQGEDMLNAIR	MTSS1
LPEGSVAIK	ITGA8
DAEECPETAEVK	PPP6R3
TRPGELMVGEDDAR	STAB1
FFDNDLLVSTSR	PDE6D
TSRPRGSSVSQDSDSQGHSEDSER	FLG
TGFSFPAQEPRPQTQNLGTPGPALSHSR	SORBS3
EAEGAPQMEAGKR	CALD1
IQDKLPTVTAKEDEEED	DPP6
SQVIAEKEPEPDLMSPTR	DOCK5
RPGGVPEKPHSR	CCDC154
RSVQWCTVSQPEATK	LTF
SEKETVIVEEQTEK	NEFH
AFCGNPAAVCLLENELDEDMHQK	PBLD
KVEGLLGCKPEVTIECTGAEASIQAGIYATR	SORD
VSIAELAQASNSLITWGR	DDRGK1
AWEQGWEQTHIEAQGQAQK	ADPRHL1
HRELSGGTEAGTVPTSPGK	RASA4B,RASA4
AAATSPDSGAK	CGNL1
YLDLLPTSLPHAVTCDIK	CYP2C9
ADLDVSGPKVDVDIPDVNIEGPDAK	AHNAK
TSSSESSAVISAFFECLR	LTN1
GYGTSGPGGDLPAAPAPR	BHLHE23
VELFFKDDANNDPQWCEEQLIAAK	PAICS
DLSAKQLQEMLGLSKVPVTQATR	SEC23A
VRDVFDFYNVPIQDR	MRPL50
KGDEVDGVDEVVKK	PARP1
STESLQTNVQRLK	RPL13
SRPSFHPVSDELVNYVNK	CTSB
TLDIPGNSDPNMIPDGDFNSYVR	C4A
MDPNCSCASGVSCTCAGSCK	MT1F
AVNAVGMSENSQESDIIK	MYOM2
VKISTEVDITNVDLSTVDKDQSIAPK	RPN2
QWWFGGGCDLTPTYLNQEDAIHFHR	CPOX
HNYEVGYR	HLA-DQB1
ESSTDDSNIWIGLHDPK	REG1B
ELAKLSAELDKDLR	SORBS3
KGSPDTEFKSGAGTELSVR	SIRPA
TVVLGDLLIDNKDTVR	NT5C
EQVPHCICANGR	A2M
AEAEDTSKDPVGR	MMRN2
KVSVVDYVEPSPQGTR	TXNRD2
ELTVCSSSEEQK	ARHGEF28
TDFGDTEEEVKGPEK	SYTL2
DFYVVEPLAFEGTPEQK	HEXA
DSVQHLQTLTQSGADEHEAWNQTTVIHLQAAK	ACOX2
NTNSVPETAPAAIPETR	ADAR
VPVTQATRGPQVQQPPPSNR	SEC23A
LSGLQPQIER	DMD
VNLASRPEQGPSGPAAAPGPGVAPAGAVTISSQDLLVR	ZXDC
DGVIGLNPLPDVQVNDLRGALDAQLRQAAGGALQVVHSR	SLC38A10
LSCAASGFTFDDYGMSWVR	IGHV3-20
IPSSMDSNYQQSSAGQPINAKPSQTANAKPIPR	MYOT
YEVPLETPR	GAA
AETSLGIPSPSEISTEVK	FAM114A2
GPDMLWQCPSSPWEK	CD163
CQAECEPGYFGPGCWQACTCPVGVACDSVSGECGK	MEGF6
CTAQWHNYQK	SYNE1
VIGYHLECK	TTN
LDGAQLQGDLSLADK	AHNAK2
VAIVHLDK	CCT5
SPDATLSPATTTSSGVSK	MUC12
AAVFHEKDYDSLAQPGFFDRFLR	COL6A2
NSVQNQNHQTFLTVEK	ASAH2
LAILPASATPATSNPDPAVSR	ITIH4
QAELVPATVNDYK	UTP20
VLQQLTEEAALDEASGFNIPAEQASRPWTQPR	ZFYVE19
LLIYENNKRPSGIPDR	IGLV1-51
QGTSGGVNTSSEQIATLTGFPDFR	TACC2
VVSVLTILHQDWLNGK	IGHG4
ETGVHSLLIDTLTQR	MYPN
CQPSGHWEEPR	ACAN
VDDVINVSGHR	ACSS3
SPPGAAAPAAAKPPPLSAK	IRF2BP2
YANLSSPTSTVSESQLTK	MLIP
AQVDEVLQLREELEALRR	PPL
SILDADPEAQALLEISGHLR	MEAK7
SSELMDVATVQDVLR	CROCC2
LDPEAYGAPCAR	KLK10
DLLANCAIQDDLESR	ACOT11
DLLTLRNFTGEEIK	OTC
SETGTRVGVVQYSHEGTFEAIQLDDEHIDSLSSFK	COL6A2
LCFKENAEQGEVNMESHR	CD99
AFITHGGTNGIYEAIYHGVPMVGIPIFADQPDNIAHMK	UGT2A1,UGT2A2
TIEEIYMSSIESLAEVTAR	FAM114A1
HAGIGHGQASSAVRDSGHR	FLG
WLNVQLSPR	CPN2
ACAGMISTWVERK	SERPINI2
LQCPQVDLFYLHTPDHGTPVEETLHACQR	AKR7A2
NSTLSEPGSGR	HDGF
DGGSPITGYLVEYQEKGTQDWIK	TTN
WQQLNPDAPEALQAPAQVPSLFRNDR	PARP4
WLNSGRGDEASEEWQNGSSPK	ADD1
LDEHQGEGTTPCTSSILQEK	PITPNM3
QLTLQHHMGSADLNATFYGPIKK	CUL3
GMPETTQPDKQR	BAG3
DTEGGPKEEESPV	SLC16A1
MEGKGDVMSTACGTPGYVGK	CAMK1D
ASQGVSSYLAWYQQK	IGKV3D-11
TYFGAEPQSVNFVEASDQIRK	SERPINB10
ATDETDRDIIREPLTELR	MACF1
IIPILGIANYAQK	IGHV1-69,IGHV1-69D
TFLNVVKNEGITALYSGLKPTMIR	SLC25A15
VSIACLAPGSGPITLLLR	PGGHG
RWIQPEPR	TNS1
YVSLIYTNYEAGKDDYVK	GSTP1
TRYSELTTLTSQYIK	PLEC
YGDPNHHLPLPDNWK	CPN1
LLGLPGPPDVPDHAAYHPFRR	ITIH4
SVFKPFIFGVGVAQAPQVLSPTFGAQDPVRTLPR	SCRN2
SFVHLKPMSHELPCGHTQTVQAHYILNGGTLLGLK	A2M
ASLQASTTAPEAR	AMPD2
NDWGDHYHWK	EFHC1
SSGGGGGGGGSSWGGR	HNRNPA0
QDALVCFLHWEVVTHGYCGLGVGDQPGPNDKK	PSMF1
NHLGSAWEESR	FLG
IQYEMPLCDEGSSSK	SYPL2
AEIKDGLEFMQHSETLWK	TTC38
SFGQSSTLFQHQK	ZNF22
AATDLPGPETPR	SCARF2
TLSGGIAVNGPR	GBP2
GLQAQEGTVSWAVEAAPQTSDRGAYLSQR	NACAD
DAAPQTFSVLIGNR	ATP7B
EECHVPILEANVDAQPK	CFHR5
ARGPGGENRDAEAQR	PROB1
ATDLSIQPPSTDLK	AHNAK2
NLIPVGSLVVMDVEVDKIEDQK	THEM5
TYFGAEPQSVNFVEASDQIR	SERPINB10
GAVALSDVMIPESPEAYVK	SYNE1
WSGSASRNHHGSAGEQSR	FLG
APLPEFGAVSLKPPQPQFTDLPK	PRAM1
DSQIYAVDYETLTR	MRPS34
CDAEAPEDQCTVTR	LMBRD1
VPHDVTDASK	FLNA
INAGMYILSPAVLR	GMPPB
DTVCSGVTGAVNLAK	PLIN4
CPEALFQPCFLGMESCGIHDTTFNSIMK	POTEF,POTEE
LEKEIEVLERGDSAPAAAK	PALM
EVFPMAALMPGAEK	PUDP
ELALGQNR	DDT
EIEVLERGDSAPAAAK	PALM
ASSAAAPHTVSYPDNLNYR	DGAT1
IYIDDNSK	PIP4K2A
LHSLTQAK	RRBP1
AEGAQPQQPPQLGPGAAAR	RBFOX2
SGSFLYQVSTHEQSESTHGQSVPSTGGR	FLG
SRGPGAPCQNVDECAR	LTBP4
KLEELELDEQQKR	MAP2K2
ISILANTLINPQPITTFQQK	EFHB
SRWQQNVFSCSVMHEALHNHYTQK	IGHG1
EAAGTEWDPGASPR	FAM241A
IMCTVDHQGQR	RNF213
GTAAAAAAAAAAAAAK	RPL14
WIDTQVILALPYDTPVPGYMNNTVNTMR	PYGL
NLGVVVAPHTLKLPAEPITR	MRPL9
VTITLTDVNDNPPKFPQSVYQISVSEAAVPGEEVGR	CDH11
TAVEKLSWAEAGSQTAAGAMER	PDE12
FNQENIKER	CYP4F11
HITSNTTAAEFIMSATPTMGNTDFWK	PARP4
GATIGVLLDFNRK	TRIM9
TEEELKELQAEQQSQEVAGR	CGN
LHVSLMENCPGTLQALGEPIR	OBSCN
VPSFETAEGIGAELK	SLC30A9
EAAGEGPALYEDPPDHK	APEX1
SNSAWQLYLQR	MINK1
NASGLVLPTDMDPTK	SORBS1
VQLPTESLQELLDLHR	GBP1
HSLCGETEEEKIR	GSTM1
ILDVDNVDLAMGK	TIMM44
NNNIDAAIEDIENMLTSENK	LRPPRC
SIDPGLKEDTLEFLIK	NCAPD2
LQQQHSEQPPLQPSPVTTRR	TOR1AIP1
VPLGGLQSVSLTIWK	C11orf16
SSQSVLYR	IGKV4-1
GPWALEEESFGREPEER	LAD1
RQGSSVSQDSDSQGHSEDSERR	FLG
SPADPTDLGGQTSPRR	SORBS3
AQSLQEAAHQELETLK	FYCO1
CHLGPGHQAGPGLHR	MUC1
EGVTIFTLGIEGTSDTQLEK	COL6A6
VYGNKDADGFYR	RIMBP2
QSPGSPERDYSPYYK	KRT13
ADIAVVICDTPQK	ACSL5
KCPTPCQLQAEQAFLR	TG
TTQNIATGTKNTLGSGVTGAANVAK	PLIN4
SPISTGQPTNQSMDDTREDIYVNYPTFSR	CD226
IAIQPGTVGPQGR	COL4A2
DSKPNVVSNNVFHIQWSLISFK	FRAS1
TQNKEESYDFFKSYEYK	TJP2
ATGQVCHALCSPEGCWGPEPK	EGFR
ELSLGIFGPMPNLR	LRRC15
ELGPYSGK	CAPN2
GVVDSEEIPLNLSR	TRAP1
EADECIVSEDKTLAEMLLQEAEEEKK	OLFML1
SLSSAINASTGDYLLESVNKLFGEK	SERPINB2
KAPGTKGTAAAAAAAAAAAAAAAK	RPL14
GATACDLVQR	ALDH16A1
NTGENEGGIDKFSR	GBE1
GNTQATSHCFDVR	ODR4
RPRMAPADSGPHR	NOP53,ELOA3CP
EQLGATLSGLIEEK	CTAGE6,CTAGE15
ICIDAMHGVVGPYVK	PGM1
EHGHFSSLPQDSAYHSGIQSR	FLG
AKPPQESPSSASALAEWASIR	CRACD
ELGLVPLTDDTSHARPPGPGR	SLC2A9
EQSHAEISLPAESGQAVEECK	AKAP12
VLTTGPTPSSFPR	PKD1
EPVSGAVEGKEELPDENK	CAVIN2
AQVDEVLQLR	PPL
QAPGQGLEWMGWISAYNGDTNYAQK	
NISFCVQEGEILGLLGPSGAGK	ABCA6
TEEELKELQAER	CGN
TYGLMDSHTVLQISSAKPSDAGTYVCLAQNALGTAQK	HSPG2
ATQAALSLLEALDTILPPTRPTDKPLR	EEF1A2
LGAGYGLLSEAELKVVPIIAK	TRIP10
VRENSCPVGAR	COL6A6
MVQCNKGAYFSDDIYKDTEER	GIMAP7
CQEVVSWLDANTLAEKDEFEHK	HSPA1B
ALLNYIASK	GSTA3
TLDAFPAEK	CPPED1
EVGTSDKEILTSR	PNPT1
LYLSVAGVSTTCQEHSHICL	SGCG
TLINESLNFK	LRRK2
SWDSSSPVDHPEPEAASPTTR	ZC3HC1
GEVYSCGWGADGQTGLGHYDITSSPTK	RCC1L
REVDFAVEVFR	AGXT2
EELGHLQNDLTSLENDKMR	POF1B
EAGSDFGPETSSVLHLDHSADSPVSSLPTAEDTYR	TANC1
WQQGNVFSCSVMHEGLHNHYTQK	IGHG1
GPDGVCLSGDRGPQGDK	PBXIP1
MDKDLGSVQGFEDTNKSER	ZC3H13
VSGEPQESGDGSLSPQAEAIEVAAGESAGR	CLIC6
ADQNYNYNQHAYPTAYGGK	DMKN
VYEEDYGSSLEEDIQADTSGYLER	ANXA8L1
TEEAILISLAALQPGLTQAGAR	SPOUT1
RPGSSVSQDSDSEGHSEDSER	FLG
FAENPKAGDEFVEK	HADH
AKLDSAQLEGDLSLANKDVTAK	AHNAK2
YVSLIYTNYEVGKDDYVK	GSTP1
QHVGSSTEFMEAWR	CALB2
EMNLEGTNLDKLPMDSTITK	IQCG
ALEDVFDALEGKSIKS	CPT2
MVAEAGSMPAAFSVK	POTEM,POTEH
AHAFVVQQKEQELQQTLQQEQSVLDQLRGEAEAAR	PLEC
EQWNSLKQNADQQDTEAMPDYKK	SPATA18
EEVKEPPGTNIVILEYAHR	C2orf88
LSCAVSGFTFSSYAMHWVR	
RAPYPNYDRDILTIDISR	ECM1
GLTVFPEELIIGR	ADH4
VHPGIQSGTTNKPNK	FLNA
IIRDDMLCAGNTR	TPSAB1
TEDSNAGNSGGNVLAPDSTK	GOLGA3
VRGTQVVGSDMTVTVQFTNPLK	F13A1
KAEESMGIGSEEKPGR	PALM3
NTWDLHPTSSK	PRUNE2
VYGDIIYTPAKDR	ALDH5A1
APTGEPGGVGSQPDDGDSPR	SDHAF1
AFFPTCCVSADSGLLVGR	PIGQ
DSGRGDSVSNSGSDALRSGLTVPTSPK	PDCD4
AAQLPDMPLEELGQQVDCDHMR	MUC5B
VLWLDEIQQAVDEANVDEDR	IQGAP2
RGEESPGHFLVAATGTAAGGGGGLILASPK	SALL2
SQNKEDYDGLKEEFR	GSTO1
HDLQGLQSDLPLTPEQLEAVFESLDQAHTGFLTAR	CRACR2B
VGAIEEFTFLPLTESR	TMCO4
LQGGAGPEPISEER	MLPH
AQREDELTFTK	PLCG1
FTQPLANCTTVTGYNTQLFCCVR	MYBPHL
NLDYPFGNILR	NAAA
NVDCILLAR	MTAP
SSTTSAVTTSTTSGPETTPR	MUC5AC
TCAGESKDYALHAGDGSSDPEVLLNIENQR	SVIL
DAATAAAAAAAAAATAK	OTUD7A
FGDTEADSPNAEEAAMQDHSTFK	DMXL2
FSKEEPVSSGPEEAAGK	NOP56
EGETQHVVEIEVIFDGVR	FREM2
AENTEGDLNSNLPHAPYHTGDPQLDTAIGQWLR	PGM2L1
HPFGFGQVPDNWREVAVGDSTGMALAR	LOXL1
AGVETTIPSK	IGLC2
NMSFTSGNMK	DNAH11
TCGLCGDFNGMPVVR	MUC5AC
TLSVCISDGVFPGMSGPPLVLR	AARS2
THPVEVFEPGAEHIVR	CHL1
LQDSDTEYGSGYPNDPK	RNASEH2A
KLGIHSTLLDEK	GLRX5
SPVTTPFK	LIMCH1
DHENLQTSFVDNVATLK	TTN
YFYNQEEYVR	HLA-DRB1,HLA-DRB5
CGPGLRPCAPLEDECEAPPVCR	DLL3
AWLSSQAAELERELEALR	NES
LAIEAGYHHIDSAHVYNNEEQVGLAIR	AKR1C2
YQTPTGIK	COL10A1
SEQVHGVINLGNSLIER	SPTA1
GSEGKPSLTLPASAPAPEEALTTVTVAPAPR	PRRC2A
TPIEGAQTSIYLASSPEVEGVSGR	RDH14
AKVETMTLDLALLR	WWOX
SEEPLKTDSSASNNNSELK	KDM3B
FLDKLPQQTGDR	STING1
LMIYDVSNRPSGVPDRFSGSK	IGLV2-18
MLPVYQEVKPNPLQDANICSR	ABCC4
VVASGPGLQHGK	FLNB
GISSQPFPEQHCAALK	PSMD5
LKICIDAMHGVVGPYVK	PGM1
DFAHMLLLK	CYP27A1
VEPKYGPPCPSCPAPEFLGGPSVFLFPPKPK	IGHG4
DLGSVQGFEDTNK	ZC3H13
AHRLHQLAYDTYQEFEEAYIPK	GH1
TPSVPSVPHQLPR	FHDC1
FYPQSLQLTWLENGNVCQR	SIRPG
HAMVVCQETDDTYIPLNHMDPNQK	DHTKD1
LCQPEGIHICNGTEAENTATLTLLEQQGLIR	PCK2
TTAEYQLLVEGVPSPR	PECAM1
LLHTADTCQLEVALVGASPR	GLMP
NAMAHGNSTHQNSLEAQK	CASR
YSFLHNSQTSFCFSDSIPTPSNMEETQQK	CSH1
SALENSEEHSAR	PXK
MAVDISESEAVESGFDLR	TTN
ASQSISGYLNWYQQRPGK	IGKV1D-39
ASSGDIGSLDYQEFVVDIESR	BNIP2
GLVYPARPAQLR	LEMD2
NTLGSGVTGAANVAK	PLIN4
YVGNFGNSSGEVDTK	CWF19L1
QKPGSTPNLQQK	PRAG1
IQNEGVVLESEETNQTNK	GPATCH2
EEAAGISGPAGR	TRIP6
LGSETCLPQHIR	USP36
ADVSQEVEEVLAESHVQR	SLC2A9
VGDTITVAAWNHSASMEEEGEDCTLNVYR	LUZP1
GKIYSLNEGYAKDFDPAVTEYIQR	FBP1
NYDPALHPFEVPREYVR	DCAF13
HGSHHQQSADSSTDSGTGCR	FLG
LCFTVQGFPMPMVQWYK	MYOM2
GQEEMLLLFHHLTPR	SHROOM3
FNKPFVFLMIDQNTKSPLFMGK	SERPINA1
EPAPADGAALEHSEEDGSIYEMADDPDVWVR	ARHGEF10L
MHKEEHEVAVLGAPPSTILPR	IFITM1
ATEVPVSWESFNNGDCFILDLGNNIHQWCGSDSNR	GSN
YTSDKDVPSEQNNYSR	CWC22
DLSMIVLLPNEINGLQKLEEK	SERPINB3
STTTGPEAAPKPSAK	EPS8L1
SLDFGDVPIDSDVHVSSTR	PRUNE2
FGHGQTPAAFLSALLPSQPPPAAVNALGLPK	PALLD
SNGAYNIFANDRESIENLAK	NID1
MSVPGRPAGEEPLAQPPSPR	WDFY4
VTFGGGTK	IGKJ4
TVLTGTKDTVCSGVTGAVNLAK	PLIN4
ASQPEAASLGPEMTILFAHR	SH3RF2
KVSPWETSTSSFFPILAPAVGSYLTPTAR	PARP4
HVLSTSGLQSDAREPGEESQK	MYLK3
GSGLRGPLSRFYSGSPTSYFTSGLQAGLK	RAVER1
DKVPSLTTYEGGDLNNTLEDLR	SYNE2
HSASQEGQDTIRAHPGSSR	FLG
TLQLAVAINQEPPDPK	DOCK8
CLAENAGDVAFVKDVTVLQNTDGNNNDAWAKDLK	LTF
GNYDAAKRGPGGVWAAEAISDAR	SAA1
DKNFNLPQLCIWK	GBP3
ENITSDSLLTTSMASESTVK	WDR44
IKMVAVGICR	ADH1B
ALGFEAAESSLSK	BPIFB1
GEPREPWVEQEGPEYWDRETQK	HLA-C
TSPCALSSATLK	GOLGA8A
LEGANVQEAQK	SUCLG2
LCFKENAEQGEVDVESHR	CD99
LAQGHTTVDELAWR	PLEC
DHPLTCDHPQLSGLFL	LHB
GSLPILYQFHHEDAALER	FCRL5
RDITYQYKYPEGSSEER	TGM4
MVHLTPKEKSAVTALWGK	HBB
TYGRHEGQYLRPGEDER	LAMC3
WPGSETEVPPPGPAR	FAM185A
DLCGCYSVSSVLSGCAEPWNHGK	IGHA2
SAGVLLLVVDPCNVPFR	CEMIP2
ASYAQQPTESR	HSPG2
SHACGYSNSSGCGRPQNASSSSQSHR	FLG2
GGPPPAAAAQAQVQGASFR	TDRP
LHTLQEVNNNVR	GGA3
RGTDECAIESVAVAATPIPK	CTSC
EHDVQNTFEEMEKHLGR	CBR4
FLIHEQQELWAQDLNK	PLCG2
ELNESLQVAER	CLU
IKEQTVPITSHLMELGLTAAK	SMG1
RMDSLNWDQPISSTQESGR	C6orf47
LQEQHLSSPQGVQLDR	BCL2L13
SFLDVPAELQPEPLEPQQPEAQSGASEPGSGDAK	PPP1R3G
VTISVETSK	IGHV4-59
EVTEFYVQNENSVDTWGKRLVIDK	ACAD11
NNYNYVIWAK	FRZB
VLLTCWDPEENKMAPCEFGVLNNLANVLSQHLNQK	HLA-DMB
ILEFVGHSLPEETVDFMVQHTSFK	SULT1A1
TPDWYNPER	LY75
LVSNSWAQAVLPPPPK	TTC22
RTVALQEGLRR	FTCD
QIQEAYEK	AGMAT
WNETFQKEVLGSRLETTQLLAK	SDR39U1
EVQQGEEFERRIGQPTLLLYVDAGPQTMTQR	AK1
SAAEIVQEIENIEK	RAD18
TEDSNAGNSGGNVLAPDSTKGSLKQNR	GOLGA3
EHSVPSEK	TRDN
GAIQFVTHYQQSSTQR	SEC23B
MVWDSQVSEHFFEYKK	CHID1
GASIPFQFRPENEEDILVVTTQEEVEEIEQHNK	CALCOCO2
EGQGEGETQEAAAAAAAAAR	EPPK1
KLDSVFEEPLSKK	MMP9
KEDLRPSAPQQEGVASK	SNCG
SYCFTASKPDGSIR	ALG8
QVQGGLTVFGMGQPSLLGFR	PALD1
GLNEDELLDFAALTEGHPLDVR	MOCS1
LALSPNAQILALASGSSIHLYNTR	TBL2
IFEKPVLGALTTPGEK	TACC2
ELKEAPQGAHFLAR	DHFR2
GGTSREGGQTAPASSR	GSN
LLASTASSSSPASVMVAKEDRN	PDE11A
DKLGPELPLAMDRFPYVALSK	ALPP
YSAQADITDDSLDR	MAP1A
ALLMKNCNGGAINCTNVQISDSPFR	PPA2
LGELTMTDATPDSLSLSWMVPEGQFDHFLVQYRNGDGQPK	TNXB
IIMATDLDSEDK	FREM2
PGSSGPGSAGSWNSGSSGTGSTGNQNPGSPR	FGA
SCATEEQYKGTER	NPC1
SQVIEKFEALDIEKAEHMETNAVGPSQSSDTR	MPRIP
VIAETEER	EPPK1
LLISAASTLQSGVPSR	IGKV1-27
LAGPPAVATSAAAAAAASYPALR	GRSF1
GIGGIFFDDLDSPSKEEVFCFVQSCAR	CPOX
QAIDDDCNQTGQMTAGFLDWPQGTFASQVMLEGDKLKVER	ETFB
EEAAQQQQAEEK	MON2
ASDYYSQQMAQR	GBP6
KYAYWYQQKPGQAPVLVIYK	IGLV3-16
QQSAPEVAVNGHR	EPS8L1
SFFSLTEIIR	CR1
FYLGGPTSVR	SAMM50
CLAVYQAGAR	APOE
LGPELPLAMDRFPYVALSK	ALPP
VETGILRPGMGVTFAPVNITTEVK	EEF1A2
HSSWSEEEEHGYSSGHSR	FLG2
VSWENPSPQEAPAAESAESSQAPCSETSEAAPR	PLEKHO2
NNLFMSSAGYR	COL6A3
AGSLDTYVQCFVLPDDSR	SYTL1
LVNSLYPDGSKPLKVPENPPSMVFK	TAGLN
LLRDPADATEAHESSSRGEAGAPGEEDIQGPTK	CHGB
TSIKRDTVNPLYDETLR	SYTL4
GEESYCICGSER	PZP
SNSKPADGPSDSKSPDHSPTEQDDR	FMN1
EQLLELPEQEEGHLK	IVL
AAAGDLGGDHLAFSCDVAKEHDVQNTFEEMEK	CBR4
EIPENLMDQYNEVNAISTACSNGVPECEEMVSGLFK	ANPEP
SSSYSGEYGSGGGK	ZG16
KAEGAQNQDK	RRBP1
ALSCQTLAAGYYHTECVSGCVCPNGLMDDGR	MUC2
LPDDLEDLK	LAMA3
FLILPDAEAQLDREGDAGPETSTAVEK	TMEM128
LTGSSAQEAASGVALGEAPDHSYESLRVTSAQK	ECH1
GGGGDSGDPGRPDPEAESPR	ABR
GFCQVNVVDHPGPPVGPVSFDEVTK	TTN
LTAVLLAK	DCTN2
AEHMETNAVGPSQSSDTR	MPRIP
SFQGPVLIGSSHGGVNIEDVAAETPEAIIKEPIDIEEGIK	SUCLA2
AAYSYRPGPGPAAGAALPDQSFLWNVFQR	PDCD6
GTAAAAAAAAAAAAAAAKVPAKK	RPL14
ILEAAGGQILIDGVDIASIGLHDLR	ABCC2
ASRSVSSNLAWYQQKPGQAPR	
TCSLSYVAGAPQYK	ITGAE
AEQQQQQQQQQQQQHQHQQQQQQQQQQQQQQQQHLSR	ATXN1
GQNDEENIQETSQVK	MACROD2
LMIYDVSNRPSGVPDR	IGLV2-18
TGGAEITGYYVNYREVIDGVPGK	MYOM1
MSLPLGIYR	SLAIN1
RLEQNLSGEEHVQELLKEK	GOLGA1
RYKGIVDCIVR	SLC25A6
QIVGYAIGTQQATPGPAYSGR	CEACAM5,CEACAM3
LNSHMDALHLGSQANR	G6PD
GDSEPTPGCSGLGPDGVR	TSEN15
IKNEPVVFPEGPEISEELK	CAMKK1
LPEGSIAIK	ITGA8
LHMDHNNIEFINPEVFDGLNFLR	IGSF10
GTAAAAAAAAAAAAAAAAKVPAK	RPL14
QHEDQSMTGHLQEELEEK	GOLGA4
MVQQPTESEPVTINIQDLLSCSNFAVQHR	MATN2
DLSMIVLLPNEINGLQK	SERPINB3
SRPSFHPVSDELVNCVNKR	CTSB
ETATQPLPLYDTPYEPEEDGATPEGEGAPWPR	SHF
AAEPQGEPGGGGGGGGGGR	RAB11FIP5
CTLDPDTSDQTDNLTEQAVEFCQR	ACSBG1
NQVVLTMTNMDPVDTGTYYCAR	IGHV2-70
GVALSNVVHK	SERPINB5
NKYEDEINR	KRT7
ADSGVHLCVIDDSNEHMLTVWDWQR	EML4
EQFMENHNPINSATSLSNIISIETPNTAPSSK	RWDD4
DVPGFLQQSQSSGPGQPAVWHR	PSMD13
ALFSQISSAVSLR	LAMA5
YKSDSDNQQGSGVPSR	
AGSGVRQVTSTASTFVKPIFSR	NDUFA6
IPVTVITGYLGAGK	CBWD2
SIAATDHEPTDAR	ENPEP
LVLSTFSNIREELGHLQNDLTSLENDKMR	POF1B
ELTDKEAER	COBLL1
VDSDSSKPPETLTNPPGVCQEK	PRRC2C
VAEILTGSNLNDGLWHLVSINAR	CNTNAP5
GHVFLQTDQPIYNPGQR	C4B,C4A
NYSGTPPPALHEGPSLHLQAGDTVELLK	VAV3
PGQSPQLLIYEVSNR	IGKV2D-29
VHTVMLPPASETFPPGMPCWVTGWGDVDNDEPLPPPFPLK	TPSAB1
EKLHSLTQAKEESEK	RRBP1
PLPTTEWLR	TTN
EVGAGGCCHALPATGILAFPK	GPRIN2
AGGSGPPQQQQQQQAVARPGR	CACNA1A
FNSVTELCAEIPEQK	GALNT4
AVLTINEKGTEAAGAMFLEAIPMSIPPEVK	SERPINA1
HVWSHHTLPITDLHCGFGGPLAR	WDR18
SQGSQAELHALPQLK	PPP2R5A
GFYPSDIAMEWESSGQPENNYK	IGHG3
LQWFQNHLDPPK	TMA16
EQTVGGVNYFFDVEVGR	CST4
TTDLSIQLPSADLEVQAGQVDVK	AHNAK2
NLVQLYKNEDDTEISKK	NAALADL2
QTATLTCTGNSNNAGNQGAAWLQQHQGHPPK	IGLV10-54
FTPPQPAEPWNFVK	CES1
SLKYNPVVINFEMQPIHEVLR	C8A
MQHSLAGQTYAVPLIQPDLRR	WASHC1
SSAGDRHGSHHQQSADSSR	FLG
LVVGQNGILSTPAVSCIIR	PGM1
DSQIYAVDYETLTRPFSGR	MRPS34
GVESSGQPENNYKTTPPMLDSDGSFFLYSK	IGHG3
VVVLPSGALQISGLQPGDIGIYR	DCC
EAVSFALSQK	IGHMBP2
KMPYTDQPAKLPEGSIAIK	ITGA8
CLSLQAEHAGVR	PLEKHA6
LQNSEPSAPLAGLEK	SALL1
TALALLDHPSEYAAR	ANXA13
LHVGCDEVYYLGEGEASRR	HEXD
TTAKDIQQTEQTIEQR	SYNE1
AVPVWDVLVSGYVSGAAR	EPPK1
HTDFEEREYVVLIR	CDH17
ETFGVNNTVYGIDAMNPSSR	EIF3J
DPADATEAHESSSR	CHGB
VIIEMDALSELDMLQAEALQDSLR	IL1RL1
FQDVLPYDDAR	PTPN21
VQPPPTTQLLLPGSER	ARHGEF37
EKFWLAANSWGK	TINAG
EILSVDCSTNHPSQAK	CLU
IHVLVEPDHFK	LGALS3
INENIAAASSTLFSSPVNLSTSGR	BAZ2B
DSCKGDSGGPLVCK	TPSAB1
ANLQEEEGSHEDFSQLLR	SYNE3
DPDGNKLDLVCDAMR	ELP1
ESPGALVETSAGEEAR	RAB3IL1
ITYEELPAIITIEDAVK	XDH
QPTGFSLNNPMYVR	PPP1R32
SSESSPNHSLHNEVADDSHLEK	KIDINS220
KGEVPPEEQGPSIK	UNC13A
ASGVGLPGGANYQER	LDB3
EDALPTRPK	FOXJ3
EVNTSGFAPARPPPQPGSTTFWAWSVLR	IGHD
GHQHQEEESETEEDEEDTPGHK	FLG2
IQTPDALNDALEK	DAPL1
CPGKPAQASPSSSSSSSAPELLGGPSVFLFPPKPK	IGHG3
EQQSHLSSIVTPEEQEFVNNNAQEYQWIGLNDR	ACAN
WFDVDFPSPGPQGGDK	MUC5AC
SGSSLYQVSTHEQSDSAHGR	FLG
SHSAHFFEFLTKELALALGQDR	DDTL
LSVFSTIDAPVAPSDK	PITRM1
HIYNREEYVR	HLA-DQB1
MEVMALVPPADCR	GAMT
QKLTAEFEEAQTSACLLQEELEK	RRBP1
ALLEGESNPEIVIWAEHIENMPSEFR	SYNM
IDGYIISYREEEQPADR	TTN
AVTELGRPDEEYWNSQKDFLEDR	HLA-DRB1
CGCYVEDTHYPPGASVPTEEICK	MUC2
VYGLQSELQYK	NRAP
SEVTELRRVFQGLEIELQSQLSMK	KRT16
NPDGGPLESSSDLAALSPLTSSGHQEK	MAVS
LLVIDLMNDSSGNQTEK	SAGE1
GANIIAGVWLEEAGQK	PLEC
RPAAGGDRELLQWLER	INSL3
HSTIVLDTNDKESPTASKPCSPENESSPSSPK	ARHGAP12
DLAGYLQELDKDHAR	FUT6
YGCQYYSHAR	LILRB2
PLPLPQGLR	IFITM1
SKANGGTTDYAAPVK	
CIYNQEESVRFDSDVGEYR	HLA-DRB1,HLA-DRB5
EQEGTESTTDEGQLPQVVEELRDVQVAPGTR	OBSCN
GIETGSEDMEILPNGLAFISSGLK	PON1
GLEWVALISYDGSDKYYADSVK	
QSVQAGELLFVVPR	SETD6
TYGAQEDGSVGEGDLSCILK	LPCAT1
LFCQTLEDILADAPESQNNCR	STING1
APTTQGTPQTPKDDPAITLLNNR	CNNM1
AAESPDQKDTEGGPKEEESPV	SLC16A1
LETTNEVTDSDFETR	CLEC18B,CLEC18A
KQPFEDVTNPLQIMYSVSQGHRPVINEESLPYDTPHR	RIPK2
VVEYLLPADKEESAPAPGHQQAQK	PLIN1
DSVGVSGNLSLPTTEEFEDDAIR	CASP1
NYTSMYDKNNLLTNK	GDA
CQGSSVSQDSDSQGHSEDSER	FLG
MYIQAAIVR	CUL2
SLNDITAR	ATP5PO
VLWLDEIQQAVDEANVDEDRAK	IQGAP2
LMKEGLEAAQLK	BHMT
VTLEYRPVIDKTLNEADCATIPPAIR	SDHA
GGRAEIGVIEGDK	AVIL
TRSWDSSSPVDHPEPEAASPTTR	ZC3HC1
YDNFAHRTEVQK	NIPSNAP3A
ELETPLAVPGLR	COL7A1
KAEGVALTNATGVVESTSQAGDR	PACSIN1
IGTAEVEKPAGLLFQQPNLDSALQIAR	TACC2
RIQQHLGEEASPR	ARHGEF40
FSQALQSGDSPPLSFSQTNVQMSSTVIK	ADGRF5
KAVLDEAVVVLQAAFR	IQCE
LRDGDSNSTLEEHSEGK	HTT
LDYDGAILDVDEDDVEK	MYO18A
IVMEEGCLTQK	POLR1B
MAEQPQVELFVK	CLIC1
NSTLSEPGSGRGPPQEEEEEEDEEEEATK	HDGF
STEGMDIVMDNLK	WDFY4
GPFKYAWVLDK	EEF1A2
VYGSLFHINHGDPFNMEVLVDSWPEYQMVIIRPQK	GLYATL1B
KRVEFVTFVPAPPAQSPEEPVGAPAVQSILVAGEEDIR	TMEM132A
GTNGAPAYSIYGRPR	ODF3B
LITEAFSVSQER	H1-6
GESPVEPAEPCR	CD27
DAWVRDINK	PLEK
DISNDAFTALDPLGDKEIK	DAB2
EAVAVFMEHSFKDENHEFQK	GBP4
ESAARGPTIL	TSKU
KGDVKPLAEQISITAGCK	CES1
GGISDHSAFLFVR	MYOM2
DAEEWFHAK	KRT13
ASQSLDGTYQGGGVCIDCQHHTAGVNCER	LAMA5
VPGFADDPTELACQVVDTK	PTGFRN
MYYSAVDPTK	CP
DGERPSGIPER	IGLV3-22
LTIVDTVGFGDQLNK	SEPTIN11
SEDMAVYYCAR	IGHV1-3
FSFAAPSSEDDVFIPTVR	AHNAK2
YGDNNHSQGINWFHWK	TNC
VSCKASGGTFSSYVISWVR	IGHV1-69D
DGVIGLNPLPDVQVNDLR	SLC38A10
QCLQLSTVPGAEPQR	C2orf69
ELSEPMEFQYLPNTDDRHR	RELA
FTSVPDSMGMMLAQHNTK	NEB
AVMDAAVFLAK	MTMR6
EESIEAVK	NES
MNTEPERK	BLVRA
VDLNLPNIGIK	MVK
ANLSSQALR	ITIH1
YFSTSVSR	HLA-A
SALGNLAGDNSLGLEPLR	RNF130
RGAPAGAGSGTQTGTGTGAR	PTPN18
ITQGQPLEVAFGSQITLR	POMT1
VAVPHTPGLCTSLPDPVK	ELAPOR1
MRAPADPAPAPADPASPQHQPAGPAPLLSTPAPEAR	PNPLA2
KAEALIQQEHADQAEIR	IFIT2
SETAPAAPAAAPPAEKVPVK	H1-2
GAVALSGDHSALESQIR	SYNE1
SRLETMNQCWESVLQK	MACF1
VIDGMTVVHSIELQATDGHDRPLTSCSIINSGK	PPIC
AYAQQLADWVR	PACSIN3
IREEIVHFGIK	SEPTIN4
SDSHFQASHTGCQSPLCSAQR	C17orf80
SKSEMSCIDGEK	SORBS1
LQEAGILSAEELQQLAQGHTTVDELAR	PLEC
RDVEQLEQLIESHDVAFLLMDTR	ATG7
HHEASSWANSSR	FLG
YQAVASNSK	ERLIN1
SLFHPEQLLSRKEDAANNYAR	TUBAL3
TEPEEVFIEDSAQSDLK	IFI16
LLNLLADLVER	ALDH1B1
SEEAVQVLMK	ANKRD44
SELPLDPLPLPTEEGNPLLK	SLC1A5
CMANKVMEDPGQGSSMAR	C10orf71
LSGLIYEETRGVLK	H4C6
LADSSSVPHDSQVAEGPSVDTRPK	JSRP1
IQFMCGEDASNVMPVIFGK	DOCK8
VPSFETAEGIGAELKAPLK	SLC30A9
LVATSLEGKFHVFDVR	WDR92
KTPMTNYTTVR	SULT1A1,SULT1A2
LQGLEADCVRGPDGVCLSGDRGPQGDK	PBXIP1
NSSAGGQGSYVPLLR	LSR
QLQEETPSGGPLTEALPPARK	NDUFB9
SDEHVVSGNLVTPLPVILGHEAAGIVESVEGVTTVKPGDK	ADH1C
TVEHGFPHQPSALGYSPSLHILAIGTR	LLGL2
DSPVLHICESK	SVIL
TSIECLPELIHACGGK	ASCC3
DRYWMHFCGGSLIHPQWVLTAAHCLGPDVK	TPSAB1
SALSGHLETLILGLLK	ANXA2
FSVPVQHFCGGNPSTPIQVR	CPNE1
TRGDSQPAEAGEAAAGK	KIF26B
AGGHCGSVPAAAAGSGEIVQLNVGGTR	KCTD3
RGKSQQQQQQQQQQQQQQQQQQPMPR	NCOR2
AAPSTAPAEATLPKPGEAEAPPK	BAG3
AAGGPGPEQEASFTVTVPPSEGSSYR	HSPG2
AGVLADDHLIEVNGENVEDASHEK	PDZK1
FGAFHSLALEDADFDGKPMVLVAGQYSTGK	EHD2
LHEIGHER	PPFIA1
AQDTLAQLQETLELIDHMQCGVTPTAPARPGK	PLIN5
AEDEENEKETAVSTEDDSHHKAEK	SPARCL1
DSILLLEDVTWK	PDPR
DILTIDISR	ECM1
LKQEYFVVASTLQDIIR	PYGB
QGSSVSQDSDSQGHSEDSERR	FLG
EGQGEGETQEAAAAAAR	EPPK1
ASHSISTYLNWYQQKPGK	IGKV1-39
TDPPSADAGTDYVGISCNLDFAPGVNMQPVR	FREM2
TQVNTQAEQLRR	APOA4
AFGAGADFVMLGGMFSGHTECAGEVIER	GMPR
FYMQIFQLSNEQTKTLMFFEGCPQHLGCTIK	PIKFYVE
QNPGLAYGNPYSGIQESSSASPLSIKK	CALCOCO2
GPYEMSPSLLDYLTMDIYAFPAGHASR	PLPP7
SYIEVSHGLGHVPQQNGFSGASETANIQR	SYNPO2
WLKDEELSPREPVLPPQK	NDUFB6
KRNTLSLAMLK	ECHDC3
LLSMTLSPDLHTR	TBCD
RGLVQDETELEDENQEGMTVHSSVHSNNLNSMPAAEK	MIA3
LAQMVDDGAFTAGLAQVSFDKLK	HEATR5A
SEDGTPAEDGTPAATGGSQPPSLGR	MYBBP1A
STHGLAILGPENPKIAKDPSWIIR	PITRM1
EVISQLTQVHGTSSPYK	ERVW-1
ILSPSGGKPK	GLYAT
GVAGSSVAVLCPYNR	PIGR
GPGGENRDAEAQR	PROB1
TQPEPESLGPETPGFPEQEEDELHR	SLC4A2
LLEDDENSQCK	LDHC
GCATQPCHHGALCVPQGPDPNGFR	CRB2
DSIRTMEEGAETPVYLALLPPDATEPQGQLVHDK	CBR3
ENMDFSISISNITPADAGTYYCVK	SIRPA
NRVGASSKLDSSPVLSPGNK	MINK1
HASSGSFLSSANEHLK	GLRX3
QVGEIQSQEGK	TCHH
EIPPDWDQQPVK	PDIA2
ENINVEEMFNCITELVLR	RAB35
TEYLCENALEGK	VEZT
VLWLDEIQQAVDDANVDEDR	IQGAP2
DSMFQNLLIVK	CFAP77
AGNTIHAILLYR	CPT1A
FKFTVGDHSR	WDR1
VEGLLGCKPEVTIECTGAEASIQAGIYATR	SORD
GAVALSGDHSALESQIRQLGK	SYNE1
LDLTGGTFEDNLR	B3GNTL1
RFVVDVWR	TCIRG1
IHPTATHHITNEGVPASLPCVASGVPAPTITWTK	HMCN2
TVALQEGLR	FTCD
GTDARPYTGK	AARS1
RLGSANGQAEDGGSSTGPPR	ARHGEF18
FFGSLPDSWAR	HTATIP2
GERVDGNRQIVGYAIGTQQATPGPAYSGR	CEACAM5,CEACAM3
MEPEPAEPLAAAVEAANGAEQTRVNK	SMTN
FNHTAIPK	MYOZ3
SKTTEIIHSTLNPTWDQTIIFDEVEIFGEPQTVLQNPPK	MYOF
LQNEAESVTGMLNEAEGK	MYH11
MQSLQPVVSCGWLAPSPNGQK	SUSD2
LFSILSTALLR	DNAAF5
MEMPSTPQQLQNLTEDTR	LAMB1
DNAKNTVYLQMNSLR	IGHV3-74
LCASGAGATADTAIEEIKEK	NUBP1
QEVPMCTDSEPR	FAM120B
QCGQVAAAAAAAQPPASHGPER	BAG3
SLEICHPQQR	ACOT9
GVTCEDVNECEVFPGICPNGR	FBN2
IDGITIHQSLAIIEYLEETRPTPR	GSTZ1
YEDEINRR	KRT7
LGEPAGESVENQEVQSK	SPEN
AAEPQGEPGGGGGGGGGGRGGSSVWLEPR	RAB11FIP5
DTSMSTAYMEISSLR	IGHV1OR21-1
ICPSCRETAVDGELVVLYDVK	ITIH2
ASQSISTWLAWYQQK	
ADSQDAGQETEKEGEDPQASAQDETPITSAK	AKAP12
FVCNPLGSTHPEATLK	LRBA
EDEGLYTVR	MYOM3
GFGSYHPSAYSPFHFQPSAASLTANLR	PARP4
KLQGIPPSGPAGELK	NUCB2
GYMTKFPTFPSWLGK	RFC1
LLDDAMADDK	GLOD4
RTLPTQGIDDFLK	CYP4F11
IVGSPFDPTTEQGPQIDKK	ALDH1A2
RVYGDIIYTPAK	ALDH5A1
GSLAEMAGLQVGR	PREX1
SALIGCLSSGSPAPR	HMCN1
QNPGLAYGNPYSGIQESSSASPLSIK	CALCOCO2
DQAANLMANHGDHCR	DMD
NYTSMYDK	GDA
VMIPLSSIPTYSAAMDSNSFLK	ZHX3
TMDFPTPAAAFCSPLAR	NFU1
TVNNLILTGPR	DEPTOR
FQTATVTEK	PSMB4
ASEIHMPGPVCLIENTK	GBP7
VTYLVHNFEEGGGIAMGMYNQDK	IDH1
VLQDNLDKLQALADALLEK	SPG7
GGDGGERDEDGDALAEREAAGTEWDPGASPR	FAM241A
LHVTLYDCSFGR	PLXNB2
ESGIDPSQVGVHPSPGAR	APBA3
KFDFQGTCNYVLATTGCLGVSTQGLTPFTVTTKNENR	FCGBP
SAVQGPPDR	IGHA1,IGHA2
DLGSEADFADDENSTAGESESHR	SCN5A
LSCAASGFTFSSSWMHWVR	IGHV3-74
ETPLSLPAK	C6orf132
GHDQLAYDGKDYIALNEDLR	HLA-C
LLIYSASSLQSGVPSR	IGKV1D-37,IGKV1-37
AAPSALGALTCHHTFGGWGTLVNPTGLALCPK	NHLRC1
RYEEEEEEEEDEEEMEEEK	KRI1
ALASYVAACQAAGVVIK	FCGBP
GRPMPEITWSREEGEFTDK	TTN
YQLEKEDTVEVLAIDNTSVR	MMUT
DLHQEAETYR	GOLGA4
LLNLLADLVERDR	ALDH1B1
QAFMGEQEKLDVHEK	MDM1
LGQTPFDVADEGLVEHLQLLQK	PPP1R12B
KLESQAGICLGDSQGTSER	USP34
IAAHPSVQK	UTRN
EKLCYVALDFEQEMATTASSSSLEK	POTEJ,POTEI,POTEE
ETQPEIGSSQESGDAALK	TXLNB
EHLVQAMPENLQEAR	ITIH3
EGTPGSPSETPGPR	OGFR
ADGENPDILTHCEHDSNSQASDSPDICHDSEAKEETEK	PRUNE2
CPAPELWGGPSVFLFPPKPK	IGHG3
RATVEQEMELR	ATAD3A
ALLPKNTAPDNGPILLQAQTTQR	TBL3
DFHFVYRPLDGGGGGGGSPPCLVVR	RIN3
ACNVLQSSHLEDYPFDAEY	AKR1B10
GRPLVCFLNEPYLQVDFHTEMK	CLC
GFGTDEQAIIDCLGSCSNK	ANXA11
HTSEEWGECGFRPTVFR	GPAM
EPWVEQEGPEYWDR	HLA-C
EFYVYFLKDEDYLKDTVENLETQSK	HAUS3
ITGSIANGTDGFVINLGQGTDKLNLHFNPR	LGALS2
RASQSLDGTYQGGGVCIDCQHHTAGVNCER	LAMA5
NEVQIHSGSFQSQVELSNDQEK	APOB
LEELDLGNNEICNLPESIGALLHLK	LRRC1
LSEIQETSEQAQSK	FKBP15
AFYPASLSPPAAGTAAGLPTALLR	FOXD2
NTLYLQINSLR	IGHV3-53
DAAVGTLVQMR	KANK1
CVSTNMCIPASFHCDEESDCPDRSDEFGCMPPKVVTPPR	HSPG2
VSRPESEQLR	LSM14A
VVSVLTILHQDWLNGKEYK	IGHG4
SAGGRPGSGPQLGSGR	GIPC1
NQVSLTCLVKGFYPSDIAMEWESSGQPENNYK	IGHG3
TVAPPVAGPSVFLFPPKPK	
YGMTEIGMALSGPLTTAMR	ACSF3
DGDSNSTLEEHSEGK	HTT
SGNGEGTPVEHVR	CYFIP1
TFQVVPEIEFPPSLDIHQEIPQQEDQKK	PHACTR4
RNGMMEPDDFR	ACTN3
QTAASAGLVDAPAAAPAAAR	SYN2
CDPSTPVPASSAALNR	DCP1B
ELEREESGAAESPALVTPESEK	KTI12
DDSIPCFLEVK	PARP4
VQAQHDYMATDTDELQLK	BIN1
SGDRGETGPAGPTGPVGPVGAR	COL1A1
IGELEDESLNR	CEP70
NLPSLAEQGASDPPTVASR	LAD1
DIRGETLNHHVK	RDH13
MQHSLAGQTYAVPLIQPDLR	WASHC1
SQDCEILGESK	ABCD4
ECEPPSAGAAVSARPGQEIR	LNPK
RRPESSPVQK	MAP7D1
SETGLAGAPAR	AP3S1
QEEDMAVVQR	KANK3
NSLYLQMNSLRAEDTALYYCAR	IGHV3-20
ITVLGSNLGVQAGDIQR	PLXNB2
TPDIDVPKENITSDSLLTTSMASESTVK	WDR44
SEVCGGELALPPVPK	WNK2
QTEDSLASERNRLTSK	KTN1
VNDDIIVNWVNETLREAEK	LCP1
QYWEALGAPEALR	POLRMT
DVTVLQNTDGNNNDAWAK	LTF
VLEVDTQGTVVCSLDR	ICAM1
DSMFGITVK	ITGA6
MAHGYGEESEEERGLELGK	CHGB
RGPGGVWAAEAISDARENIQR	SAA1
KKPWPDSAGDQASPPGDAPPLEEQK	SIGLEC5
ENAEQGEVDVESHR	CD99
DAASGAEAPMQPGFPENLSK	ADO
AAYLDDLR	RABGGTA
TRPLEFAAMGDYLDTFALK	SNX30
DAGFHSEIFKR	MYOM3
YVVMDFVMDHPDYPFSDEY	AKR1C4
ELEAIFGRPVVDR	MAP2K2
YLDQIGNTTSSQR	LMO7
AAAAAAAAAPAAAATAATTAATTAATAAQ	SRP14
LAAAAQLPVRALQGGRQAPLR	SPATC1L
AEEINAKAEEEFNIEKGR	ATP6V1E2
TSAATSSTTSSSGTTPSPVTTTSTASVSK	MUC5AC
LEEECEGREPGLETGTQAADCKDAPLK	
SASEVDRMFPGVPLDTHDVFQYQEK	MMP9
PASQAKPESQPPAAEK	TCEAL5
MYALISDAQPLLLSTFSGDR	GPLD1
LSPDDASFVDAIHTFTR	LIPC
GSSAACNGLLTNHYVCEVDGQNVIGLK	SDCBP2
RSLRVEVDLLIGSSQDDGLINR	TG
EGQGEGETQEAAAAAAAR	EPPK1
YPEDLPITLPNLLR	TXNDC11
ELQTCLQALELGAAEK	FYCO1
QVFYGEEEQLK	PNPLA7
DRAEAYLIEQMYDEAIQDYETAQEHNENDQQIR	DNAJC3
GQQPHQGLR	ATL2
GCQLTITFSVPNEDVFQELEKR	KYNU
RDDDGTLHAACQVQPSATLDAAQPR	SOD3
ALGEDQVAETSAMSDALKDILK	C2CD2
CVDGHCVCNPGFTGEDCGSRR	TNXB
EPQVYTLPPSPEEMTK	IGHG4
SGCTPCSCDPR	AGRN
LKGELESSDQVREHTLHLEAELEK	RRBP1
VVSPFPLCQPAGEPSR	NCEH1
LTMSIEAR	CPN2
LRPVSTPGK	MOCOS
KFFGSLPDSWAR	HTATIP2
EQLQQEQALLEEIERHGEKVEECQR	PLEC
KDEGEGAAGAGDHQDPSLGAGEAASKESEPK	AKAP12
QQHEGAQGTLDSGEPPQCR	LSP1
KCLKNEYIENR	CMC2
ELPELEATAQLLPLEGPK	C11orf16
DTSISTAYMDLSR	
KLDDQSEDEALELEGPLITPGSGTAVLYIGPLK	FERMT2
TPEVTCVVVDVSHQDPEVQFKWYVDGVEVHNAK	IGHG3
EIVPVLVSTRR	ACAT2
LEQYEGPGFCGPLASGTGGPFTTCHAHVPPESFFK	FCGBP
GDSGGALLCAGVAQGIVSYGR	CMA1
FVDADFSDNVCSGNTSHSLNSPR	PLEKHG1
VMFVGGPNTRK	HAAO
QTLPVTLR	RGPD1
SVHWYQQKPGQAPVLVIYYDSDRPSGIPER	IGLV3-21
LKDVGGEAFYPLLEDDQSNLPHSNSNNELSAAAMLPLIIR	TBCK
LEAEGEAMEDAAAPGNDRGGTQEPAPVPAEPFDNTTYK	NDUFV3
NSSVCENCGYFQQLEGK	NT5C3B
ELLVPQHTVQLVGGLSPLSSPSDTK	ACIN1
QHNEDILQYKR	NDUFC1
GLVEPVNMVDNGDGTHTVTYTPSQEGPYMVSVK	FLNB
NLNQDQEHGR	SEMG2
GPGSPSVDSSSVMTVPRPSTPSR	FAM160A2
DRTQIAICPNNHEVHIYENSGAK	ARPC1B
IQPFDDEEDEDIWEDSDTR	PPP6R2
LSDLQEALDQALNHVRDAEDMNR	LAMA4
PPQGGNQSHGPPPHR	PRB4
YELYSETQR	LAMA5
ASGGTFSSYTISWVR	IGHV1-69,IGHV1-69D
AMQADISEAAQILSSDPSR	TMPO
ITYEELPAIITIEDAVKNNSFYGPELK	XDH
FTVGDHSR	WDR1
TVFPRELAVEAMK	FBLIM1
PQVQIHVQSQTQPVSLANTQPR	ZYX
EAGPGPGPLNVGLHLNPLESIQLELDSVNAEADR	TSPYL6
LQQGPTCHLAVR	OBSCN
ILGAFMQIITFR	LPO
WGAAPYQGRPK	PGLYRP2
ETLLNHFLYEVAR	AFM
VEGNTVHIEVK	EIF5B
TISEGNPSPR	ARSB
LREENDLGPAGMVDSSQGQGYLEEK	SLC52A3
PLPNVVTLQEDITTER	FTSJ3
KPSEEEAAAAAGGPPGGPQVNPIPVTDEVV	CYBA
KFDFQGTCNYVLATTGCLGVSTQGLTPFTVTTK	FCGBP
SAGILILPIMSR	GPCPD1
DGLHSVVDDDLDTEHR	FAM20C
VSLLFEDDVDSR	WASHC2A
VVFPSEEVVEQK	MRM3
LAAMVDITTEELKQQFNQEIK	IRAK4
MGFTNVGPNNQPVSFQEIFEAKR	SEPTIN14
EGAIISGDSPVATNKLDQEVQEETQGR	CD33
QEELESTVAR	SYNE2
LHQLAYDTYQEFEEAYIPKEQK	GH1
ELSEGIVDEGASTSIGPHSIDDSNLNHGNR	ZNF318
YVNPGNEAVSGHITIYPSWGAAQSK	LAMA3
LKLTIVDTVGFGDQLNK	SEPTIN11
ETLQLIDSTTSYGLTGAVFSQDKDVVQEATK	ALDH4A1
SVMDTTQIAGLNCLR	HSPA4
EGHALASDVDYR	NEB
GFSQEELETCMINQAPGCPDYSILSFTGAFHGR	ABAT
SEIPLQEQNYPAVDSPPSGGGWAGWGSWGK	FAM114A1
KKPSEEEAAAAAGGPPGGPQVNPIPVTDEVV	CYBA
LVPSRDQTLQEELAR	ACTN3
GLEWVSAIGTAGDTYYPGSVK	IGHV3-13
AQVSPPASDMLHMR	PI16
CLCDPGYTGPTCATHMCPADCR	TNXB
TLDAFPAEKESEWK	CPPED1
EVACLETLVR	NUMA1
DIEIGFLPWLTNEVEK	RSPH3
LIDIFYPGDQQSVTFGIK	ALDH18A1
YGVNRLEEMLRPLVEEGLR	ALAD
SYHYTDSLLQRENEWNLFSR	SYNM
MDALATSINQFALELSK	SERPINB10
ESIENLAK	NID1
LPEEVATPTTDEEEDSLIAIDR	POLR1A
DQNQQCSYIPGSLDNYQTAR	KCNMB1
EAQNTCAMLTTYNEIDMSNIQEMR	DLST
CSQHVCLVRPELIEQVNK	TINAG
DEELSPREPVLPPQK	NDUFB6
LRSDAVESAAQKTSEDLER	SLC7A6OS
HTQTSSSGQAASSHEQARSSAGER	FLG
GIFAVQVDENRR	LAMA2
GYGSLEIQGSDPSEWEDCSFDNR	MYO9A
DPSFFSNPQDFNPQHFLDEK	CYP2A6
SVQELKKYFELEPLAR	ARL15
GQEEISGALPVASPASLR	MTRR
SLSPQDEK	RNF213
KLISEVDGDGDGEISFQEFLTAAR	CALML5
DTGHFKVLQNEDVFTLVLK	MYLK
HWDFNIIDKDTSSSR	PLBD1
SEGALQVLYGEVGSLDGTPQTR	KANK3
KLEMDLKDLEAHVDSANK	MYH9
PVTSGPISGTHLR	MYOM3
RFQTIDIEPDIEALLSQGLSCA	GPX1
LTSQMQATLQQASQQVLASEAR	LAMC3
DKNNKEPTIEDILNLESSPTASGSSVSPGLYSK	FERMT1
SSQALAFESSAGIFVGNAGATGLER	COL15A1
LDHCLQEASPCYK	GHDC
HLTAQVCSLEAQVAHADQQLR	NUMA1
NEDDTEISK	NAALADL2
NAYSLEIR	TTN
GASDRDAASGAEAPMQPGFPENLSK	ADO
HLSQSSLLLEHLLSSWQQIPK	TMEM214
MEIHEDPK	MYBPC2
NLPSLAEQGASDPPTVASRLPPVTLQVK	LAD1
SLSETCLPNGINGIK	STEAP2
QLQEMLGLSKVPVTQATR	SEC23A
AGPDAVTHDNEWEMLSPQPVQK	PRUNE2
GALINVPSPFLGLPR	VARS1
SNGGNLLCAVDESNDHMFSVWDWAK	EML2
FLENEHQELQAK	TRAF3IP3
AAAGLPLVPR	RGMA
AVQCQHLEAPNEGTMDCVHPLTAFAYGSSCK	SELP
FQEEADSVSQTLVK	EVPL
HKLENGLAALSPSSK	ARHGEF40
SGYFLSISDSQCLLNNALPVK	ADGRG6
APSVSAKPGPALWPLPLSVK	HEXB
AVTELGRPSAEYWNSQK	HLA-DRB1,HLA-DRB5
ASDTAMYYCVR	IGHV5-51
ELPSEQQEQWEAFVAGPLAETNKK	PPP6R1
TNHIQALAHSTVGQTLPIPLK	GCKR
ACLGSLHELESEPVIQVTVGSAK	STON1
DQQVTEISFSMSEK	GOLGB1
NAINSPMSPALADVHPEDTQLEENEER	PARVB
DGDEVCESNVSNSITSGEK	AKAP5
GRAPLTYSLEK	MYOM3
SEYSSGMEADVAK	DDX31
LSEIQETSEQAQSKFKSEK	FKBP15
YEQEHSAIQDK	CHCHD6
IYFGGLPTLSNLSMK	LAMA2
KMYELAGK	CHD1L
TLAIELASR	DHRS4
ELDVDSIIAEIK	KRT82
PQGPPQQGGHPPPPQGRPQGPPQQGGHPCPPR	PRH2
LYAESYERNPSGHDQEPQAVLSPLIAIALK	PGM5
CDEPLNILVR	ISG15
LAKEEGWLAEHMLVLGITNPEGEKK	PCK1
FLEENADPSASEIR	POLR1A
SSESDHFSCVQLR	CLMN
SSMSPTTNVLLSPLSVATALSALSLGAEQR	SERPINF1
VETMTLDLALLR	WWOX
LLNKVELMLPEK	MPC2
SLAAYTAACEAAGVAVKPWR	FCGBP
RAVPPNNSNAAEDDLPTVELQGLVPR	F13A1
EIPELEEEK	PRUNE2
IFEEDPAVGAIVLTGGDK	ECHS1
TGEVVLTQSPGTLSLSPGER	
TTPIEAASSGAR	HCLS1
LPQEQSQLPNPSEASTTFPESHLR	IFI16
SIKASVDVSPPKVEADMSLPSMQGDLK	AHNAK2
TAVHNGLGEK	NADK
ADLEAQVEYLK	KRT32
KPQYEQLTAAGQGILSRPGEDPSLHGIVK	DST
QGTLTEYCGTLMSLPTK	NCF1
GTAHYHSLPAQDNLVLKR	NRAP
LSGDRNPLHIDPNFASLAGFDKPILHGLCTFGFSAR	HSD17B4
HGAGVAMDGQDIQLPLLK	VWF
MGTPVLEALGDGEFVK	PCK1
YQDTASTLSGSQDTFR	NPIPB5
RLSSVSGPSPEPPPLDGSPGPK	CASKIN2
YTYDDFKK	PTPRJ
EEPVSSGPEEAAGK	NOP56
DVSQSSLDGASNNPHGLQEAQSTSTSATAASHTR	MAGEB10
MPEVAVPEVRLPEVQLPK	PRX
LEKQGAAGSPGGPR	SMTN
CDVNVGEWTMCTPPTGINK	TTN
SMSMDETDKSPCEAGR	COBLL1
ATSYAELCNEYRK	SPINK5
YAYNVSLK	EIF2B5
EEIGAVSSK	TRDN
SSNTYTLMDVR	ALCAM
TCSNDVVDYFKR	NSUN5
GVAGSSVAVLCPYNRK	PIGR
MDDPTEQCQDPVPEPPR	MUC5AC
TLSEDELKEIPAEQMDFR	MYLK
DHRPQMVWDSQVSEHFFEYK	CHID1
THNEDHEEEDLKPNPDLEVGK	SCN7A
SSPGLYTSPGQDSLQPTAMSPPYGGDISPVSPSR	SYNPO
LSAASGYSDVTDSK	DTX2
TEETATEMLTSELQTQAHMIK	AKAP12
NAYEECLEHLETFK	MYH7
EDLRPSAPQQEGVASK	SNCG
MEPEPAEPLAAAVEVANGAEQTR	SMTN
KSCCSCCPVDCAK	MT1E
MIQVFNQLK	FAM186A
DLTGFPGPLNDQDDEDCINRHNVYINGITYTPVSSTNEK	A2M
NAVDLVYRAEDHATEFQR	LAMA1
TTSQAQTEVPLDDPDR	ABCC6
TVMIPGPQLKPEEEYEEAQVEAQKPQLA	MRPL45
QTFIDNTDSVVK	IQGAP2
SDPLCILLQDVGGGSWAELGR	CPNE1
FPVIVGHEATGIVESIGEAVTTVKPGDK	ADH7
FPTDTLQELLDVHAACER	GBP6
IDVVVNNAGILRDHSFAR	HSD17B4
DLEAHVDSANKNR	MYH9
CSGLLQVIFSPLEEEVK	GBP1
LSGVLYQQHSQALGK	GHRL
LSETPGTK	ARHGAP21
ASSESQIFELNKR	MLPH
SPLGPHHETAQQLEVLEQQSTSLGQDAR	LAMA5
VEGDMQVPDVDIKGPK	AHNAK
ALEDVFDALEGK	CPT2
EQALQEAMEQLEELELERK	SWAP70
NCNGGAINCTNVQISDSPFR	PPA2
EGQGEGETQEATAAAR	EPPK1
NVFLPKPTWGNHTPIFR	GOT2
RTGFSFPAQEPRPQTQNLGTPGPALSHSR	SORBS3
GSCGIGGSIGGGSSR	KRT16
RWLLLCNPGLANTIVEK	PYGB
GATYSSEIPKEDSTTFAK	LMO7
VGPTDGTPESQVELRPR	PIEZO1
IQKLAGCVGSCLYSQLQK	TPSAB1
AQVPGHQPEATNLIPVAVK	ADCK2
ALRETLLAQPAAGQATIPEWCQGSAPSGLEGELLR	MDN1
VGTASENVYVNTAHLK	CTSC
LVVGQNGILSTPAVSCIIRK	PGM1
TSYETTDKVLQNK	CAPN7
PGQAPVLVIYDDSDRPSGIPER	IGLV3-21
IAGMDPVVHSALR	PANK4
DMVTQASLYLFEATGK	CLCA1
IIEYGSPEELLQIPGPFYFMAK	ABCC2
DKDVEDEQEHYISDDLDIETK	HORMAD1
ASSESQGLGAGAR	MLPH
LKEEEFCSFQINEFPWEDKISILNYK	CST5
NTLSLAMLK	ECHDC3
QTGQAYYVILLNR	LAMA2
TSEDASEYYENYIEELKK	PARP4
KFNELMVMFR	COQ7
TTTAPGTATSVK	MUC5AC
EELGHLQNDLTSLENDK	POF1B
GTAAAAAAAAAAAAKVPAKK	RPL14
YLENYYDLEK	MMP3
EIGHKNPSAMAVESFTATAPFVQIGR	TMEM43
GMLEPVQRPDVVLVGAGYR	HSPG2
IYSLNEGYAKDFDPAVTEYIQR	FBP1
NTKLELQDPGQVEK	MX2
VEGDLKGPEVDIRGPK	AHNAK
QELPSALESHEVPGTLSMGVPQIFK	ZNF24
TPAPLQHLNTLLDGTYK	BBS9
ENGQLAGSLGPCIR	CD99
ATISIPVDMVSISAAK	NEB
ESVHTQTPPEHPLGQR	ADAM15
VYIHHMSPTGGTDINGVLQR	ITIH5
HFHNQEELLRFDSDVGEFR	HLA-DRB1
VDIKGPQVDIK	AHNAK2
RPLSVHPGEDAAQLLAK	LAMA5
VTTPDMSTTQHNK	PRG4
SLGNIIMVCRK	CFH
YVSLIYTNYEAGK	GSTP1
EQPWEMVMDK	STARD7
GPGSDSSLFATYNVELVR	PATJ
GHEVNLEALPK	GSDMA
NTLYQMNSLRAEDTAVYYCAR	IGHV3-53
NSGEEEIDSLQSMVQELRK	ARHGAP25
EDIPVDYMK	HEXA
LEVYPTSLTKNDLEDSLLK	UGT2B15
KQQPNPGSELCYK	TTLL12
CRPCDCHEAGTVPGVCDPLTGQCYCK	LAMA5
DYLMSTHFWGPVANWGIPIAAINDMK	MPC1
LGGPGNSFHTPPR	IDUA
LTPEDLSDDVFK	DMGDH
CVDGQCICHEGFTGLDCGQHSCPSDCNNLGQCISGR	TNC
QLELPEQQEGQLK	IVL
VLDSPSAPVNLTVR	TTN
SVLRPSQFGGQPCTEPLVAFQPCIPSK	C6
MVSGAYRQEFGQSK	MMUT
CGPPPPIDNGDITSFPLSVYAPASSVEYQCQNLYELEGNK	CFH,CFHR1
AGLENSLAKTECR	KRT15
VAVTQAAEVAVATMEPVAR	SMTN
DYPDFNPSVDAEAIQK	ANXA3
ELAGGNFTSPDASASSCGK	PPP1R9A
VAQIQTDYDALKR	CEP135
DLEAEHVEVEDTTLSR	BOLA2B
ILGATLLK	FAM90A26
DDDLNSFNATDLK	LTA4H
VPETVSAATQTVK	TP53BP1
IPPGDLVFDPDQRGDVVLPFQR	DUOX2
LGAVYTEGGFVEGINK	CEL
DTVYSGVTSAVNVAK	PLIN4
LLRDPADATEAHESSSR	CHGB
TASGAAEGWDRGQASMAEVAAAR	GPSM1
ADFDDRVSNEEK	CAPZA1
AQTLGAVVPPGDSVR	PML
EITPPFKPAVAQPDDTFYFDTEFTSR	RPS6KA1
ASPLLAIGQTLAR	FAM207A
GSGIGGGIGGGSSR	KRT16
DRAPELLGGPSVFLFPPKPK	IGHG3
IYTSGSTNYNPSLKSR	IGHV4-31,IGHV4-4,IGHV4-61,IGHV4-59
EAFLEQMMGLEGAVK	LAMC3
DTVCSGVTGAAK	PLIN4
THTAQDRPPAEGDDRFSESILTYVAHTSALTYPPGPR	PTPRN2
ADISQEVEEVLAESR	SLC2A9
HGSHHQLQSAESSR	FLG
LSCAASGFTFSNYAMHWVR	IGHV3-30
ATLELTHNWGTEDDATQSYHNGNSDPR	GLO1
VIRNQSLVNELAFTAR	ECH1
EPSDTSAAFESTAK	NCOA7
GLVQDETELEDENQEGMTVHSSVHSNNLNSMPAAEK	MIA3
SIHQPDPTAVEQISLESVDMDSPVNMK	FBN2
ADNSVPGTPTRK	PDE5A
VAVTSSSSSSSSSSIPSAEKVPTTK	MPRIP
DGTTHQTSLELFMYLNKVAGK	ASS1
DVWGLEGCYPK	MUC5AC
LSEGSQPAEEEEDQETPSK	ACIN1
TLSTDSIQYHLQMQDK	FNDC3A
ADDAGMETPLCSEQFGSGEAR	RUSF1
HGGPLPYYR	AOC3
TQWLEVDTRR	AEBP1
RYEQEHSAIQDK	CHCHD6
CECQSGYEFADDR	NID2
FTYDQDSEPIQTFHFQAPTMATYQVVELR	SUN2
QQQMVVAHHYSFAPDGEAR	TNS3
NPSSSMPRPSAGSVK	LMO7
IMDYYETNSQCSEPGIVFITK	CCL14
LTQAQIFDYSEIPNFPR	PNP
EVVQGSSAPAASSPTWK	CRYBG2
ELEIGQNCLELELGQSR	TJAP1
EEQEVAMLGAPHNPAPPTSTVIHIR	IFITM2
EIFSACAQSVHEYLR	GRK5
APSPLYSVEFSEEPFGVIVHRQLDGR	GAA
GCVLDVCMGGGDHDILCK	FCGBP
QQPNPGSELCYK	TTLL12
PGVTSLTTAAAFKPVGSTGVIK	PDLIM5
VTSTNNMAYNKAPRPFGSVFSPK	PDLIM5
EQALQEAMEQLEELELER	SWAP70
DELEEGAPSEAMLR	PCSK1
GHDGEDDEGEEEEEEEEEEEEEASTEYGHQAHR	HRC
VQGIGWYLDEKK	FTCD
GYSGSQATDSEGHSEDSDTQSVSAQGK	FLG
LPWVCEEGAGIPTVLQGHINCGSLLGYR	SERINC2
EYWQVCTMLK	VNN2
SYGLPDGQVITIGNER	POTEJ
AVDVLSELSFAPMTPDHFPSLFCK	PDPR
AFSEYLGTDQSK	ESD
KQLYWELSQLTHGIK	MUC16
IILFLPCISQK	STEAP2
GLEWIGYIYYSGRANYNPSLK	IGHV4-59
NPPVWVHASPEHVVVTR	ITIH4
NAAGHGSSGGGGGNTQDECAEYQEQMK	SPINK5
YEVPVPLNIPSMPSSTPQGQLYDVLIKK	MGAM
IGAAIQEELGYNCQTGGVIAEVLR	NOP56
EAPILKEFKEEGEEMPR	ACIN1
AKLPDATPK	GC
KQPFCDGSHFFQCTGLSPLK	CISD3
RSGASGASAAPAASAAAALAPSATR	CENPV
KQIDQFASEVER	BDH2
LMEHGIIQHVSSK	DEPTOR
GFGHIWLDSVSCQGHEPAVWQCK	CD163
GYNQFAYDGKDYIALNEDLSSWTAADTAAQITQR	HLA-B
GAPPSPEAGFATADHSGQERETEK	COPRS
YTAIPIVGQVFQSQCK	MTTP
GTEAAGAMFLEAIPMSIPPEVKFNKPFVFLMIDQNTK	SERPINA1
NLHMAEAPANLEQPTSSFHVGTCFANAQRGTYFDGTGFAK	LAMA2
GPHDGPSQPTGPR	BSN
GGTLSTPQTGSENDALYEYLR	CLEC3B
VHCQIVGVQTVER	SPEF2
ALIDMYIEGIADLGEMILLLPFTQPEEQDAK	GSTA2
EVEQWFATQTEKLNK	KRT34
LLLAHPACNSSLTDK	KANK4
ATSEDTLNLR	WDFY4
FSQPELSEHPQK	PRAM1
TEITGATTVTSVGHQSMTPGEK	OVGP1
NVIAETIKGQTGAILQNTVESLSK	BCL2L15
AAPQNGGSSEPPAAPR	ZFPM1
EHTLHLEAELEKHMAAASAECQNYAK	RRBP1
ERADEPQWSLYPSNSQVSEEVKTR	CHGB
DDDGTLHAACQVQPSATLDAAQPR	SOD3
LCNNPAPQFGGK	THBS1
LSCAASGFTVSSNYTSWVR	
EKSNDILEEGEKNLGNIK	TRMT1L
AIDCLEDEK	SYNM
HIYNREEYAR	HLA-DQB1
LAEDPAEPR	KCNJ11
HHEASSWADSSRHSQAVQGQSEGSR	FLG
DLCPLLSEHGLQCSLEPHLNSNLCVYCCK	
EDTGLLTTTHGPEEAPR	PLIN4
ANNAGGGLPAAGPGDR	CEP131
NSLYLQINSLR	IGHV3-48
QRLEVIADK	PALM3
HWVLSISWSPDGKK	NLE1
EFCTMVSTTELQK	PARP4
PASQAKPESQPQAAEK	TCEAL5
MNVEGIHCDR	LAMA2
CHLGPGEQAGPGLHRPPSPR	MUC1
LQNMSSGENKPSCICGGENVVENAHTEFPTVTENR	ADPRHL1
EPQVYTLTPSREEMTK	IGHG2
QPFCDGSHFFQCTGLSPLK	CISD3
EQLGEFYEALNCLCIPR	ORM2
ITGSIANGTDGFVINLGQGTDK	LGALS2
SLCACSDDCKDQGDCCINYSSVCQGEK	ENPP1
TEALNHHNLLICSVTDFYPSQIK	HLA-DQB1
LLEEALLCLLPAELPAKR	PRKDC
EEENFTCR	ENGASE
ASTEIVGK	SLCO1B1
TSPLGTQLVLGPGNSALLGCPIK	ADAMTSL1
GVACVVPGTLEIEGRK	NRAP
ILGVGPDDPDLVQAR	LSS
RSDFASNCCSINSPPLYCDSEIDAELK	GC
QEHSQGTTTFAVTSILR	IGHA2
DGEGPVREATVK	SUMF2
FSVAGPGPNKPGSGEASAR	PERM1
QTLPEDNEEPPALPPRTLEGLQVEEEPVYK	HCLS1
KDEGEGAAGAGDHQDPSLGAGEAASK	AKAP12
CLAGYYGDPIIGSGDHCRPCPCPDGPNSGR	LAMB1
ELLLDGDYLQR	RSPH3
IDWGDDQFYSTSLK	IGHV2-70D
AHRLHQLAYDTYQEFEEAYIPKEQK	GH1
GTGVQSEGTWESQRQDSDALPSPELLPQDQDK	ITPKB
STSGGTAALCLVK	IGHG1
TFKPALQELKPPTYK	MRPS22
RMDPFSTKEHIEIIAPSPQR	EIF2AK3
VDNALQSGNSQESVTEQDSKDSTYSLSNTLTLSK	IGKC
KAQPHYSNPLVAVK	ATP4B
VKLEQQVDDLEGSLEQQKK	MYH6
ISLKEENVCEENSPVDQSDFFYEFSK	TUT7
NHPVPVIAMVNGLATAAGCQLVASCNIAVASDK	ECHDC3
VLEMTGNIDETEWEWK	BCHE
WQQGNIFSCSVMHEALHNHYTQK	IGHG3,IGHG4,IGHG2
EAEGAPQMEAGK	CALD1
DLEAHVDSANKNRDEAIK	MYH9
LSSTDQQESCSSTPGLEEPLFK	GOLGB1
MEPEPAEPLAAAVEVANGAEQTRVNK	SMTN
STVLSNGEAAMQSSNSESK	DDX18
AEVCHTCGAAFQEDDVIVLNGTK	RTF2
APVIRPGGTLGLSEAADSDAR	TNKS1BP1
SMKLPQEQSQLPNPSEASTTFPESHLR	IFI16
QKGCEENLDEAR	ADD1
QALDNMFSNK	GKN2
LKEEEFCSFQINEFPWEDK	CST5
KEIPENSAVDQEA	OVGP1
EYQELMNAR	KRT84
KPTSTDGPGQDAPGAESAGEPR	RSPH1
LIDAETTAGAWPNVAAVSITGRK	TKFC
QLSLVASVLLAQGDRNKEVR	AP5Z1
LLNEKEQELR	MTRF1L
SEQLCNEEK	LRRC17
IREPLTAQQLEMTTER	CC2D1A
DGLEFMQHSETLWK	TTC38
SYGGDSTGGTPR	PAPLN
TEGDSSATAIFPQTHK	ANK2
SDASSDQGPASPQK	UHRF1BP1
EVSQPDWMPPPEVTLVLTK	PDIA4
ETVLNALK	POM121
VAMLEENGECVLMEGK	NUDCD3
WHELMLDKAPMLK	ASAH1
IASSYYPEGDGDSSHLLAK	DLG5
NTQEKFNLSQESSYIATQYSLRPR	LBR
HIDCAAIYGSEPEIGEALKEDVGPGK	AKR1A1
ALDSNSLENDDLSAPGGEPGDFNPESREDTRGGNEK	LRRFIP1
SPEPSHLK	TTN
AEEEFFDIIFTELK	DNAI2
AARPPPAASATPTAQPLPQPPAPR	SCAF1
QGCGEDKICQSNLQLVHAR	ITGA7
HPAGQQLDEFLQLAVDKVEAGLDSGPCR	MMS19
AEGAQNQGRK	RRBP1
NSLYLQMNSLRTEDTTLYYCAK	IGHV3-43
KDEEDALPVLQEEIK	SPEF2
GKDLSMIVLLPNEINGLQKLEEK	SERPINB3
MWICPGGGGGGGGGGGGGGGGGGDR	NOTCH2NLC
FAVTNQIGPVKEDSDPTLVNPCYDGSHMCDTTAR	NID2
IILGGIYNADLNDEWVQR	CST1
HSGTGQGQASSAVR	FLG
AQLNVGNVLPVGTMPEGTIVCCLEEK	RPL8
GGPGQLGFEGEQGTR	COL6A3
GGGAGGGGGAASGPAAGTPSAPGPR	YBX2
YRSEALPTDLPTPSAPDLTEPK	PRKCSH
LIDAETTAGAWPNVAAVSITGR	TKFC
SDPVTLNVLYGPDGPTISPSK	CEACAM6
VHSRAPSPLYSVEFSEEPFGVIVHR	GAA
MTLDLNDENDAGNLITFPK	STK31
EAGFPPGVVNIITGYGPTAGAAIAQHMDVDK	ALDH1B1
LIHNLNVILAK	LRPAP1
PSFHPVSDELVNYVNKR	CTSB
RVLQEGSVEAR	CCDC124
TADGEFMAVGAIEPHFYELLIK	AMACR
SLTEEMALGEPAAAAAALLGGEEI	DKK3
SLDVLGWEER	PANK4
AETEKPANQKEPTTCHTTVK	RBM19
VQANAPLIKPPAHTSAILTVLR	PRR16
EPGYTPPGAGNQNPPGMHPVTGPK	LPP
APQMPDSHR	SYNPO2
WETLNDAGFTTANNIAK	CINP
AGSHTAQNSDVFVPESDRSDYNCTGGTEVLANSNRK	SETX
RLAAETGEGEGEPLSR	DIDO1
EACDVGPCTTAWFHSDWSSK	ADAMTSL4
GGCSIKMEPEPAEPLAAAVEVANGAEQTRVNK	SMTN
ALFSQISSAVSLRR	LAMA5
MVGCTGKVIGIDHIKELVDDSINNVR	PCMT1
VQAQYPGVYINNEVVEPSAEQIAK	HNMT
IAAAPAGSR	TANC1
QAPDQDPGGPR	DUS2
DVEQLEQLIESHDVAFLLMDTR	ATG7
GYHQDAYDGK	HLA-B
EIPENSAVDQEA	OVGP1
AFAKLPPNVLR	ECI2
QLGQDLLNSYTENEGK	HSPA4L
FSVAGPGPNKPGSGQASAR	PERM1
FPPEEALYTLWQHNK	CPZ
NYHVEVLIPPSISKDDPLGEVGVK	HMCN2
TVYFAEEVQCEGDSFHK	CSRP1
DNGQAPFTITPVFSDFPVR	NPC1
VMQVVDEK	ASAH1
SLGNIIMVCR	CFH
VAVTSSSSSSSSSSIPSAEK	MPRIP
SNFLVVCYLHDVK	PREP
RSPEAPQPVLAMEEPAVPAPLPK	HCLS1
QLLQENEVQFLDKGDENTVVDLGSKR	FGL1
GLASPTAITPVASAICGK	SVIL
SLPEETVDFMVQHTSFK	SULT1A1
QNADQQDTEAMPDYKK	SPATA18
HGTDDGVVWMNWKGSWYSMKK	FGB
GCGLEDVPVSQPCGEGIAPTPEDPLQPSCR	AHNAK2
QLAAGWGPCEVLLSNALSR	MAN2B1
VILQPIEGIMGSDYINANYVDGYRR	PTPRS
DRLPFEEKLEVENVMK	SVIL
IIRDDMLCAGNSQR	TPSAB1
AEEAPEQSASVEVPSSNVQQHQK	ZNF773
GEQGEDSSEEK	CHGB
KHTDSVAELGEQIDNLQR	MYH3
LEQDLSIIQSIQRPDAEGATEHR	CUX1
GDENTVVDLGSK	FGL1
PTLLHLTHGK	MTTP
KGCAGVITLNRPK	HIBCH
LTAIIEEAEEAPGAWPQLQDAWR	EPPK1
GKEMVDYVANYMEGIEGR	DDC
SEGLPSDDLSIENALVIIQSR	DYNC2H1
EFDINQQNSKIEDEQALALQLQK	MYH6
IKPLKLPQGLPTEENMSNTCLK	MRPL30
SEDYEQAAAHIHR	COG4
RFQEALQTIFNR	MYO1D
FQEALQTIFNR	MYO1D
ESQGSDGFEESGTLLK	INTU
AGNPETVPTTPGPAADPATPETPAPAAR	FAM110C
GSLEEYEDTPWSDQRPR	ZC3H3
SVGGSEHSPQWSPNGVLLSPEDEEELTAPGK	LAMC3
QVEILNRHPHFK	EPHX1
SVPCESNEVNETMPETPTGDSDPQPAPK	SPANXC
GHDQLAYDGK	HLA-C
LVNSLYPDGSKPLK	TAGLN
GHNGLQGLPGIAGHHGDQGAPGSMGPAGPR	COL1A2
GSDVIIVGR	UMPS
LAVISNFDRRLEGILEGLGLR	HDHD3
MYYSAVDPTKDIFTGLIGPMKICK	CP
CLAGYYGDPIIGSGDHCRPCPCPDGPNSGRQFAR	LAMB1
SDIIIIAIHR	STEAP4
GATYNIIVEALKDQQR	FN1
TSELPPLK	PTGR1
QKLTAEFEEAQTSACLLQEELEKLR	RRBP1
TPESFLGPNAALVDLDSLVSRPGPTLPGAK	
QWECDGENDCHDQSDEAPKNPHCTSPEHK	LRP1
AEWYRDDLLLK	MYOM2
LQSYFAACEDETPAIR	PLEKHM2
AQQEQAAHQATLRK	TACC2
VAKNEVLWHPTLNLPLSPQGTVR	TAPBPL
LQELTPSSGDPGEHDPASTHK	TRIM25
FQVDLQNGSSVKPR	LGALS8
METFAPTELPELLK	PRIM1
TITLEVELSDTIDNVK	RPS27AP5
VLMEDDDLYSCVVENPISQGR	HEPACAM
YVCDCSGTGYIGR	NRXN1
DYLASHPFDTGMTLGQGMSR	ITIH5
GDCGDTLAATQSLVMK	SPTA1
YLDQIGNTTSSQRR	LMO7
MVDFAGMK	COMT
ELMTEVCK	MYOM1
NTVLQQVLEGR	GSDME
CPAAPPPPAGGAANNHGAGSGAGGR	GSPT1
LENNMLMLPSVQPQDAGTYVCTATNR	HSPG2
VQSGSESVIQEYVDLRTR	PLEC
FNEVSSQQAAIQAYEDTVR	AIFM2
APTGEPGGVGSQPDDGDSPRNPHDSTGAPETRPDGR	SDHAF1
SQEAEQKDVIQER	MDM1
SVEEYANCHLAR	TF
EWQELDDTEK	PSMD2
PAGISPLSLSTEAR	CRTC1
GSESPRPNPPHAAPTGSQEPGR	TBC1D1
GSYGSGGGSYGSGGGGGGHGSYGSGSSSGGYR	KRT1
QLQSLTCNLESLR	GFAP
DVASLSSQIQDTQELLQEETRQKLNVSTK	MYH11
MEPEPAEPLAAAVEAANGAEQTR	SMTN
QPAGKGLEWIGR	IGHV4-31,IGHV4-4,IGHV4-61,IGHV4-59
QSLEPEVPAPTEQEVPAPTEQEVPALTAPR	PRR33
KAFITNFSMNIDGMTYPGIIK	ITIH4
QTAASAGLVDAPAAAPAAARK	SYN2
SSVSEQFDHLSSHLYLR	SPG11
LSSFYYHEAGVTALSQDPQR	ANKLE2
NANSQEDAEELK	JCAD
PGGSEPPAAFTGDTLFVAGCGK	HAGH
EDELTFTK	PLCG1
SFVHPKPGAAGTVGAGLIPISSELCYR	PREX1
RPPGPASQSLWGNPTR	SKIV2L
STCNVVHDEFLDIPCTNR	DLC1
EGSEDAGNLPEAQEK	SH3BGR
AHPVQSEFPSAQEPGSAASLDLPEMEILLTK	TRARG1
RGGAGPSAITS	PLSCR3
AALVDQSGVLLAFADQPIKK	FGGY
HSQSGQGQSAGPSTSRNQGSSVSQDSDSQGHSEDSER	FLG
TASDTSTEAYNLLLR	LAMC1
EPGDQGPAHPPGADMSR	MRPS2
DLHDDNEDEEMLETADGESMNTEESNQGSTPSDQQQNK	PPP1R2B
LLEPHCFPLSLVPTEFCPSPPALKDGFVQDEGPMFPVGK	C7
VSRPESEQLRNDNK	LSM14A
EQEQVRATSQGGDLMSDLFNK	WASHC1,WASH6P
VHDRSEEEEEEEEEQPR	DCAF8
NPDSHYGELIEK	CMPK1
LTITSPEMTFPGER	UNC45A
AVTASNDEDLLIAGEFR	COBL
SHTLELSEALR	PCNT
ALAQVFCEESGSSPLLQK	SCFD2
YIYNRQEYAR	HLA-DPB1
ITSNQNQDTQEK	PATJ
TNGKPEEKNHEAGTSGCSIDAK	CEP170
SFQGPVLIGSSHGGVNIEDVAAETPEAIIK	SUCLA2
KKHTDSVAELGEQIDNLQR	MYH3
LQVYDLPGILAQLSK	COX10
MDVENEQILNVNPADPDNLSDSLFSGDEENAGTEEVK	PDCD4
LQPEESTETVDSSYVVGHVLNSR	SPICE1
HSVSQEGQDTIRGHPGSSR	FLG
SVQWCTVSQPEATK	LTF
ITTTTSEEPCR	TBX3
KKNEPEDEEEEEEEEDDEEEEDEDEE	HMGB2
LENGLAALSPSSK	ARHGEF40
SEETVPEAASPPPPQGQPYFDRFSEDNPEYMR	ADD2
LANSEGTSDAWVDQFTRPVNTSALDTEFER	PEX5
AVTPQGRPVAEYWNSQK	HLA-DQB1
NNQQVPDNTEELGQTK	THUMPD1
YLFAVTGNGLVNQGNNPEVQVDTSKPDILILR	GPC4
DYALHAGDGSSDPEVLLNIENQR	SVIL
IADGVNEINTENMISSIEPEK	PTPN12
LPDTALPTLQNGAAVTDLAWDPFNPHR	CORO7
FSGSGSGTDFTLTISSLK	IGKV3OR2-268
ASGFEFSQVLALSGAGQQHGSIYWK	XYLB
ESGHSNWLADPEEPLTGFSWR	ATL3
QEVPTCSDPEPR	FAM120B
VVQETVLVQER	EPB41L3
SDITVVVFFIMPAK	GYS2
IALLLMASQEPQR	VWF
TEGPSPALLEETPLEPAAGPK	TACC2
AEVTAHEVAVSLPSVEVDIQAPGAK	AHNAK2
FWRPEEPIEVIRPDIAALVR	GPX8
LKTEKAPQDQVDIAVQELLQLK	EPRS1
GTNGAPAYSIYGR	ODF3B
GKDLSMIVLLPNEINGLQK	SERPINB3
NPNNPNAHGNFLK	DNAJC10
FFQQRLDHFNFQR	DPP7
DVDDPMVSQGLWCLK	A2ML1
QMPSGPTKPSEGPAK	LMOD1
SSQSLVHSDGNTYLNWFQQR	IGKV2-30,IGKV2D-30
RVSGEPQESGDGSLSPQAEAIEVAAGESAGR	CLIC6
LIKENQEAEKLEDDIR	TRIM22
HEAFESDLAAHQDRVEQIAAIAQELNELDYHNAVNVNDR	ACTN2
RGEEWNPQKAEEK	SPAG7
EQLDMAGAQVR	DCTN1
LSVADQEK	ENO3
SCCSCCPVDCAK	MT1E
ALGHGVDLGHIYGDNMER	PTGS1
AGTGLKGEEVEGAGWMPGREPTTHAEAQGNEGDGEEGLQR	AHNAK2
YDTPHDMFNVVAAK	NEB
EGMPAPFGDQSHPEPESWNAAQHCQQDR	ECM1
LSSPLHFVNTHFNGAGSPQDGVK	RETREG2
TLSEDELK	MYLK
GGPVQVLEDKELK	SELENBP1
FELLSEPQFGDLTSVTLMK	WDR55
VQQLDCREPFLSCCQFAESLRK	C4B
LEADVHGKPLPTTEWLRGDK	TTN
VFLTDTDPNENLSAQGEDEWPPLRK	LLGL2
DSGRGDSVSNSGSDALR	PDCD4
NILGAQVSEVVPLPEHGVSVVFVNLGNTK	MCEE
CLKNEYIENR	CMC2
QYDQFGNDKSQAAR	DNAJB12
QTMQSLNDR	KRT24
DSTYSLSNTLTLSK	IGKC
TKLEDYANLK	SPTA1
TEQVIMFLK	PPP6R2
KNPDIPQLEPSDYLK	EHHADH
GTAAAAAAAAAAAAAAAK	RPL14
KFFDMELENLER	STK10
TALDAFGRIDVVVNNAGILRDHSFAR	HSD17B4
NQDPNPPPQPEELTSSLHTFK	TNS3
SAVQGPPDRDLCGCYSVSSVLSGCAEPWNHGK	IGHA2
VLGTAGTEEGQK	CRYZ
DSEDVSERDSDK	AKAP12
AGTAFYIDQCAVHAATEGR	VWA8
NLLVENIINIYKQECSSRPLQK	TRIM63
QLTLQHHMGSADLNATFYGPIK	CUL3
VPVDAFQVGK	TPO
EYYAIGSLR	SAMD15
FYIPHVPVSFGPGGQLVR	SEC16B
QGYQLLEGNQVLHSFTAVCQDDGTWHR	C1R
DVTGSPRPGGDGEGDPNHIER	ITIH5
EEIGAVSSKK	TRDN
TLHEVSLQESIR	NAT10
EESSSGSSHAVMDISLPTGISANEDDLK	C5
ATSQGGDLMSDLFNK	WASHC1,WASH6P
KLGITPEGQSYLDQFR	WASHC4
EAFEEAGVLLLQPR	NUDT19
GHNQLAYDGKDYIALNEDLSSWTAADTAAQITQR	HLA-B
LAAQEGQFTEPRPEEPPQEK	MYO7B
AEAYLIEQMYDEAIQDYETAQEHNENDQQIR	DNAJC3
LEDEEEMNSELTAK	MYH6
LHWERPEPPGPYFYDLTVTSAHDQSLVLK	COL6A3
LPLALPPASQGCSSGGGGGGGGGSSAGGSGNSRPPR	HSPBP1
DVISNTSDVIGTYEAADVAQK	SLK
LNEGSSAMANGVEEK	SEPTIN9
GQMTDLYHYITSYVVDGQIIYGPAYSGR	PSG6
AVPPNNSNAAEDDLPTVELQGLVPR	F13A1
APPAPGPASGGCGEVDELFDVK	COPE
RSALENSEEHSAR	PXK
AAASHLFPFEKL	XPC
GSISFEELK	RNASEL
WTGTAPILQQYYNTK	TGM4
GLVEVTIQNLSEEDKGSYTAQLQDGK	MYOM3
TSTNHVSVSK	MUC5AC
MDVTQMEFPDASFQVVLDK	EEF1AKNMT
TIEGSSPADNRYSEYTEEFSK	MTMR6
VDHKGPQIDIK	AHNAK2
DPLSAVNAGNRLVRSHTSMYIEK	ZNF793
HPPQPQPQPQPQPQPQPEPEPSPWGPLDDVR	MMP24OS
ESAAHPEADGAPK	AKAP17A
VLIYGASSLQSGVPSR	
LENHVNDLK	SYNE2
EALELDSIR	ARL2
EEVDEDRDVDESSPR	MAPT
VCQPPPEILHGER	CR1
DYDSLVQPGFFDR	COL6A2
GLAGHFLDYLTR	RASAL1
GLQTGPVPPGRLAGPPAVATSAAAAAAASYPALR	GRSF1
IGLVTEGETCGNAEK	UROS
INQYPESNAEYLTHLVPGAHVVK	STEAP4
GYDQFAYDGK	HLA-C
YENESLQSGR	MKI67
QAEVVDTEWEKLNLHSADWQR	DMD
LGLDFPNGMLGSLLAQLSFPGFPSIQLPYLIDGAHK	GSTM1
AHLWELEQAR	CROCC2
LLDDAMSADKSDEWFAK	GLOD4
NEESLPFQNLPIEK	PRUNE2
VLLNDGGYYDPK	EMILIN1
ASEAEAPDKHGSSFVSLLK	CDKN2AIP
FVVAHGEDMR	METTL7B
QQSVESLAEEVKDKVPSLTTYEGGDLNNTLEDLR	SYNE2
YFSTSVSWPGR	HLA-C
HWDFNIIDK	PLBD1
EVPVYTYSEPR	FAM120B
LEPTLHLLGVQFDQNVAHGIITEKPGVATK	SPEF2
SAMSEIEGIQSLICRR	ARHGEF18
DEVNRLSGLQPQIER	DMD
SSTGPEPPAPTLLLAER	SRRM2
VSQGISSYLNWYQQK	IGKV1D-37
LSEIQETSEQAQSKFK	FKBP15
TSAGMFPGSQPQAPASPVLPARPPPPPLPR	LTBP4
LQSAGSAVPTSSSFK	CEP170
GPFTYISPSNTELTLMIQEQGDK	ADGRE5
AEDTAVYFCAK	
LVPDLLAIVQHK	HEATR1
LIYLEHSPNSEGAASHTGDSR	SPECC1
GGMGSGGLATGIAAGLAGMGGIQNEK	KRT18
GCPHVLGYEGPGDPASDEGDGLPGDRPR	RUNDC1
EYFGLQHDDNSVDSPR	PTPN3
LSCAASGFTFSSSAKHWVR	IGHV3-33
AEQQQQQQQQQQQQQQHQHQQQQQQQQQQQQQQQHLSR	ATXN1
LIQEQEQQLVGALAADLHK	ALDH3A1
NVVYSCNEGYSLIGNPVAR	C7
TLLNTGLEK	SPATA20
SAVDEDRKMYIQAAIVR	CUL2
EALLQALGEPGPYLLAGEGPLDKGESCGGGR	HNF1A
TAASGVEASSR	PDLIM1
VPLASQGLGPGSTVLLVVDKCDEPLNILVR	ISG15
VLGLSIVGK	PATJ
VKGDMDVSLPKVEGDMQVPDVDIK	AHNAK
NNLPTAISDWLYMK	FMO3
LLDTAFDLDIFK	OGDH
TAQAIKDFNR	ACACB
FIAVNGATAHPHYDPDGTAYNMGNSFGPYGFSYK	BCO2
KAEEAMEAQEVVEATPEGACTEPR	SURF6
TAYILQAVESAWEGVHR	ASCC2
EDAGVVCSEHQSWR	CD6
KQEEWGLTSTSVLK	R3HCC1
QGHVEQCECLGGR	HGFAC
ALFNYNPNEDK	MPP7
AEVQKLQALANEQAAAAHQLEK	KTN1
ESALEPGPVPEAPAGGPVHAVTVVTLLEK	CAVIN3
MDALATSINQFALELSKK	SERPINB10
DNPMSTPK	ADAM28
DYLMSTHFWGPVANWGIPIAAINDMKK	MPC1
RCDAEAPEDQCTVTR	LMBRD1
HSAYQDGQDTIRGHPGSSR	FLG
VEAAEQVR	KLK13
MVAVQNYHGNPAPPGKPVLTFQTGDVLELLR	VAV2
EPAIHSEGQWVTLPAPLDTINIHLR	GAA
QVHSDTGISSKAMGIMNSFVNDIFER	H2BC21
SQLMMPVSRPMGPVPNPQPIDPASLEEFK	PLVAP
HGYFDEEMNR	PLEC
GMDDDWGPR	EIF3A
RGPGGAWAAEVISDARENIQR	SAA1
VCLVGCGFSTGYGSAVNVAK	ADH1A
VFTTLVLCDKPLSQDPQNR	SKIV2L
AQQNLSWEEITKEYQNEEDSLGGSR	COQ5
DKLGLQILPVDGNPHK	CFAP251
SEALPTDLPTPSAPDLTEPK	PRKCSH
DSGHRGSSGSQATDSEGHSK	FLG
SPSEESAPATSPESVSGSVPSSGSSGR	RAD23A
TPEVTCVVVDVSHQDPEVQFK	IGHG3
KVPAQRLQEAGILSAEELQR	PLEC
IAAANGIGRLVVGQNGILSTPAVSCIIR	PGM1
VILQCNVFGSGTK	IGLJ6
SSEEAGFPGDPHEDKQ	PRR15
RNTLSLAMLK	ECHDC3
TSSSEDGSMGSFSEK	EMC1
LTGDCCFDYDR	SBSPON
SSGGPGAGLCLFPLDEVHAK	PLXNB2
QEQIQAMPLADSQAVREQLQQEQALLEEIER	PLEC
HGDVHFDHFHPCAALTTDHIER	DDX60
DRDGGMHSDPVSLNVLYGPDLPSIYPSFTYYR	PSG5
TNVLNHAYENLTR	SYNE2
CAGEIAMQADNHK	PCSK1
SDPLKDDPHVSSNVTSNDR	ERCC6
WIQHDHVYLDNMTAK	FASTKD1
EAYFSVGLQGIVEK	PITRM1
DGIAVDHVVGLNAEK	BOD1L1
QGTDLASR	TTN
FIQENVFVAANHNASPLSIK	UMPS
ERPLSAENPGGEPEAPGEGGPAPEPR	LONRF2
AEAPYLLVSNGHLPK	LRIG1
LLSDLLPPSTGTFQEAQSR	TLN1
TAQILNLQQHLSTLEK	SMC6
YPMEHGITNWDDMEK	POTEF
SPADPTDLGGQTSPR	SORBS3
HQDSGALVGFSCPGVQDSAALTIQESPVHILSPQDK	OBSL1
TMMNTWTLQR	ERAP1
VEANVSLPSMQGDLK	AHNAK2
ASQSVSGYLAWYQQRPGQAPR	IGKV3-11
MSKDALNLVQMQEQTLQLEQQSK	
YSQVVPAVTEGPIPEVLK	CTSD
ESDTEVITVEK	BCL2L13
EKEEETTRELLLPNWQGSGSHGLTIAQR	AHNAK
LDHCLQEASPHYK	GHDC
LLLTNDPLEAAHGGNVLITDTWISMGREEEK	OTC
HLAVLNGAMVSTPHYSPGLLIEK	MUC2
LLELEEHIR	HSD17B7
GEAGAPGEEDIQGPTNADTEK	CHGB
LIAASSRPNQASSEGQFVVLSSSQSEESDLGGGGK	APPL1
EHLPDEFIKDEQNKGLIDEITK	NMI
ETLIATCHFDAVK	CFAP52
KIDLTTIVKPEAPFDLSVIYR	IL7R
CICNQLSLTTK	SCRN1
LSCAASGFTFSTYGMHWVR	
LAAETGEGEGEPLSR	DIDO1
GMQGAPPQGSMLGPPQELR	WDR33
ANGYCFGAQEQR	GPN2
ADFSGMSAEK	SERPINB8
HNQVESIFLSAIDMYGHEFCPENLK	ACACB
EGATLVCGGNQVPRPGFFFEPTVFTGVEDHMFIAK	ALDH1L1
VTITCRASQSISGYLNWYQQRPGK	IGKV1D-39
LQDSDTDYGSGYPNDPK	RNASEH2A
SQEVVETMCPVPAAATSNVHTVK	KANK2
QTEHSPEDAACGPGHICSER	PJA2
AVHEEVRPVDFK	ZZEF1
IQPEDMFVYDINEKDISGPSPSK	APIP
KFSQPELSEHPQK	PRAM1
QINDLKSQNDALNEK	MTUS1
HQDCIEGATATLR	OBSCN
SALFAQINQGESITHALK	CAP1
ATFSSVPLVASISAVSLEVAQPGPSNRPR	HSPG2
ENAEQGEVNMESHRNANAEPAVQR	CD99
SFQIQIAHLDPENITLSGEGIFHQICLDLPR	HYDIN
TCQDIDECADSEACEARCK	GAS6
SSLWEAPR	AMACR
LQGTLAADKNEILFSEFNINYNNEPPMYR	THG1L
AVSMLEADHMPPSR	PKP2
LCASGAGATADTAIEEIK	NUBP1
SLRVEVDLLIGSSQDDGLINR	TG
IQTLDALNDTLEK	DAPL1
GGTFTDVFAQCPGGHVQVLK	OPLAH
TRNTMSLLAANNLLAGLRGELMPSELK	GRHPR
QVVSAVTALVEAAER	EPPK1
EEAAGPALALSLIEHYEPSETAK	PLCD1
SGEAGISNTSR	PHIP
VGSEKPGTTLPQPPPTTCPPGALQAPEAPASR	ZNF598
SQGAANTTSGENFDQSPLKR	DENND5B
HLLHLLLSPLEVR	MUC3A
SLLGKEGEKLYTPSGNIVPR	TMEM177
YLDKDTVYHLQPSGR	MAT1A
AIYHGSFSTK	COL6A3
MIGLEHPLIPVQHQYVVTSTIPEVK	DMGDH
KLCFKENAEQGEVNMESHR	CD99
STTQASSHTPGEPGR	C1orf116
ALEQQASTPPPPLLPGSSAEPPPPPPPPPLPSVGAK	INF2
SRPSFHPVSDELVNYVNKR	CTSB
EHTLHLEAELEK	RRBP1
DTCVQSPISSFPR	CRYBG1
KKQIDQFASEVER	BDH2
SSTTSTWELLDPR	CARS2
MVHLTPVEKSAVTALWGKVNVDEVGGEALGR	HBB
ENEWNLFSR	SYNM
VQAEREAVQSR	PLEC
TGAGEVNGDVGDEDLRPGYLNDIPR	KLHL41
KTEEEDVECEDDLILACQPESSVK	IMPACT
PSAEYWNSQK	HLA-DRB1,HLA-DRB5,HLA-DQB1
IGTTEVEKPAGLLFQQPDLDSALQIAR	TACC2
NQANACQQQQDAPVEGVAGEQR	SPTA1
LGMIVDKIDVDKDGFVTEGELK	CALU
RIGQPTLLLYVDAGPQTMTQR	AK1
MKDVNVENVNQHR	MTTP
DTLNFCFKERLQAVDLTNQPLDK	CCDC105
VVAPVESHVPESDQAQGESPAANEGTTVQHPEAPQEEK	SPEN
ESIGSLQDGTHTPSTAMETAIPFR	MTPAP
ISSSSQTPQILVK	AKAP9
RDTVNPLYDETLRYEIPESLLAQR	SYTL4
NTFGSGVTGAANVAK	PLIN4
KLSVADQEKVDK	ENO3
NWNGSVEILK	TGM3
RYEVPLETPR	GAA
TTATFTAK	TTN
EPSAPSIPTPAYQSLPAGGHAPTPPTPAPR	PDCD6IP
DITTGYDSSQPNK	PGM2L1
ALEWLARIDWDDDKYSTSLK	IGHV2-70
VGDFTPVSEK	GORASP2
AEEPGDGPAEEWLGR	SFT2D3
AAQLLDVR	HOMER3
NLGESPTGSADSAGIALR	CLCN2
VLDEHIQER	CEP57
SGQEFDVPIGAVVK	MYO7A
AELTSQELQISTYEEELAK	EPS15
GLETHIIALK	NAA25
TPEVTCVVVDVSHEDPEVQFNWYVDGMEVHNAK	IGHG2
ELYPGNYKPNITHYFLR	SIRT3
LQGQKEPGDQGPAHPPGADMSR	MRPS2
RHFIQDSCLECSPNLGPWIR	FOLR3
LLEEALLCLLPAELPAK	PRKDC
KDAMWIGFLTR	ASAH1
DNATLQATLLAAR	LAMA5
AKLDSAHLQGDLTLANKDVTTK	AHNAK2
VQLPTESLQELLDLHRDSEREAIEVFIR	GBP1
SPFEVYVDKSGDASK	FLNA
LAALALASSENSSSTPEECEETSEKPK	NOP56
DPGLEPGPDSPGGSSPLR	PIEZO1
AQLGNESSVDEVSFYANR	AKAP3
DSRPSQAAGDNQGDEVKEQTFSGGTSQDTK	THRAP3
AESLVGGAPGPR	C2CD4B
GTVSVTREDSPSEDPVFLR	PRKG1
KLEALIASNDNANK	DST
HNDLLSWFEDCK	C12orf29
AEILESVIK	MAGEA10
AILDAEPGPRPALQPSPSIHLPLDAPLPGSK	TBC1D10A
DVDGLTSINAGR	MTHFD1
VSCTYKEDEGLYTVR	MYOM3
EAVSSGVTGAMDMAK	PLIN4
GGTGPPGPEGGK	COL3A1
DTLMISRTPEVTCVVVDVSHQDPEVQFK	IGHG3
AAGEVDIGDAAYYFERDIK	TACSTD2
GISEDSHLESLQDVGQSAAPTFMISPETITGTGKK	MAP4
CESQSTLDPGADEAR	NPTX1
GVSMDECVLCAQAFGQR	FTCD
VPEPCPSTVTPGPAQQK	SPRR3
HARPPDSPASAPPDSSSNSASQDTK	TRIP10
QKLYEPVVIPVGR	NCF2
GFTGNTEGSMLK	CRYBG3
VMITLTDVNDNPPK	CDH11
AISPTQSTSSWQK	MUC5AC
HGSHHQQSANSSR	FLG
AEVCHTCGAAFQEDDVIVLNGTKEDVDVLK	RTF2
EQFCDYMFQQAVK	PELO
VTDTQEAECGGPPVPDPK	TTC1
TPPDPVNGMVHVITDIHVGSR	CR1
DPAGMPHPQTGK	PAPSS1
GLGVEVPGVGQAPGR	JMJD4
LAAQESSEAEDMSIPR	WASHC2C
AGTFPVNGPPRDSLAAASGVLGGPQTPLAPEEETQAR	FLVCR1
TLISITQAKPESESSFLCASSDGMLWNLAK	TEP1
FLESQMVIK	GBP6
AAAAPEASPSPGGDAAWSEAGPGPRPLAR	MSH6
RGHAGTADNEK	MYLK
SDEFGCMPPKVVTPPR	HSPG2
GRPMPEITWSR	TTN
EILQIMDK	PNPT1
AGDMAVYYCAR	IGHV3-13
DLTGFPGPLNDQDDEDCINR	A2M
DNDVLLHWAPVEEAGDSTQIIFSK	TBC1D17
QFEESQGRTSSK	TG
EENSGLLQELEELRKQAEK	CLIP1
AAECSDFPVPSTEGTPIQGSK	DST
NVVYPLYQLGGPQLR	MRPL23
ENPDSFLNHVLALTAQSPNIEHLNEVSLK	SYNE2
MAEGAQPQQPPQLGPGAAAR	RBFOX2
DQTLQEALAR	ACTN3
HSAYQDGQDTIR	FLG
TISAVGEQLLPTVK	SUN1
QLVASVSCAELEGQIAK	SYNE2
QSPGSPER	KRT13
EAMKDAVLKVVEEER	CCDC91
CLQHQNRYDGQVAVFGSDLQEK	UBA1
SGSLIDAIGLHWDVYPTSCSR	ZG16
AEGLECAK	VWF
LDKEFYEEEERAEADEIR	LRRC23
ISDISVEVGR	LAMA1
YQELQIMAGR	KRT77
AASSQTPTMCTTTVTIK	DSC1
FLPAEVADSGIYTCIVR	IL1RL1
AEGAQNQDK	RRBP1
MELLHPLGLDSPIAGFLQK	MCEE
ESGMTTAFIHVLER	DENND4C
LTVDKSRWQQNVFSCSVMHEALHNHYTQK	IGHG1
VFEDGTLGISLDETVNEK	GLDC
LAGSEVPQDR	ARSL
TQNKEESYDFFK	TJP2
IVNLFPQCTKDEIQIYQSK	SCRN3
GPKVDIDTPDINIEGPEGK	AHNAK
FGEWSGGPGLSLCPPGGIQEVTINQNPLTPLK	KRT78
FSDSGSGTDFTLK	IGKV2-40,IGKV2D-40
CAPGVGPAEADIDFDIIR	FLNA
GGKQILLSADHIIIATGGRPR	TXNRD2
HIDCAAIYGSEPEIGEALK	AKR1A1
NTLYLQMKSLRAEGTAVYYCAR	IGHV3-38
CDLVSLQPLPPGFK	CHMP1A
KYQAVASNSK	ERLIN1
LQGIPPSGPAGELK	NUCB2
FQPQSADFLDITNPK	UFD1
VDVSEEGPCQPTEAK	KRTAP16-1
LTGHGAEDSLADQAANKWGR	SAA2
ADSQAQLLLSMVVGVFTAPGLHLK	AGT
SQDKDVSEGETSDGVR	GTF3C3
DKALEQKNTALEQK	MAP1A
VFSVAELQAR	TRAPPC5
PAAVRPPAAAAK	COL6A3
LLRGHDQLAYDGK	HLA-C
YKETLQLIDSTTSYGLTGAVFSQDKDVVQEATK	ALDH4A1
GPGGVWAAEAISDARENIQR	SAA1
GGATSVLKPGNSK	ELF1
YSLVTDTPQIVQAK	NRAP
GLNSWQQQQQQQQQQPRPPPR	TNS1
VGQMLSIQDNSFISPQLQR	COQ8B
ERPQVSENLQK	NCOA7
AFVEWSQALLLAPEGSRR	EEF1D
EQGLRDIASTPHELYRNDYATMLPDSTEINQDTINR	COL6A2
VKLEQQVDDLEGSLEQQK	MYH6
FDPQFALTNIAVTK	HLA-DQA1
GTDECAIESVAVAATPIPK	CTSC
RLAAQESSEAEDMSIPR	WASHC2C
RNGQGDAPPTPPPTPVDLELEWVLGK	PFAS
LFPMAFNLVK	SEC14L4
GEQGEDSSEEKHLEEPGETQNAFLNERK	CHGB
LENVIVTDVDPK	VPS13C
MFPGVPLDTHDVFQYQEK	MMP9
DSQMQNPYSSHSSMPRPDY	MUC13
EPTTHAEAQGNEGDGEEGLQR	AHNAK2
TTQIPQFILDDSLSGPPEK	DHX57
NVVFIDMGHSAYQVSVCAFNKGK	HSPA4L
GKGEHFPYER	RYR2
IHLDTSSFMEELPGEK	R3HCC1
AEQSPSVEENLSIEDLELLEGR	SYNC
NDLEDSLLK	UGT2B15
KQGPYFEQPLQWK	MYOM3
APEQQPPPPVATSQHHPGPQSR	FNDC1
WIQPEEDEGKVVVR	TNS1
ARNGDDCPLGPGR	GDF15
TLAASGSQPSNGPEPGGQQLK	REXO1
SCHGSLVEER	XIRP2
GAPMDPNESPAAPEAALPK	CGAS
ETFGVNNTVYGIDAMNPSSRDDFTEFGK	EIF3J
LDTFLLDNFVPLMSRPDFLSYLSFEKLMSYLDNDYLSR	KLHL15
IPTIIGILACQLR	WDFY4
KDGDEVCESNVSNSITSGEK	AKAP5
ALAGWLRPEDGGQAEGAEDEMEVR	GHRL
QDAGVLGLR	BRSK2
GLEWVSGISWNSGSIGYADSVK	IGHV3-64D
EFVSFSDKPVDQIVVEEK	SYNE2
SPAINLMGFNVEEMCEAHAWIQR	PARP9
GPSAAGGHPGPAASEPVLPPLPGPQR	PIDD1
RLLSDLLPPSTGTFQEAQSR	TLN1
HFNENLTGR	SPTA1
ENQEAEKLEDDIR	TRIM22
LYHQLEQETGIQTGYTR	PDPR
EANALAAGHPAQAAAINAR	SPTBN2
YSEYTEEFSK	MTMR6
DVPGFLQQSQSSGPGQPAVWHRLEELYTK	PSMD13
NGNTALHYSVSHSNFSIAK	KANK4
EELLAESGSGTLDLPALTR	EPPK1
TVAHLQTVQHQLAELK	ACADL
AMGIMNSFINDIFER	H2BS1
RNTNSVPETAPAAIPETR	ADAR
APGFPLVSSLRPTAR	RIN3
FGGGSDAGSKGPMVSAQESQAQAILQQAR	COL5A1
ECDNPAPQNGGASCLGRK	C8A
NTIAVGVDPQEGK	LRP4
FIEGGDGHLSEDEEIK	POSTN
MNQADYALDAAVTLLEFYEDYFSIPYPLPK	ERAP1
FVVHGLTTGEQYLFR	MYOM2
RGPGGAWAAEVISDAR	SAA1
LLEGPLPEGASLK	AHNAK2
TEVPLAENQSGPDCAASLKEETGPSYQR	SYNPO2
ADIDVSGPKVDVEYPDVNIEGPEGK	AHNAK
TSLSAPPNTSSTENPK	IFI16
NSTIVFPLPIDTLQGIIGAK	STOM
DAMWIGFLTR	ASAH1
QCPKDCSNRGLCVDGQCVCEDGFTGPDCAELSCPNDCHGR	TNC
IEPDRAQVDEVLQLR	PPL
LLQGKDYIFR	TTN
DHHSTHYRASEEEPEYGEEIKGYPGVQGPEDLEWER	CHGB
SLVQESLSTNSSDLVAPSPDAFR	TP53BP1
SAGGGTYYADSVK	
VEDACILTCNVSLEYEK	CCT6A
EEFCGLLSSPTRPLSSCHK	FCGBP
DGFVQDEGPMFPVGK	C7
VEDQENEPEAETYK	BCAS1
AEPSEATQSHSISSSSFGAEPSAPGGGGSPGACPALGTK	RTN3
KEDFIVQDLEVWAFE	NCOA7
HHEGFTNWLSPVSWNWNSK	FUCA1
FLRGHNQYAYDGKDYIALNEDLSSWTAADTAAQITQR	HLA-B
FGSGAAGGSGSSNSSGDALVTR	FAM174B
VLASCLTPSGAEALQR	RDH5
LCTSVTESDVAR	PMPCB
TTHLSIQSPSADLEVQAGQVNVK	AHNAK2
ANSSATETIKK	DSP
QEYFVVASTLQDIIR	PYGB
LQAEEKAHAFVVQQK	PLEC
MDLPGVSIADEGETGMFSLCTIR	FTSJ3
TKAEAAEQAALAANQESNIAR	JPH2
THPDQFDLWYTLDRPPIGWK	CYB5R2
NGTAGGPRPAPTDGPR	CERS4
ALEQQASTPPPPPPLLPGSSAEPPPPPPPPPLPSVGAK	INF2
GLEWIGRIYTSGSTNYNPSLK	IGHV4-31,IGHV4-4,IGHV4-61,IGHV4-59
LAAQLGAPTSLIPDSAIVNTR	ANKZF1
GEPAGWGK	SFTPA1
YSSSGSAANSFHFK	EEF2K
TPEVQGRVPTLER	SPTBN2
NDYATMLPDSTEINQDTINR	COL6A2
EIGHNNPSAMAVESFTATAPFVQIGR	TMEM43
LLEVLDTEK	CCDC91
EEPRAPWIEQEGPEYWDRNTQICK	HLA-B
TVVQLEGDNKLVTAFK	FABP1
ADPVPLESMDSASTGKTEPGLLGK	GPRIN1
PGPSFSTPSLALATLR	DCHS1
VSSTEGAAKEEPK	HMGN1
TLSGPLDLEQNGQGLPFK	TRARG1
ADNNIDAIEETLETDDTTICSDRPPENEK	ATF7IP
TQCTEFFLAPVKTEVPLAENQSGPDCAASLK	SYNPO2
VWPETPEEK	AEBP1
FRCPEALFQPCFLGMESCGIQETTFNSIMK	POTEE
FEQSANNFYQQQAEGHK	BIN2
TMLIPPELK	DNAI4
DINVEQMDVDCK	DNAH17
NPPQQPLHVDSICDWDSGEVQLLRGER	EVPL
FQSSAVTALALQEASEAYLVGLFEDTNLCAIHAK	H3-2
DLGPHAEGQLAPRDGVIGLNPLPDVQVNDLRGALDAQLR	SLC38A10
LEEECEGREPGLETGTQAADCK	
AALAGGTTMIIDHVVPEPGTSLLTAFDQWR	DPYSL2
KEDLELIMTEMEIPR	HYPK
RLEGILEGLGLR	HDHD3
EIYLEVIHNIPDFELLSANTLEDR	DNAJC10
SEMSCIDGEK	SORBS1
KAQTSFLHLGYLPNQLFR	DDX1
AVNTLNEALEFTK	CPS1
HLLVHAPDDKK	ACLY
QLGSAPPGPFAWPLIGNAAAVGQAAHLSFAR	CYP1B1
NMENYLQALNISLAVR	RBP5
NWMVGGEGGASGR	UQCC3
SPSSSQPLPQVPAPAQSQTQFLVQPQPQPK	ZYX
GDPGRPDPQAESPR	ABR
WHHEPAEFQAR	HEXB
VPEPDYTK	SPRR3
RDQSIVALGR	MYO18B
KTSEDASEYYENYIEELK	PARP4
LSDLQEALDQALNHVR	LAMA4
DQEDSDGDLSVNLEYAPTEGTLDIK	SPARCL1
YAMAWGVVEKK	LACTB
AGLRQQSHQESARGR	FLG
NYGYIYVGTGEK	RSPH9
LGQMTVRDITSDSLSLSWTVPEGQFDHFLVQYKNGDGQPK	TNXB
FQNDHLSVLK	DENND2A
TVGTNTPPSPGFGRR	TNS1
HHQEEVGELLGQIQGSSAAQAQMQAETR	NEFH
DGSTAIHFEHSWGDGVAVLR	CPT2
TEVPLAENQSGPDCAGSLKEETGPSYQR	SYNPO2
TILTLTGVSTLGNVKNNQESDCVSK	PGP
ALFREPDLVLR	GEMIN4
SENYSLTDFWAYMVVSK	PLA2G4C
CLSLQAQITALTK	FKBP15
PWRPLPAQAQSAWEPAPAPATYR	ADAD2
CPQALFQPCFLGMESCGIHETTFNSIMK	POTEJ,POTEI,POTEE
GSMPAYSGNNMDKSDSELNNEVAAR	CYBRD1
VNLHHVDFLR	FAM83H
AAFTECCQAADKAVCLLPK	ALB
ASCSSSSSIAASYPVSR	ARHGEF17
SIEDCVQEEAR	CYP2C9
GVDQEPLNLFYIER	DSC3
VTDGTECRPYSNSVCVR	ADAMTS5
SLLEGQDAR	KRT15
SMGSKEDLIWELLNQAQEHFGKDK	TF
LFSVPSVFTPAIDTK	CTU2
VALSSQTEVALAR	MAP4
EEHEVAVLGAPPSTILPR	IFITM1
LKECVLHDDLLEAR	ARHGAP45
AQLNVGNVLPVGTMPEGTIVCCLEEKPGDR	RPL8
FGAAVLGNHTTR	FKBP15
VLHASLQSVLHKEESLGPK	EXOSC7
YLVNFIGQGPATYGPFCAER	MYO7B
ALDSNSLENDDLSAPGGEPGDFNPESR	LRRFIP1
APEPLGPADQSELGPEQPEAEVGESSDEEPVESR	CAVIN3
SSDSELNENEPHLPHGVSQR	ELAC2
VYVELQELVMDEKNQDLR	SLC4A1
KPVPPSPENLSVICFTSGTTGDPK	ACSL5
ASEGAMSDGPVPAEHR	MAST4
NASPSGDEDSSDSPDSEETPR	SEC16B
LSLESEGAAEGAAASPELSALEEAFRR	TPPP
DCSNRGLCVDGQCVCEDGFTGPDCAELSCPNDCHGR	TNC
SSPVFQIPKNDNIPEQDSLGLSNLQK	
YPNSLECTYIVFAPK	NRP1
TQAAVYLQAAWR	MYO9B
QDEDFLLPETTVTK	ZSCAN5C
SLTSLVLYGNKITEIAK	SLIT3
EAEAAQGQTGDETYLDIFR	ACAP1
IGQAIAQR	GRHPR
AVMNGLAPGSNGQDKDMDPTK	SORBS1
MSETVPAASASAGLAAMEK	H1-6
ITCSADALPK	IGLV3-25
WQQLNPDAPEALQAPAQVPSLFR	PARP4
ENLEALQRPTLLHLTHGK	MTTP
ASSSILINESEPTTNIQIR	NSFL1C
AAGEVDIGDAAYYFER	TACSTD2
DDALYETETLPNLER	MYOM2
VVNVIGAHYPGTHSAK	GALC
EWQLNQKR	PIK3AP1
FHFQGPCGTTLPEALACHGNETVS	SIRT5
DKQSGICMDSGGFR	SCRN2
ASYFICHDQDTIKK	PGM2
CLAENAGDVAFVKDVTVLQNTDGNNNDAWAK	LTF
EGWECVFCGDECTGLLLSDLAR	LAMA2
AVGEPMRPLAEECCQLGLGLCDQVDDADLRR	IPO4
KHTLSFVDVGTGK	SDHA
ENHLSQFLEGEILSASK	CGAS
TLDLGKNQLETLPPDLLR	LRG1
QEMECCLNNILK	SYNE2
LLQEDTPMR	POSTN
ASQDAVTTSQSQYSSFR	CCDC170
DKDSPETEESPAPEPR	HEPACAM
LELEEAATPEGHAMR	LAMA5
DKEFHSNQELER	TRIP11
AALGTLYLTATHVIFVENSPDAR	MTMR7
TPNSVVGHYTQVVWYSSYLVGCGNAYCPNQK	CRISP3
QCDNPAPQNGGASCPGRK	C8A
LLIFGASTR	
EKWLLDGISSGKQQEEMK	PALMD
HTQTSSGGQAASSHEQARSSAGDR	FLG
LPRPGPSFSTPSLALATLR	DCHS1
APADPAPAPADPASPQHQPAGPAPLLSTPAPEAR	PNPLA2
ELVDDSINNVRK	PCMT1
KCPDYTCPITFSSPADITILLDGSASVGSHNFDTTKHFAK	COL6A1
ALVDTYCR	HLA-DRB5
SPSSMVPSVLINK	GGT5
KAADWLFSADVSRPPGSTVYTCMLNHHGGTESDLTVSR	SARDH
QIMGTYLVR	MYO15B
GFSSGTVDALGVLTGAQLFSLQR	EPS8L1
TPPPRPSPLQAGSDGCEEPK	SPINDOC
ISTEVDITNVDLSTVDKDQSIAPK	RPN2
VLAVPAENYDYQILHKK	LAMA3
DIVSYVMDHFDIEIMGGLGPSTGK	AGXT
SETVPAASASAGLAAMEKLPTK	H1-6
SYPASDHTTPLSR	NID2
QLERDNVELENLIR	KRT31
LQSPQGFNK	SLC25A26
ALCCAGCLSENLR	TRAF1
SSCQIVQFMEGDKGGVVNCLEPHPHLPVLATSGLDHDVK	DCAF8
FVEKPQVFVSNKINAGMYILSPAVLR	GMPPB
KVTIPDLEPSRK	TNXB
AWLSSQAAELERELEALRVAHEEER	NES
DIQWLSPHSALHVEK	RUBCN
IFSFNGKDVLR	COL18A1
EVAQQAVDADVHAVGVSTLAAGHK	MMUT
ASAQTYRENLR	HLA-B
ENTDLAGELR	MYH11
MKDVPGFLQQSQSSGPGQPAVWHR	PSMD13
GHNQFAYDGKDYIALNEDLSSWTAADTAAQITQR	HLA-B
GPSVFPLAPSSKSTSGGTAALCLVK	IGHG1
GFQMLADPGSFDSNAFTLLLR	COMMD3
EVLNGVQTELLTSPK	PARD3B
NWGLSFYADKPETTKEQLGEFYEALNCLCIPR	ORM2
LQGSELSLVPHYDVLEPEELAENTSGGDHPSTQGPR	PARP10
CPETLFQPCFLGMESCGIHETTFNSIMK	POTEI
QIFLDQNMLAVIDELMQALNFNSETMPQK	IL12A
DCQVIPLPPGLPLTHAQDLTPATSPAGPR	LAMA5
KAFSEYLGTDQSK	ESD
SGDTAVYYCAR	IGHV1-69D
HLGDQMEVSLLAVR	FYCO1
GLNSWQQQQQQQQQQQPRPPPR	TNS1
LQGASWDTQSGPQER	MLC1
VSGQTEVDDILAAVRPTTR	SCLY
LGIHSTLLDEKK	GLRX5
DHIVLTVLPDQDQSDETQEK	RIOX2
LEGDLSLANKDVTAK	AHNAK2
LPGEGGDGTPAEAR	TUSC1
QPELPEQQMGKLK	IVL
EVAQHDVR	PGLYRP2
AAEIGYEDPINPTYEATNTMYHR	PRODH
NTMYLQMSNLK	IGHV3OR15-7
STVLSNGEAAMQSSNSESKK	DDX18
CPTPCQLQAEQAFLR	TG
LECGGSAVEDK	ALDH1A3
VAEQRPGSILYGTHGPLPPLYSVSLALLSSELAR	FRY
DDAQSVETVGKPK	AHCTF1
AFSEYLGTDQSKWK	ESD
GILVDTSR	HEXB
AKLDGAQLQGDLSLADK	AHNAK2
ECDNPAPQNGGASCLGR	C8A
SAGLAPDCEASATAETTVSSVGTCEAAAK	HINT3
NNSDQMVYVVTEDTDDFTR	PLSCR4
AKEHMLQTNWK	FBXW8
GVSSPDHIFLPIPNWEHK	ITGAV
LMIYDVSKRPSGVSNR	IGLV2-23,IGLV2-14
MDATANNVPSDRYKVEGFPTIYFAPSGDK	PDIA4
VVIQPEALFSIYSK	PML
YSLIDPSSAPELLR	CLIP2
GEPGAEPGHFGVCVDSLTSDK	MYO9B
ALETLQER	GSDMA
LTAEFEEAQTSACLLQEELEK	RRBP1
MIFMELNNAWSEFENQGSR	GAK
LSEGPVPEGAGLK	AHNAK2
DVASLSSQIQDTQELLQEETR	MYH11
IIVHPQFYTAQIGADIALLELEEPVK	TPSB2
CPDYTCPITFSSPADITILLDGSASVGSHNFDTTKHFAKR	COL6A1
HDEILTELEK	FARP2
SGTPQLSLPFAAR	LGALS8
FGIQAQLVTTDFQK	PSMB3
KAFSEYLGTDQSKWK	ESD
EEFILYMEEASEEK	TMEM70
ERIQPEDMFVYDINEK	APIP
LLESGDLSMSSVK	AP3D1
NHEAGTSGCSIDAK	CEP170
NIITTELNSATDNPMVFANRGETISGGNFHGEYPAK	HAL
TSHENMLIPVVGTLQECASEENYQAAIK	ODAD2
REDAITQQNTMQNEAVNLLDPGSSYLLQEPPR	PAWR
NLCWDVLCVDQPVVEDPR	MAN2B1
NVSPVALPR	CTSG
ILAAQGQVSAQGGAQPSVEAPAAPR	SLC25A22
GIIDLIEER	GFM1
MESEMETQSAGAEEGFTQVTRK	PNO1
VPVPGYTKVPEPCPSTVTPGPAQQK	SPRR3
EEPGRPAGEVSTGCLASEK	SPAG1
QFFSHVIADTIK	IQCG
PSFHPVSDELVNYVNK	CTSB
RLQAEPGIEAPSGTEAGALLLCEPVGPVYTAGLR	LIPT2
EWFWDLATATMK	HPX
MQQEIAFQQVMSQIANVKK	MCUR1
ENIIEERPGQELTDVNGVR	MRI1
KVYGLQSELQYK	NRAP
STSFRGGMGSGGLATGIAAGLAGMGGIQNEK	KRT18
GGSSGNPTTTIESPK	PODXL
NVHFNYPSRK	ABCB1
LKEAQNTCAMLTTYNEIDMSNIQEMR	DLST
DFKDGTFDPDNLEEYGFEPTQEGK	MRPL41
LLRDPADASEAHESSSRGEAGAPGEEDIQGPTNADTEK	CHGB
IHEEAVQELR	MYH14
EEQEVAMLGAPHNPAPPMSTVIHIR	IFITM2
TVLTGTKDIVCSGVTGAANVAK	PLIN4
IASPHFTVSK	TTN
ERDPVPKPSVLFLHPDLGVGGAER	ALG2
NIFLVTNGQIPSWLNLDNPR	GNPTAB
DSVTGKESQGERPHLSLLIPR	C17orf80
SESGNWHCTASWK	SEH1L
VGEAGLLSVNCSEAGPGALGLEAVSDSGTKAEVSIQNNK	FLNB
QGAACNVLFINSVDMESLTGPQAISK	TNS1
APQMPDSHRGR	SYNPO2
GLAWIGYIYYSGSTYYNPSLK	IGHV4-28
VVGVFHTEYGK	NIPSNAP3B
QPPLLLAALQAPTQILK	LRWD1
EKLHSLTQAK	RRBP1
TCDLPSCPGTEDKDTLGLPSEEWELLAR	ISM2
AELSRSDLSLIQQQQQQQQQQQQQQQQK	FAM171B
AQEAMTDETPDSSK	KDM5A
LMHLTSEELNPHPDK	NUDCD1
QEEEKQILKQDFETLSQETK	EEA1
EAFGTEDGLQR	NEIL2
LTQSSAFYSQR	SPG7
ISQLEKELIEDLKSLR	MGA
SIHTVLTF	ADH1B
LEPPWINVLQEDSVTLTCWGAR	FCGR2A
VIFDIVDLYTTWEAMEK	AKR1C3
LSEIDVALEGVR	EFHD1
AARPPPDQLASEEPWTVLPEHLILVAPSPCDMAK	CEP192
VSTFVVSTVNTQNPHVNAFFQECQK	DOCK10
MPHQLFIGGAFVDAEGAK	ALDH1L1
SPSVVLSEPSQESK	FMN1
PSQAAGDNQGDEVKEQTFSGGTSQDTK	THRAP3
ELGGSSQAGNR	AGFG2
GDSAPAAAKENAAAPSPVR	PALM
AEGAQNQGR	RRBP1
WCDADPCCTGFGFLNVSQLK	TG
AEDPEVDVNLPK	AHNAK
FDLIFLMLDPQDEAYDRR	MCM4
STESLQTNVQR	RPL13
MKGTAHYHSLPAQDNLVLK	NRAP
LKGDIDSNAAIDLSNK	PLA2G7
TLDPFETMLK	CYP20A1
EEVPALHPASHDIGK	COBL
GPILLELQTYR	PDHA1
LAQMVDDGAFTAGLAQVSFDK	HEATR5A
HCLTGGEALNR	ACSM5
IDPQTGWPFFVDHDSR	BAG3
TLVSCIDFR	ENOSF1
LKTEPEEVFIEDSAQSDLK	IFI16
RECVVNSSAAR	MAP4
NMITGTSKADCAVLIVAAGVGEFEAGISK	EEF1A2
ACQNVSVVIHTACIIDVFGVTHR	HSD3B2
EIQSQPGNALYFK	SGCD
IDGYIISYREEEQPADRWTEYSVVK	TTN
VDVEYPDVNIEGPEGK	AHNAK
QQTVAGVNYFFDVEVGR	CST1
VTTVSESTK	SIRPA
AADWLFSADVSRPPGSTVYTCMLNHHGGTESDLTVSR	SARDH
VPSLGYGSPAAGAASADTAAR	GNAS
QQHEGAQGALDSGEPPLCR	LSP1
ESGPALVKPTQTLTLTCTFSGFSLNTSAMR	IGHV2-70D
AVFPPEPGAGKPGGAAAEGAGPGAAR	C2orf72
NVIEDLVPIEDIPDVHPDLQK	DDX51
LLIYENNK	IGLV1-51
ARDEGSYMCSAYQGSQAVSR	PAPLN
DLQQSIAREPSAPSIPTPAYQSLPAGGHAPTPPTPAPR	PDCD6IP
VIWHGSSPHGIR	COL15A1
VALLLMASQEPQR	VWF
TLEGLQVEEEPVYK	HCLS1
FDSDAASPRTEPRAPWIEQEGPEYWDGETR	HLA-B
VYLFELHITDAQPAFTGGYR	MYBPC3
VSHGEGGGEEAAAAAR	FIZ1
ALPNSEDLVK	OPA1
TLACVCALLVWHPAGPGEK	MAP1S
RGSDVIIVGR	UMPS
CHLGPGEQAGPGLHR	MUC1
NHNSLLSLPQEPYSFSK	GAA
QNQEVEKENSHFFVATFAR	TBCC
RFCGEHAGAMEEEDAR	TRMT13
YQWDLDTCK	RABEPK
VLPKPESASVSAAPTPPVSLPLAPSPVPTLPPK	NACA
GPKVDIDAPDVDVHGTDWHLK	AHNAK
VEKVPSFETAEGIGAELKAPLK	SLC30A9
NASLSQSLR	WDR91
GDFPTDCVYVMPTVTMPPR	MYO7A
WNPSPPACEPNSCTNLPDIPHASWETYPRPTK	C4BPA
ASGFTFTSSAMQWVR	IGHV1-58
IGTTEVEK	TACC2
GASAEELLAQCLSSSLR	MCM3AP
ELEVCEQANK	ERO1B
SYNRFQTATVTEK	PSMB4
TEVPLAENQSGPDCAGSLK	SYNPO2
AVVLVGFGGLNK	VAT1L
LTPPAGISATEIAK	PRDM2
EEIVHFGIK	SEPTIN4
VTISVETSKNQFSLK	IGHV4-59
NTFGSGVTGAVNVAK	PLIN4
ASQSVSGYLAWYQQR	IGKV3-11
GTAAAAAAAAAAAAAAAKVPAK	RPL14
TGFSFPAQEPR	SORBS3
IPEPCQPK	SPRR1A
QQTVVGVNYFFDVEVGR	CST1
VILNYPSPWDQEERPAQR	TRAF3IP2
QVSSLSSSPSTPSGLSSVPSSPMSR	ATXN7
LGLSFNSISAVDNGSLANMPHLR	DCN
GPSGFPLRGATVFPSLR	MUC5AC
SLQIPQCLTTCEK	TG
LQQALLPVVDYEHCSR	CELA3B
GPGAEGGSGSPEK	MINDY1
LLSLFPLSCQK	SLC5A6
REEEEEEEEEEAEAGEEAVPEEEGPTVVLNPHPSLGYK	CHGA
WQQNVFSCSVMHEALHNHYTQK	IGHG1
QEIFHQFVSLSTSGGK	HEATR1
NCEQCKSFYYQHPER	LAMB1
RAPVCGDDGVTYENDCVMGR	AGRN
IEGLDIHFIHVKPPQLPAGR	EPHX1
YLTWASRQEHSQGTTTFAVTSILR	IGHA2
DWHDLIAK	NEB
VRQGHVEQCECLGGR	HGFAC
IQFDEGYDNYPGQEKMDDLKK	MRPS31
TMEEGAETPVYLALLPPDATEPQGQLVHDK	CBR3
LHPDKNPNNPNAHGNFLK	DNAJC10
RGEWKDLIATLAK	SENP8
VVSVIDLGVFVR	OR52E2
KVLLDGVQNLRAEDLVGK	C3
DPHETQNLATDPHFAQLLEMLR	SGSH
EAALPPVSPPK	EIF4G1
QLTIEMFNMECGAFYFLFLDR	ATXN2L
NSLSETVR	LMAN1
RASAILPGVPGSETLSNEVFQESEEEK	NIBAN1
TDPQTGKVHVSGAR	GPD2
LNATEEMLQQELLSR	PPFIBP1
LRETQDPTAQSLAASLSTGQLLR	VWA8
AFVHWYVGKGMEEGEFSEAR	TUBA3E
GYNQLAYDGKDYIALNEDLSSWTAADTAAQITQR	HLA-B
LIVQLTVLEPMEKPIFHDPISEK	MXRA5
PAPGSTAPAAHGVTSAPESR	MUC1
QTIPHYYLSINVNMGEVLLVR	DLAT
MDVENEQILNVNPAENAGTEEVK	PDCD4
LSEKLDSTDFTSTIK	TFRC
GISFDAAATSGGSASSEK	ETFA
DKPLWPVILSPTMEEGHGLDLTYITER	TNS3
QEGQYLRPGEDER	LAMC3
HIDCAAIYGSEPEIGEALKEDVGPGKAVPR	AKR1A1
DEQHQCPLGNLK	ESYT2
EGHNYENNHNFHMNTPK	CWH43
IYKKNDPSAESEGL	MMAB
ITHVALDFWR	TOR1A
SQNSPEAAPTSSLESSSSIEQEK	SBF2
DVTEIDILIK	GINM1
ETWLNENQR	SPTB
NSTSFFGLMAAAAISK	SLC25A33
MDPNCSCSPVGSCACAGSCKCKQCK	MT1X
TFVGEPQRLGSETCLPQHIR	USP36
YILQGVTSWGLGCACPNKPGVYAR	LPA
VDKTVAPPVAGPSVFLFPPKPK	
HNYGAVESFTVQR	HLA-DRB1,HLA-DRB5
CVEPLGMENGNIANSQIAASSVR	MFGE8
CIHNTDGIYCDQCK	LAMC2
AFYYPEEAGLSFGGPGSSR	DBH
SGGTLVLVGLGSEMTTVPLLHAAIR	SORD
EMNERLEDEEEMNSELTAK	MYH6
YLFAVTGNGLVNQGNNPEVQVDTSK	GPC4
LLIYAASALQSGVPSR	IGKV1-27
AAAASAAGDSDSWDADAFSVEDPVRK	EIF3J
YNGDIEDIKR	LMO7
DSTLDPSLVEMTEAALR	ALPG
AGAGPPGAQGPGPEGQSLAPALR	RINL
TRPEFYLNSYMNQQDVVNAVR	COL6A3
HSDHILLFNDAHFLMASLGAHDPQTTQELLTTLR	TTC38
VSDLAATAYK	COG3
DKTVVLGDLLIDNKDTVR	NT5C
NQIKDAQLQNAR	KRT20
SELLLLACVHNYQPCVQR	ERAP1
LLPSVWSESEDGAGSPAPYR	MBD1
YFSTTEDYNHEITGLR	ZG16B
EGGQTAPASSR	GSN
IAKDPSWIIR	PITRM1
SMTSELEELDKPEEIVPASKPSR	SHANK2
SDGGLAPMDTFSGSR	OPLAH
QRAQEALLQLSQALSLMETVK	PLIN3
LTAIIEEAEEAPGARPQLQDTWR	EPPK1
GCEENLDEAR	ADD1
TQWLEVDTR	AEBP1
CRSTDTSCVNPPTVQNAYIVSR	CFHR1
QLQEETPSGGPLTEALPPAR	NDUFB9
QTLEKENTDLAGELR	MYH11
LDNLFLEQEDEEEK	CUL9
INPQAEWVIKPQPSS	ARHGAP28
DNSKNTLYLQINSLR	IGHV3-53
TTSQAQTEVPLDDPDRAGWPAGK	ABCC6
HGIILNSEIATNGETSDTLNNVGYRGPTK	LRRFIP1
KGDITTIR	PMP2
GHVECYLEECQALSCPHGWAK	KCP
GWVDFFVPK	SERPINA7
IAYHSANANSHFSSPTQR	PKHD1L1
GISEDSHLESLQDVGQSAAPTFMISPETITGTGK	MAP4
EPVGENGGR	POR
AKSHPEVSIEHLGQVVQCSHEEGLVCR	MUC5AC
RQDLEVEVRDEQHQCPLGNLK	ESYT2
ELEIMQILTR	CASP7
PAQASPSSSSSSSAPELLGGPSVFLFPPKPK	IGHG3
VNPVQGLASHWDYEK	COX4I2
EAVAYAVNSWTTSISCMLLK	TAP1
ELAEEFGVTEYPR	PDIA2
APWIEQEGPEYWDRNTQICK	HLA-B
GGSPSALWEITWER	GBF1
SDSELNNEVAAR	CYBRD1
HILELQEVYDYLYQPSYR	RNF213
TEESKAAAPAPVSEAVSR	CAST
TQIAICPNNHEVHIYENSGAK	ARPC1B
MDATANNVPSDRYK	PDIA4
LRSPLPWQYR	HSPG2
LLDTAFDLDIFKNFS	OGDH
FVCAPPSRLTLVPVYTSPQLDMSCPLLQQNK	NUP210
DRDGGMHSDPVTLNVLYGPDLPSIYPSFTYYR	PSG5
VQQELSRLGMLEMLLPGQPEAVAR	GSS
VDLKGPQLDVK	AHNAK2
KENVATTDTLESTTVGSSV	KARS1
NKQTLEKENTDLAGELR	MYH11
ELTFGSSVEVQGQLIK	NARS2
EGSDLASIHTIEEFDFIISQLGYEPNDELWIGLNDIK	MRC1
GKGLLGNAIKWNFTK	GPX4
SQREGQGEGETQEAAAAAAAAR	EPPK1
ASQNIGSSLHWYQQKPDQSPK	IGKV6D-21
VVVNSPANANYQER	LDB3
DKQLQIFDPR	CORO7
YIQQQKQQQQQQQQQQQQQQQQQR	ATXN3
DELLAQHAAGALGLPNLVAVLTR	EPPK1
EGLPWPEQQR	ICAM5
SSSFSHRSELLHGDLASLGAAAPPQTASPR	CTBP2
TEAEPTHVNK	AKAP12
NLWIPMKPYYTK	ATP5MJ
EESYDFFK	TJP2
SNPATPASK	C18orf21
QSSQDDELK	PPIG
ASGYTYTDYYMHWVR	
RQCDNPAPQNGGASCPGR	C8A
LTIVDTVGFGDQLNKDDSYKPIVEYIDAQFEAYLQEELK	SEPTIN11
DTVSTGLTGAVNLAK	PLIN4
KTPESFLGPNAALVDLDSLVSRPGPTLPGAK	
GPLQPMAGTCPAPEIR	PLXND1
HEESEMHINNSVK	ZMYM5
GNAETSASASQTNHVK	CDK13
WNETFQKEVLGSR	SDR39U1
NENRGNPAVSYVR	FCGBP
GEPREPWVEQEGPEYWDR	HLA-C
LVHDFTDDVIQER	CYP4F3
ISVATGALEAAQGSKPQCQTR	HCFC1
ADPVPLESMDSASTGK	GPRIN1
GAQAGTQVEEAEAVAVASGTAGGDDGGASGRPLPK	SLC4A2
GMLQPGTALVLLEAQAATGFVIDPVR	EPPK1
DTVVFVNQWSVNHDPVK	CYP1B1
TYGREIQVTELLNK	CPB1
DVQEQIAVLMQSR	RABEP1
STQMESTCVSASLPR	LMO7
LYLSNNHISQLPPSIFMQLPQLNR	LRRC15
SSQSLLHSNGYNYLNWYLQK	IGKV2D-28
ILYDLHSEVQTLKDDINILLDK	SKA3
CSATGSPVPTIHWSK	HSPG2
DILLQQQQQQLGHGGPEAAPR	IRF2BP2
EHGQCADVDECALAEK	CRELD2
ATEVPSLTALHTLWLR	TPO
MALGIAAALGSNVIR	MLPH
HQAQGDMATMLQLVLLLK	CYP11A1
LHGHLYTPGQEITNDCK	MUC2
MSIYQAMWKGMLQPGTALVLLEAQAATGFVIDPVR	EPPK1
VDGTPEIGISWYK	TTN
SHPEVSIEHLGQVVQCSHEEGLVCR	MUC5AC
KMDQTMAANAQK	CMPK1
DHLQAPDIEEHNTK	LRRC6
DDPSTPCVSCPCPLSVPSNNFAEGCVLR	LAMA5
AEDMALYYCAK	IGHV3-64D
WEMAEDMEK	AGAP9
ENPAEPGAVTGSATVTAFWR	ASPDH
SALSGHLETLILGLLKTPAQYDASELKASMK	ANXA2
IGVLITDGKSQDNVEAPSKK	COL12A1
PYLLSQEIPPDWDQQPVK	PDIA2
HQSEMKPGEPEPQILDFQTQQYK	ACOX1
VIGIDHIKELVDDSINNVRK	PCMT1
ENNPIQGPDGK	SPINK5
QWMQNPNNNPIHPNLR	ANPEP
DPAEPMSPGEATQSGARPADR	MYBBP1A
LPEATPTELAK	GC
VNLPQYPPTAIDYK	PDE11A
LSAYPALEGVLHR	CD5
EQNYDLTQVSESMK	ECD
VGVTDLSPFGK	DMGDH
GRPVPMVIPDELAPTYSLDTR	EML2
EGQGEGETQEAAAATR	EPPK1
KLPPSTAIK	ZAN
EESFGPVMIVSR	ALDH1L1
SSCSLSVAEVDR	MCC
EGEDPQASAQDETPITSAKEESESTAVGQAHSDISK	AKAP12
EESLPEISLLELLQNR	JHY
GDCSVRDPEDTAMPGR	CARD10
GVACVVPGTLEIEGR	NRAP
GATYNIIVEALK	FN1
VVDSMEDEVK	FARSA
QKLQEQQQQMEAQVK	GBP6
GTQVVGSDMTVTIQFTNPLK	F13A1
MDDPSISR	PARP4
ISAFFSSVWDTILTK	KIAA0040
KEEFHEQSFRVQK	HABP2
AHTTSTGLWGLINNAGHNEVVADAELSPVATFR	HSD11B2
VDIDTPDINIEGPEGK	AHNAK
YANEVDSDAGAFK	SRP68
LLIYGNTNRPSGVPDRFSGSK	
QIEELRNQIKDAQLQNAR	KRT20
DMVTQASLYLFEATGKR	CLCA1
VPSVEIVTPQLPAVEIEEGRLEMMETK	PRX
AENFTPVFMAPPVHYPR	GRHL2
RGPGPGSAVACSAASSSRPDK	SOGA1
VSDALGQGTR	DMKN
RVYGDIIYTPAKDR	ALDH5A1
LLGLELSEAEAIGADSAR	PIH1D1
FAGAHLGPEGQNLVQEELAAR	DUS3L
TPIALATGIRPFPTEESINDENIYK	VAV3
LKAGVAAPATQVVQVTLQSVQR	PLEC
SEEEKDQQKQQMFENK	SLK
QQIQAGLELAQAHK	CCDC187
TILQNEYMKDDFFIK	PITPNB
FGNANVVNVLSSHHLIVK	ANKLE2
LALKLHPDKNPNNPNAHGNFLK	DNAJC10
HGGHYFPK	GATM
SNPNWILPDSVDWR	CTSS
HFLEQILFPSSPR	ZFYVE26
DLGDLIEATGFDR	TTI2
EVEDCVTNRPCR	C8B
LQTEAQEDDWYDCHRETR	DDX20
EVPKCGFLPGNEK	PSME2
LHLQLGQPAAAAALCLELAAALR	F8A1
GGPVQVLEDK	SELENBP1
LGTWGFFSTGDEHSPGNWGHLDQVAALR	CES1
LEKPPKEGVYELAVFQMEPGGPALWGDAFER	NIPSNAP3B
SLSETCLPNGINGIKDAR	STEAP2
LEQQVDDLEGSLEQQKK	MYH6
AAQAQGQSCEYSLMVGYQCGQVFRACCVK	FBLN1
ELQTCLQALELGAAEKEEDYHTALR	FYCO1
AVDGFTFTEGDKSPDGR	NCAM2
HVGSSETNLLQHLLEACGR	PYCR3
VTNSVSSK	BPI
APQEFMTSHLEAGSR	ADPGK
VCVAIDECELDVR	STAB1
AFGPGLEPTGCIVDKPAEFTIAAR	FLNC
RIVGSPFDPTTEQGPQIDKK	ALDH1A2
AAPTQVLSMTAQPGPGHGK	PIP5K1C
KTSEDASEYYENYIEELKK	PARP4
GDEDLGDMGKDEEAQFR	CRACR2A
PFVFLMIDQNTK	SERPINA1
LEEFSVPFK	SYNM
QQEGCFGEPDAEDEESSK	C16orf89
MLPTYVGSSPHGTEQGDFVVLELGATGASLR	HK3
TTRLQQQHSEQPPLQPSPVTTR	TOR1AIP1
LLEHVTQEQNELLK	SYNE2
ASGGTFSSYVISWVR	IGHV1-69D
IHHDQPVKPLER	UGT2B4
IGSVLAVFEAAASAQSAGASQSR	CTDP1
TTDNFDDILK	RNF213
NHPVPVIAMVNGLATAAGCQLVASCDIAVASDK	ECHDC3
KEEVWDSFKV	GPR158
WLLLCNPGLANTIVEK	PYGB
YYSDGQHRPSPAQHR	CLDN23
LSSSAIPHLYSEALK	VPS8
GLEWVALISYDGSDK	
WQGSPAELESDTQGAR	ARHGAP6
GCIDMNECWASPGR	FBLN2
CSTNPGNWVTFDDDPAVQSSQK	STON1
CQLSMANHR	SIGLEC1
PAPGSTAPPAHGVTSAPESR	MUC1
TSTNNVEQYQAMVTSLEESLNK	TPR
APETDDSFSDVDCHSNQEDTGCK	PMS2
NTLYLQMK	IGHV3-38
HLSLGSVQLCGVGKFPSLPILSPALMDVSYR	AGL
DGHLLNVDQNQNSYR	HMCN1
RVHLAPPPTWEGYDPSWN	MGAT1
LNVSLPFVSR	MDC1
SSSKDSRPSQAAGDNQGDEVK	THRAP3
VGAGLGGLFTDK	AP5B1
LQLWWCGGGPDSSIPDDHQGEK	WRAP53
AVENINSTLGPALLQKK	ENO3
LQALANEQAAAAHQLEK	KTN1
TAVGSNPDTPHFPR	KLHDC7A
DDCNRLQEQFDEQSK	GOLGB1
QFLFDSLLK	TEFM
AQCIYTGGSSYTCSCLPGFSGDGQACQDVDECHPSR	NID1
LNGQQTALASQYR	PRRC2C
LQDNELQALPPLRLPR	VASN
YIPNRGPLDK	RPL10
KQEEWGLTSTSVLKR	R3HCC1
VRGTQVVGSDMTVTVQFTNPLKETLR	F13A1
APAEDGMSAELQGEAIGLDEVK	SMTNL1
LNYLDLYLIHWPMGFKPR	AKR1E2
IGCSLSEVCPHASSVLGNLDPNK	STK31
LQAEANDLQIR	GOLGA3
SPGFPEKYPNSLECTYIVFAPK	NRP1
AEPSAWSQDTGDANTNGK	MTDH
LSWAEAGSQTAAGAMER	PDE12
LSCAASGFTFSNYALSWVR	IGHV3-23
TSFRVPNLEEGK	TTN
RTPDGFDSVPLKTSSGGPDMDL	ELAPOR1
GNVYIGGAPDVATLTGGR	HSPG2
NLQTQQASLQSENTHFENENQK	MIA2
SGGLSVEMCGPALSQQWK	GALNT2
GPAAPPPPAGGAANNHGAGSGAGGR	GSPT1
MVDFAGMKDK	COMT
EQDDTAAMLADFIDCPPDDEKPPPPSEPDS	PELP1
LNSEQSQALQHQQETGHSLK	EVPL
STSDCGGPKDHPLTCDHPQLSGLFL	LHB
ILIGGFSMGGCMAMHLAYR	LYPLAL1
LACESASSTEVSGVLK	ITGAM
SGASGASAAPAASAAAALAPSATRTR	CENPV
PSEEEAAAAAGGPPGGPQVNPIPVTDEVV	CYBA
DGEVISEATQQQHEVL	DES
ENLQLETRR	PPL
CFKEHSSLAFSK	APOH
FHYLTFVPSAEDVYDCR	HLA-DPA1
LEGILEGLGLR	HDHD3
CFYQLQPAMTQR	PMF1
LASYQSCLLSSPGTMLK	DHX37
HPLKPDIQPFPQSVSESCPGK	HRG
KFAENPKAGDEFVEK	HADH
KNGAVWCICNENYAGPNCER	LAMA4
AALTLSGAQPEDEAEYYCLLSYSGAR	IGLV7-46
SLALRSELLVDKTK	CETN3
MKETAEVYLGQPVKHAVITVPAYFNDSQR	HSPA6
VLCNETNNQTIWDEHDNR	TEKT2
SGASGASAAPAASAAAALAPSATR	CENPV
VLLDGVQNLRAEDLVGK	C3
DKYILQGVTSWGLGCACPNKPGVYAR	LPA
LEWMGWINTGNGNTK	
HHHIDQLGDGTCSLLITGLGR	OBSCN
AVETLSPDWEFDRVDNGSQK	WASHC4
LLHLLVDDMPVKPYSDGEGGIEDENR	NUP205
HELTDEELKSLFTNFANVVDK	AFM
VAALDCMEEENQAVCHDYDIHFYPTFR	QSOX2
ESLLVSAWSEELISK	H6PD
QPSSPSGEGDGGK	RFTN1
GQPQSQEESEEGEEDATSEVDK	CHGB
RLSGLIYEETRGVLK	H4C6
DDVSSFVDPALALQDAQNLYAAGEK	ANXA8
LEGSDVQLLEYK	DPP3
GKDWEIPVPVGISVTDENGK	GTPBP10
LVASELHTSLYSSMVGADR	MDN1
HGTDDGVVWMNWKGSWYSMK	FGB
VSQMNSLEEELETIHLENEGLK	NIN
NPWSMDENLMHISYETGILENPK	ASS1
TLHQGMAEVYNFDFITMKPILK	PLBD1
STSLMEPEPAEPLAAAVEAANGAEQTRVNK	SMTN
AFSEYLGTDQSKWKAYDATHLVK	ESD
YNGDIEDIK	LMO7
ALSQHLPETGTATDQLLR	KANK4
VVGACGVGK	RHOT2
TPIYPYLLPK	PLD2
LYVEPAAPLGAPTYIPTLEPVTR	TTN
GDNFETVTWLSDSEVVRAPSPGWR	MBLAC2
QNTGTWESNANVK	ITGAM
RLNEGSSAMANGVEEKEPEAPEM	SEPTIN9
TPDEGAWTSIYAAVTPELEGVGGR	DHRSX
YRPGTVALEIR	H3C14
YSGETIQERK	TIMMDC1
ASFTNVTETQFTISGLTQNSQYEFR	TTN
ASQGLPGPTGSVVSTGTSFSSSSPGLASAGAAEGK	MAVS
KQEELESTVAR	SYNE2
NKADNNIDAIEETLETDDTTICSDRPPENEK	ATF7IP
YCICNSGVVR	IQSEC1
SDNPVVPSLFK	DDX60L
DIQQTEQTIEQR	SYNE1
GLEWVTIISYDGSIQYYADSVK	
KLGNDAVSQDSSSPALSSVER	CARMIL1
ESSWVTPESCFYK	IQGAP2
DVSEGETSDGVRK	GTF3C3
ETVSTGYTQPQPPPAGLPQNAR	C1orf116
HLHLASPVQESPFYILIETSGSNAGHDAEK	D2HGDH
VSTIAGIGIQGTDKEGGAK	NHLRC2
VEVRVPDVEVSLPSVEVDVQAR	AHNAK2
AGKDVTGSPRPGGDGEGDPNHIER	ITIH5
PSQAAGDNQGDEVK	THRAP3
ADESTYVLVAHSGSGVIER	IFIH1
LGIHSTLLDEK	GLRX5
GEQGEDSSEEKHLEEPGETQNAFLNER	CHGB
SVGGSEHPPQWSPNGVLLSPEDEEELTAPGK	LAMC3
FLELGPDGHQR	FAM83H
IHTGEKPYECADCGK	GLI4
TQLHEDLLPR	PTPRN2
HMMAFIEQEANEKAEEINAK	ATP6V1E2
TLNEADCATIPPAIR	SDHA
NQVVLTMTNMDPVDTVSYCCARI	IGHV2-70D
IPSLPTSTQTLK	TSHR
ASAILPGVLGSETLSNEVFQESEEEKQPEVPSLLAK	NIBAN1
NGAAGGPRPAPTDGPQSR	CERS4
TKGQPREPQVYTLPPSQEEMTK	IGHG4
DDANNDPQWCEEQLIAAK	PAICS
APDPGFQERFFQQRLDHFNFQR	DPP7
DNPPNIPSSSSSKPK	OXA1L
HVLSTSGLQSDAR	MYLK3
LQQQHSEQPPLQPSPVTTR	TOR1AIP1
SPSWISASVTGPLEQVEAEAALLTEEVLER	AKAP12
ICQSNLQLVHAR	ITGA7
LVLPSGMEELR	ALOX12
SLADYRTEDSNAGNSGGNVLAPDSTK	GOLGA3
IVTDYTLAEADAALQK	USH1C
NYLTWYQQK	IGKV4-1
FQFAFPSDKYEQDDLNLEGVGNNDLSHVAGK	HFM1
DFENSINQVK	ECI2
TMQGSEVVSVLK	PDCD6IP
DIASTPHELYRNDYATMLPDSTEINQDTINR	COL6A2
DCNDTLEEDNTNLETPTKR	PUS3
RQTFIDNTDSVVK	IQGAP2
IIPILGTANYAQKFQGR	
VIDPVTGKPCAGTTYLESPLTSETTQLSK	MRPS17
MDATANNVPSDR	PDIA4
SPDHSPTEQDDRTPGR	FMN1
SAHTLVGPTR	TCOF1
FAVTNQIGPVKEDSDPTPVNPCYDGSHMCDTTAR	NID2
LEQQLVHVERPVLR	DNPEP
FEEGENSLLHLK	PON2
AASYGLTPATSDCR	AHDC1
TLSPEIITVTSAVGPVSMAAPTAITEAGTQPQKGVSQVK	WNK1
EEEEEEEEEEAEAGEEAVPEEEGPTVVLNPHPSLGYK	CHGA
ASEEEPEYGEEIKGYPGVQGPEDLEWER	CHGB
CSGTEASVVAPPPVVLLPNVETPSEEDCMFGNGK	PLG
EAASSPQVVLGPSR	PRRG3
MVIQEIENSEDEEGKDSGR	SPAG1
FQLGNSGPNSTIK	ESYT2
DDYPFCMDCYNHLYANK	FHL5
SPMVPLPMPK	CRAT
QDIQSDGFSIETCK	CAPN2
APRPFGSVFSPK	PDLIM5
GPGGVWAAEAISDAR	SAA1
EVVDGSPAAASTISEITAEVNNFR	VILL
KQTSVDSGIVQ	DOCK1
VLKEQALQEAMEQLEELELERK	SWAP70
PSGEPGCSCAQPAAKVAAPGWAQVR	FAM20C
SLENCLLDLR	FAM83H
GAEVQGDRASPGEK	PRX
ALREAPLGLR	GRIN2C
PGQAPVLVIYYDSDRPSGIPER	IGLV3-21
GFFDPNTHENLTYVQLLQR	EPPK1
LAAVAQGLQQTSIPK	RGPD2
HQTFAHEVDGRSEQVHGVINLGNSLIER	SPTA1
SGAPPVINLLGTSFPDDTAVQPSFQVGVPLSTAPR	PGAP6
SNTIQSGPEGSLVNSQSLK	LRRC8C
DAAYPPGPPSNLHVTDTTK	TTN
DAHVTPGSGALQGQSVSVWELLFYR	EPPK1
AQQEQAAHQATLR	TACC2
HQLPLDDASLSFAHANCTLIISYQKPK	DPCD
STETQPSSTAPK	CFAP97
LCFVALDFEQEMATVASSSSLEK	POTEJ,POTEI,srpk1a,POTEE
GQNDEENIQETSQVKK	MACROD2
VLHASLQSVLHK	EXOSC7
IKGVTCEDVNECEVFPGICPNGR	FBN2
GPLEELLHTLQLLEKEPDALPRPR	CEP131
CKYVSLIYTNYEAGK	GSTP1
NVHFNYPSR	ABCB1
TLTEEEVEEVLKNIFK	NAT2
ASSDMSASAGYEEISDPNMEEK	SH3PXD2B
RGHDAMIAYDALLAAGNSWTELCHR	ADPRHL1
LCHCPVGYTGPFCDVDTK	F12
AGEGSYALDSESCMEK	PES1
KHTGSGILSMVNAGPNTNGSQFFICTAK	PPIAL4E,PPIAL4F,PPIAL4H,PPIAL4C
SATSLESESDNNSCR	ARHGEF28
YFSTSVSWPGRGEPR	HLA-C
SQENKGEDAPLDQGSGAILASTFSNSGSYFALTDDSKR	WDR4
GPGGAWAAEVISDAR	SAA1
VQVLAAQLLSEMK	MEAK7
EFHNCQDALELSSFQNVIMR	DNAH7
NTLYLQMHSLR	IGHV3-30
EDSDPTPVNPCYDGSHMCDTTAR	NID2
KGTSEPVLDPQQTQAFDQLCR	VPS8
RANGEAPSALPYCYFLQK	EEF1D
LFVLESQNGSQGLQLEAAR	SUSD5
RRECDNPAPQNGGASCLGR	C8A
QAPAEDQVAASPLEPPVPR	DGKG
ETPVDLHLPR	SERPINB3
GSSVSQDSDSQGHSEDSERR	FLG
STFQSVVSESPQEDSAGDTSGAEMTSGVSR	SYNM
ISGISFITIGLSTVVNEAK	COL28A1
TSEDASEYYENYIEELK	PARP4
ALSPPHDTENPYSAK	NTN4
LQPNLTDEEVLLLSMR	DNAH2
LTAEFEEAQTSACLLQEELEKLR	RRBP1
LAKDVASLSSQIQDTQELLQEETR	MYH11
KFSKEEPVSSGPEEAAGK	NOP56
YFEVEEADGHK	CPOX
LYHLSDSEGNLVVR	VIL1
SQMTEPGPEVK	IMPACT
DEDTAVYYCAR	IGHV3-48
EVTERAENEEEINAELTAKK	MYH2
KFDEFQTGILLYELLHQPNPFEVR	PRAG1
PGPGPAAGAALPDQSFLWNVFQR	PDCD6
FQDTNGKHLLPK	PGD
VLGTSVESIMASEDR	CPS1
EAAAAAAATHQQALR	MIDEAS
GSIYIGGAPDVATLTGGR	HSPG2
NFDDAFLPVLKPHLEHLVADTHESTQR	PSME4
APWIEQERPEYWDQETR	HLA-A
AAASHLFPFEK	XPC
HEGQYLRPGEDER	LAMC3
DEAASTSSTYNFTYYDR	HPS4
SCSGPASGSGSGPGPSSGPGAAPAADKER	BTBD11
LQHLVNELTHDIITK	SERPINA1
DASTSPPNRETIGSAQCK	PCM1
AVPTAPTR	LRP3
QEPFLLSGGDDGALK	GRWD1
RFGIQAQLVTTDFQK	PSMB3
DGADVASIHLLTAR	TG
ITQQLTFLHFQR	FASTKD1
DKLGPELPLAMDR	ALPP
EKSSQESGEEAGSQENHPQESK	CHGB
AYQYHSYNGWNR	DNAJC10
WELLQQMNVDTRPINLEPIFQGYIDSLKR	KRT2
VVEYLLPADK	PLIN1
VTLNGVPAQPLGLR	ICAM1
NAHVPIQTEGVNTADEPTTFKK	TASOR2
MCSADYAGLLQTFQVFILDELTAR	TG
LQEQQRQEEEER	KIAA2012
LLIYAASNLQSGVPSR	IGKV1-39
LVQFWAPHLVGPHLGLETGNGRGIINLNAFDPTLPK	FAHD2B
GSAVPVDGYISGLLNDIQK	PAK6
NSLEFFTMLAQR	GNL3
EEVESFASFFPLPGLPDF	SHMT1
DYLATYYSFNGSPSPEAEMLK	INMT
RDELLAQHAAGALGLPNLVAVLTR	EPPK1
AHAFVVQQK	PLEC
GVSSPDHIFLPIPNWEHKENPETEEDVGPVVQHIYELR	ITGAV
AVKQFEESQGR	TG
KEQGVLTGMNETSVIIAAPQNFTPSVIFQK	AP3B1
AGEPNSPDAEEANSPDVTAGCDQAGVHPPR	NSUN2
KVPSRPPPHYPGIK	DYSF
SIIMCRVSLLDGTDVSVDLPK	EPB41L5
LTFDEYRNNSQK	ANXA3
ENYLTVGLTVGQVRPLVPLQPVTQNR	PKP2
ASPGHTLCR	GYG2
EAGAQEPLVDGCSGGGR	ERMP1
VVELPTQEPEVGSTCLASGWGSIEPENFSFPDDLQCVDLK	KLK1
ELLTDHRVPSLLLEAMK	RILP
TALATGQLPGR	PAK6
ESDWLSQSMFTCR	IGHM
LMIYDVSNRPSGVSNR	IGLV2-14
GTAAAAAAAAAAAAK	RPL14
MYYSAVDPTKDIFTGLIGPMK	CP
PMSLGSWQSLALSSVVVDPSIR	TG
VAGALAEAGVGLEEIAKQVNVVTK	TKFC
QSAAELDLVLQR	USE1
SSQSLVHSDGNTYLNWFQQRPGQSPR	IGKV2-30,IGKV2D-30
DVNVENVNQHR	MTTP
WTAVVVPSGEEQR	
GYPGVQGPEDLEWERYR	CHGB
SLSSAINASTGDYLLESVNK	SERPINB2
LMLLNTPGQLPQTLSSPSTR	TSC1
EKDPEMFCDPFTSATTTTNK	EPS15
AVEVATVVIQPTVLR	PTGFRN
DLLLSEIPSSTASLCSR	IRAK2
VPTNLAVEEALSLQDGCR	SYNE1
ASQGISNFLAWYQQKPGK	IGKV1-27
GLATDVATFTQGAAPGREDTGLLTTTHGPEEAPR	PLIN4
GGGAGFISGLTYLELDNPAGNK	C7
SPPDISHGVVAHMSDSYQYGEEVTYK	CFH
LVLSTFSNIREELGHLQNDLTSLENDK	POF1B
STGQLNMNPGTTSSNTATAER	FRY
AEAPGSPAVVLPGR	CRB2
NAIAEPAVQR	CD99
SPHSSTGVKVLAFLSLAEVGQVAGPGPQR	CAND2
AEVSPEPLR	CROCC2
NTECAPGLGAQYPLQLNK	TNFRSF11A
EAVSSSQGPSDPTDR	PMS2
ATDKDITDTLSNPEVFNYGVETHEAYK	NQO2
EQSFTSLEVR	ATRX
ENYLEATVWIHGDSEENK	DIS3
MEWNGMKWNGMEWNGMEWNGMEWK	PCSK5
SVKHDPIPAADTFEDLSDVEGGGSEPTQR	ASMTL
NPSAMAVESFTATAPFVQIGR	TMEM43
ADLATAPPHVTIVR	LRRC47
IIVATIENAQPILQIDNAR	KRT16
LLPSFVSSENAFYLSPHIR	COL6A3
AQVSNEDCLQVK	PSCA
FHDLRPDEVANLFQTTQR	FHIT
FSESTAMGASR	FMNL1
GAALKVGQMLSIQDNSFISPQLQR	COQ8B
QGPYFEQPLQWK	MYOM3
ELHMEDSDKPLLSSLFNAAGVLVEAR	GSDMB
ETDAHLANPVLPNEVLQEAVPGSIR	ERCC2
FDAIHEEFPR	CELSR1
LSCAASGFTFSNAWMNWVR	IGHV3-15
QSGPGAPNLDCFYQQVTK	SEC16A
GKCEEAEECPYQVSLPPLTIQLPK	FGL2
STHSLAILGPENPK	PITRM1
LLLEAGADPTVQDCR	ANKZF1
SVDALDDLTPPSTAESGSRSPTSNGGRR	LSR
LSPQDPSEDVSSMDPLK	HS1BP3
GLHLNLGNTIMKDYEYLWNTVSK	DDX60
LVVQQAGQADAGEYSCEAGSQR	OBSCN
EDLGHLCVWSDGCR	PLXND1
QVPELPVIR	LDAH
SSSSYHTWNTGTEGSFVER	GEMIN5
EGSVGSTSDYVSQSYSYSSILNK	USP47
ELGIEESIPETAADK	CLOCK
QIDQFASEVER	BDH2
ELNESLQVAERLTR	CLU
SHCGPNPCFR	THBS3
WCQSMQDPSLNLR	CROT
VIGIDHIKELVDDSINNVR	PCMT1
LNEGSSAMANGVEEKEPEAPEM	SEPTIN9
EGEDPQASAQDETPITSAK	AKAP12
RENPAEPGAVTGSATVTAFWR	ASPDH
VPAQESQDGSGSRPAAPLIGAPANSEDTHLVDPK	CDKN1B
SPPVGSGPASGVEPTSFPVESEAR	SRA1
FLFHPGDTVSSTAR	TMEM176B
NTFQLLHEILVIEDPIQAER	USP24
SYGLLVVPEPAGCTPELPGEIIK	DROSHA
DSPETEESPAPEPR	HEPACAM
KTEDRFVPSSSK	LUZP1
NHLGSAWEESRDGSRHPGSHQEDR	FLG
ASQGISNFLAWYQQK	IGKV1-27
TSDPALCPLIVSAAADSAVR	ELP2
AAMRETWLNENQR	SPTB
KQYDQFGNDKSQAAR	DNAJB12
RIIESYFR	P3H1
HLEESSTLDPHTK	NID2
FVFSLQTIPR	SLCO2A1
LLEGEMQPAINAEDADLSK	AKAP5
PATPATPGAPTSPAEHR	DMAC1
YLPHHSAHSSQLDADSWIENDSLSVDKHGDNQPDSSSLK	TRAPPC10
VSTIAGIGIQGTDK	NHLRC2
QAIDDDCNQTGQMTAGFLDWPQGTFASQVMLEGDK	ETFB
KAPPRPGPVPEAAQPFLFTTR	MYH14
MTQSPSSLSASTGDR	IGKV1-8
MLDAQVQTDPVSIGPVGKPK	BCAS1
EHLPDEFIK	NMI
TAHDSNVLHIAR	WDR41
KLQGIPPSGPAGELKFEPHI	NUCB2
QEIAAESSENVDCLENPK	LRRFIP1
STTELDDYSTNKNGNNKYLDQIGNTTSSQR	LMO7
NLQTQQASLQSENTHFENENQKLQQK	MIA2
GDFAAAAANLQTCLAVLGR	SREBF2
KLSLANLIHDMSR	HBS1L
NSVSLTCEASGIPLPSTTWFK	HMCN1
VQVLAAQLLSEMKLQDGKR	MEAK7
SGMEPQVALPSPWPGEGR	CCDC187
QHNEDILQYK	NDUFC1
SKLEDNIRR	APOL1,apol1
SSPGDSPSAVSSNLSPSASPTSSR	IRAG1
AAGAAEAAVAAVEEVGSAGHFEELLR	GLRX3
VSAEAEVALVSPEVTQEVVEEHCASPEDK	MAP1B
SRDPHETQNLATDPHFAQLLEMLR	SGSH
LSVADQEKVDK	ENO3
KEDVFKDNFDEMDR	TUBG2
FEIGEGEKLDLPYGLER	FKBP4
MVWDSQVSEHFFEYK	CHID1
EHLPDEFIKDEQNK	NMI
GLFCDFGSPANR	CCN2
DNWNRPICSAPGPLFDVMER	SPTLC3
SGLITSQYFYELQENLEK	MAST2
KMTLDLNDENDAGNLITFPK	STK31
LYNPASGTISLDGHDIR	ABCB10
PGIPGGTASLLEPTSGALGLFQGSPAR	WDR62
NEEALQVPR	CCDC69
SRGPGAPCQNVDECARSPPPCTYGR	LTBP4
PFESIDEGHVTHNWDEVDPDPNQLR	HGD
LNAEESDKLYK	SYNE2
KALAQVFCEESGSSPLLQK	SCFD2
DSLPIPVR	GPSM1
DLLNTNDYEEYK	SPEF2
TLTPVGHQSVSPGGTTMTPVHFQTETLR	OVGP1
SLEENLATAKHNLLR	LZTFL1
GLEWIGSIHYR	IGHV4-39
FLDKDGLISK	CYP1B1
CSNEAVFAVDFHPTDTNIIVTCGK	EML1
VVGVAIDLPVWVPKPSVDLK	CFAP74
EASQGSSASSAPQSVK	ZNF830
TTLPQDCSNPAPLSSPFNGVHDR	GLB1
GSFPAMITPACQIAK	NRAP
GKASGSFVVVQK	HP1BP3
TVASPGVSVEEAVEQIDIGGVTLLR	ATIC
YCLCEDENHEVGSEEEEIPFR	RNF113B
LLIYGNTNRPSGVPDR	
LGADMEDVR	APOE
PQGPPQQGGHPCPPR	PRH2
RPEETTVSVQSAESSDALSWSR	ITPKB
FSGVPDRFSGSGATDFTLK	IGKV2D-24
EVNEVSQHFQTTK	NIBAN1
IAGAIGPCISLNVK	SEC23B
SFNGFSSAQKNQEQLLTLASILR	HEBP2
QEVPIGTDPISK	FAM120B
HNYEVAYR	HLA-DQB1
RTTRLQQQHSEQPPLQPSPVTTR	TOR1AIP1
RPALNYPVYGEMTQVR	PRG4
SSMSPTTNVLLSPLSVATALSALSLGAEQRTESIIHR	SERPINF1
VQLTPVEEAHQQLER	MYO18A
KKLDDQSEDEALELEGPLITPGSGTAVLYIGPLK	FERMT2
KHGGSIVNIIVPTK	PECR
EALDVLDAVLK	MRPS27
CVLLSNLSSTSHIPEVDPGSAELQK	FASN
DQGDCCINYSSVCQGEK	ENPP1
LIQLVNAQQAK	MAN2B1
FSTVADTPELLR	NRAP
VFQAVEQASNLTQAPEEEPIPLDQLGGSCR	DPEP1
NTLYLQMHSLRTEDTAVYYCAR	IGHV3-30
DITYQYKYPEGSSEER	TGM4
CIYNQEESVR	HLA-DRB1,HLA-DRB5
LYVEPAAPPGAPTYIPTLEPVSR	TTN
GSGVGEQNGGLIGAEEK	APLP2
NALEAQNEIHTK	MYO5C
ESDQHVVPTAPDTEADNCIVHELTGQSSLLR	PIEZO1
FLNPNTLER	EPPK1
DSSAMAVDAICTHRPDPEDLGLDR	MUC16
TKAAAAAAAAAPAAAATAATTAATTAATAAQ	SRP14
LISPQHNQSK	SPTA1
SISIIDSPGILSGEK	EHD4
VGEAGLLSVNCSEAGPGALGLEAVSDSGTK	FLNB
AENEEEINAELTAK	MYH2
QCTVLDTYPGVSEADAGETLSSTGPFALEPDATGTSK	SON
LGHFLEHVLGSGLVTDGTMATDQR	D2HGDH
ALELAGQANR	GIP
SQPAASTLESESVQR	MKI67
AGSHTAQNSDVFVPESDRSDYNCTGGTEVLANSNR	SETX
VDLLCTYLQPFSGPGLPIK	MUC16
KFSLDALITNVLPFEK	ADH1C
NALTGLPSGLFQASATLDTLVLK	LRG1
ASEDPLLNLVSPLGCEVDVEEGDVGRDSK	NPEPL1
ILDILISDLSCHVIEPSYK	ZPBP2
LHPDKNPNNPNAHGNFLKINR	DNAJC10
AVLDEAVVVLQAAFR	IQCE
GHEVTVLASSASILFDPNYSSTLK	UGT2B10
DSGTCHSCPPNTILK	ELAPOR1
RLSLESEGAAEGAAASPELSALEEAFRR	TPPP
KEPEVIVVSQPTEPQPVLIPSININSDSGENKEEIGSLSK	SLK
CSGLLQVIFSPLEEEVKAGIYSKPGGYR	GBP1
VPGDQTSTIIRELEPGVEYFIR	TNC
EEENASVTDSAELQAYPALVVEK	PRKDC
GLAPGQPVTLR	ACOT2
DVQEFINNPKWYTDR	BCS1L
TSDYEQSETSKPALAQPASAKPVER	NEB
LFLVSPLIISHEINEK	KCNJ5
LSAASSASSLASAGSAEGVGGAPTPK	ABI3
GGGFGGGSGFGGGSGFSGGGFGGGGFGGGR	KRT2
LIPGVEYLVSIITMK	TNC
HAGPVPVQVPLR	EHBP1L1
RELNESLQVAER	CLU
AEEEFFDIIFTELKK	DNAI2
SNKPVTIISVISHPSDVMEIR	NOX4
IQDALCALEGSQALEPK	SNX19
EEGWLAEHMLVLGITNPEGEK	PCK1
IGCNTCVCR	VWF
AMTAYWTNFAK	CEL
REEAEESGPQLAPLGVPAPEPKPEPEPPAR	EFHD1
NTVYLQMNSLRAEDTAVYYCAR	IGHV3-74
APQDQVDIAVQELLQLK	EPRS1
QGGPPGPTRPLTSSSAK	ASPSCR1
KCCVECPPCPAPPVAGPSVFLFPQNPR	IGHG2
RQESSSSLEMPSGVALEEGAHMLR	TRAPPC10
ELQDGIGQWQTVVR	DMD
ALFNYNPNEDKAIPCK	MPP7
MEEDIKEEEEK	PCMTD1
IIEDDEKPVDLTAGR	PCLO
EEIPTDSSLVTPVDRPVLTK	CMYA5
ISHVVIEDTVVSDK	WAPL
GDSAPAAAK	PALM
TVVQLEGDNKLVTAFKNIK	FABP1
GRAPPRPSGLPGTPGPR	WNT6
LNASEVGHK	SYNRG
AGEGLDQVR	BCO2
QQHMVQGESETADVSPNNMQV	ERICH3
NWHNSVTACQEVR	CLEC4M
SQPNLDTCAFHEQPELK	CST4
NDVGPYECGIQNK	CEACAM5
AWLSSQAAELER	NES
AHMGVFTELAILYSK	CLTCL1
KILGAFMQIITFR	LPO
EFMEVEEGTDVNIVAK	TTN
GFHPDPEALKGFHPNPEALK	C17orf97
KQCQQLQTAIAEVEQR	KRT79
VGLVASQKNNLDAVALMHPDGSAVVVVLNR	GBA
EENDDFASFRVDRTER	HRG
PGQSPVLVIYQDNK	IGLV3-1
IQILNNWMEAQEER	SYNE2
GPWALEEESLGREPEER	LAD1
NDNIPEQDSLGLSNLQK	
AATMENAVLLETNTVEEK	RIF1
ILAAQGQVSAQGGAQPSVEAPAAPRPTATQLTR	SLC25A22
NPSLIPLLLEAR	ANKRD22
KFQTNLVPYPR	TUBA1C
SPAADAKPAPK	LAD1
ASGQESEEVADNYQPVR	RNF168
GLGTDESILIEVLCTR	ANXA13
FGGGIGVPTKEER	WDR17
NTVEIFKFEEGENSLLHLK	PON2
FLSLESDR	IKBIP
CPGSLPEGQNNPQVCPYNLYAEQLSGSSFTCPR	HGD
SVEDVRPHHTDANNQSACFEAPDQKTLSTPQEER	PRRC2C
SLDFNTLVDNLSVDPETGDLWVGCHPNGMK	PON1
GAPAGAGSGTQTGTGTGAR	PTPN18
CGTDWEEYIK	ARMT1
TPEVTCVVVDVSHEDPEVQFNWYVDGMEVHNAKTK	IGHG2
SYGGDSTGGRPR	PAPLN
SWLSSSQGVVLTAYHPSGKDQAVGNSHAK	ARHGAP18
LGLDFPNGMLGSLVAQLSFPGFPSIQLPYLIDGTHK	GSTM1
MYSHPLHNDPDLETVYTLCEK	MTREX
SVSSFPVPQDNVDAHPGSGK	ATG16L1
NGLLTNHYVCEVDGQNVIR	SDCBP2
TDQALVGSLVSSTCGVCGK	MICALL2
CDCTPCGTEACDPR	LAMA5
DLGSMSHLTGYETER	COQ6
SSPSSVTNSSYDGESDSQHHLSCEPVFQTNR	CRYBG3
RQEILEEEGEGQEPPLEAER	CRACD
GFYPSDIAVEWESSGQPENNYK	IGHG3
GDEASEEWQNGSSPK	ADD1
QLQIFDPR	CORO7
IQQHLGEEASPR	ARHGEF40
DGGMHSDPVSLNVLYGPDLPSIYPSFTYYR	PSG5
SAPATSRPGSAPTPGAPGEADLR	LMTK3
KEPEVIVVSQPTEPQPVLIPSININSDSGENK	SLK
TQVNTQAEQLR	APOA4
RPHPEDGDEQSLEGVSSSGDSAGLEAGQGPGADEPGLSR	ZSCAN18
HPTIQGFASVAQEETEILTADMDAER	CFI
EVAVGDSTGMALAR	LOXL1
SLLDQENCNASPEPGAEAGAGAGGGADGFPALACSLEEK	FEZ2
MEVDQPEPADTQPEDVSESK	EP300
SDLSLIQQQQQQQQQQQQQQQQK	FAM171B
DQAVGNSHAK	ARHGAP18
TLTYFNYDQSGDFQTLTFEGPEIRK	COL14A1
IISHFSQDDFTALVQMTEK	ASCC3
VLTGTGNVNVIQPNYPAAAR	MTG1
ATMGTPGGK	SLCO2B1
ISEKQEEIISILEEK	PRUNE2
PGFFFEPTVFTGVEDHMFIAK	ALDH1L1
CVDGHCVCNPGFTGEDCGSR	TNXB
WISAMEDQLQSDDPGKDLTSVNR	SPTB
RKEEEEEDDDDDDSK	CHD4
ELYIPLGESEVAGGASHSSGQR	SYNM
QGISNWLGNMLQFLR	CYP8B1
ATPENYVHQLR	HLA-DPB1
HLANTDVPIPTHYFVVLTNCK	ENPP3
EPVELGQPNTLICHIDR	HLA-DPA1
TLGDRFSASAVETRPSIWGECPPK	MYLK
DYDSLAQPGFFDRFLR	COL6A2
LIIYAQLTGK	VWA5A
VENLLFHVVSTPTNGQLVLSR	FRAS1
VEEEPEEEPEETAEDTTEDTEQDEDEEMDVGTDEEETAK	HSP90B1
TEASTELAGTVAHELQGVHQGEFGSEK	PCNT
VPEARPNSMVVEHPEFLR	GSN
KFPESETK	SERPINB5
LGPELPLAMDR	ALPP
DMAGAQAAAVALNEEFLK	DSG2
YQEEPPAPQPK	TJP2
QRVQEALLQLSQALSLMETVK	PLIN3
AASAAAAPHLLLLPPPPPAAPPPAGACSPLGPR	SLAIN1
ASQGVSSYLAWYQQKPGQAPR	IGKV3D-11
AKLPEATPTELAK	GC
LTGSSAQEAASGVALGEAPDHSYESLR	ECH1
GTEEPGEK	SYNE2
ASLIEEDEPAEKENSSK	CEBPZ
QFEESQGR	TG
SVSFEQAVQILQDDVACDIIK	KRR1
QVIITILDQEPDVQNR	MEP1A
INQPDVVCEDPEEEVAPASCSEHCAECER	MUC2
VTGHPKPIIK	TTN
KQVEILNRHPHFK	EPHX1
VPGDQTSTIIR	TNC
EFENLYIENIELRR	WDR37
RCESCAPGYEGNPIQPSGK	HSPG2
GLPAAAAPVCPAASAAAAGGILASEHSR	PIDD1
VFLENVETFIK	ELP1
ALGEDQVAETSAMSDALK	C2CD2
AILQQLLLLR	TBC1D1
TLLPEDTQKLDNFLGEVR	MACF1
GPGLNLPPPIGGAGPPLGLSKPK	PRCC
DPADATEAHESSSRGEAGAPGEEDIQGPTKADTEK	CHGB
VICDNTGLTRVPVDAFQVGK	TPO
RSTSDCGGPKDHPLTCDHPQLSGLFL	LHB
AKPEGALHNNDGLYDPDCDESGLFK	EPCAM
GIHFQDYDTTPFAK	HPGD
MEDSASASLSFAAATGTSTSTPAAPTARK	RSL1D1
IQDVGLVPMGGVMPGAVPAAAAQEAVEEDIPIAK	MRPL12
YVSLIYTNYEVGK	GSTP1
IIDTAGLSEAVGLIMCR	TRIM32
CVVALAIDPNILSLSGK	DHRS1
GTAAAAAAAAAAAK	RPL14
AGPKAEGEEDEVK	SART3
NKPAVEVASTAQGDFPSEK	CMYA5
SNNIFQVGECR	CDC42BPG
CPDNTLGVDCIER	NID1
LLSDHSKPTAETVAPDNTAIPSLRAEDEENEK	SPARCL1
KLAAQEGQFTEPRPEEPPQEK	MYO7B
QAMQPLLGSGAELVGAR	HOXA13
REEMEQLFHDDQGSVTR	TRIP11
SSQSVLYSSNSK	IGKV4-1
WKNEVQIHSGSFQSQVELSNDQEK	APOB
DVFGQEPHPVEDDLYKEPTR	NUGGC
LTSALDQLLQATR	PTX3
GIGCHYLEEGAQCPAPLSYVPR	UGT1A8
CPKALFQPCFLGMESCGIHETTFNSIMK	POTEF
WSETSVEHR	TM9SF1
SVISFVCRPEAGPTNRPMLISLDK	IGF2R
VWPNPEVFDPSR	CYP4A22,CYP4A11
DVNVENVNQHRGEK	MTTP
KLQSYFAACEDETPAIR	PLEKHM2
QAVEMKNKSEEEQSSSSVK	HNRNPC
YGWSANESGQIFICSQEESIKPK	EIF3K
EEPVSSGPEEAAGKSSSK	NOP56
MTNTTYSEPAQNSK	RESF1
SMQDVVEDFKNKYEDEINR	KRT7
GGPEGATTWLMK	EPHX2
DTVNPLYDETLR	SYTL4
KDGPHGSVLEEGLDDYLTHLIEER	CEP120
PDIQPFPQSVSESCPGK	HRG
ILVCLLQGSRDDVSSFVDPALALQDAQNLYAAGEK	ANXA8
ITQQMVCAGYK	KLKB1
VVEKDNDVLLHWAPVEEAGDSTQIIFSK	TBC1D17
DLDEDANGITDDGK	DNTTIP2
ATSYAELCNEYR	SPINK5
TRGIFAVQVDENRR	LAMA2
VNMFPFVGEQQSEFSSFDKNDSR	RBM45
GVLLDISGVLYDSGAGGGK	LHPP
APKLLIYAASNLQSGVPSR	IGKV1-39
FLDKLPQQTADR	STING1
YGPADVEDTTR	EEF1B2
TLLPEDTQK	MACF1
EEGEAPSPAPASEGR	TOPORS
EMNERLEDEEEMNSELTAKK	MYH6
DQQKQQMFENKLIK	SLK
SSQALVASLR	CROCC2
VREVSQPDWMPPPEVTLVLTK	PDIA4
EQLQQEQALLEEIER	PLEC
TPAMIISR	NPIPB13
ASLEAAIADAEQHGELAIK	KRT8
LPQVSPADSGEYMCR	HSPG2
VYPERPHPEDQR	HERPUD1
LEADVHGKPLPTTEWLR	TTN
VDGNRQIVGYAIGTQQATPGPAYSGR	CEACAM5,CEACAM3
ERADEPQWSLYPSNSQVSEEVK	CHGB
DERFEQSANNFYQQQAEGHK	BIN2
MEEEMHTDAK	EXOSC5
KEDLAGSSLEDYVR	GIMAP6
KKQDEEINQIEGER	SH2D4A
AVGKDNFALIPEGTNGVEER	DPYSL4
LAAAAAAQSVYAFSARPLAGGEPVSLGSLR	GPX1
DALTQINIHYGGVQNLCSR	ATP2B4
TFEDSEDSCR	SP140L
WLFPTGGSVR	LAMA5
RGQSEADSDK	DSP
EVAQHDVREGK	PGLYRP2
DSKEPFSSVEIQAALSK	MCM3
FLMGTNSPDSRDGEGPVR	SUMF2
EEVEELFQR	CAPSL
AHQTGQTVTGSGTQTQAGATQTVEQDSSHQTGR	CRNN
HVNALISPGQK	ABCC8
FGQDIISPLLSVR	SCFD1
QLQSLTCNLESLRGTNESLER	GFAP
GCQTITSGK	CDC42BPA
SILTSTTTVEHAPIWRPGTEQSSGSSGSSGGGGGSSSR	NCOR2
KQDEEINQIEGER	SH2D4A
IEPHHTAVLGEGDSVQAENKDPK	PIR
SLEVLVADLVNAQKDSMPDESSQTSLQK	XIAP
LVSELDDANLQVENVRDQALILMNSR	UTRN
GYHASDDGAK	FBLN2
FCQLHSSGARPPAPAIPGLTR	LTBP4
SCGSSTPDEFPTDIPGTKGNFR	EIF2S3
RAEVLGHKTPELAPR	SEPTIN9
RLNEGSSAMANGVEEK	SEPTIN9
AEQIASVQNAQR	TJP2
ETPGRPPDPTGAPLPGPTGDPVKPTSLETPSPPLLSR	PNPLA6
GTDECAIESVAVAATPIPKL	CTSC
EPSGGGSTALLNK	ZFP36L2
QIEELRNQIK	KRT20
EVTFHCHEGYVLHGAPK	SVEP1
RVALEELENKPR	UBR4
WIQPEEDEGK	TNS1
VALEELENKPR	UBR4
ALLNAESLPTHR	EXD2
APSPLYSVEFSEEPFGVIVHR	GAA
KPAFNLSAFGTLSPSLGNSSVLK	NUP153
AQACNLDQSGTNVAK	APOL2
DTVNPLYDETLRYEIPESLLAQR	SYTL4
GLQAQEGTVSWAVEAAPQTSDR	NACAD
EDEGLYTVRVPSPFGPR	MYOM3
MDPNCSCTTGVSCACTGSCK	MT1M
EQSAAGPAAVPGGGSATAVRPPVPAVDFGNAQEAYR	PRODH
GELFWDDGETK	MGAM
AEESMGIGSEEKPGR	PALM3
NDYATMLPDSTEINQDTINRIIK	COL6A2
RNTNSVPETAPAAIPETRR	ADAR
VAPLVFFHFSGARPDQGLALTLLR	TEP1
PGQSPVLVIYQDTK	IGLV3-1
AGTLTVEELGATLTSLLAQAQAR	EPPK1
ASGSFAPISQAPPSFSPPPPLVPPAPEDLRR	SORBS1
QSSNDLFQVNSTSDDEIPR	BTBD8
MPSFGVLAPGK	AHNAK2
FSMPGFKGEGPDVDVKLPK	AHNAK
GIYNQEENVR	HLA-DRB5
SEDCAADLQLR	ITGA9
ENVAFEQEKEGQSNEK	LACTB
CKYVSLIYTNYEVGKDDYVK	GSTP1
YNPVVINFEMQPIHEVLR	C8A
EGLEAAQLK	BHMT
YIESPVLFLREDMGK	TTLL12
GHNQLAYDGK	HLA-B
AEEWLKLLLEYQK	DMD
ALEWLAHISSNDEK	IGHV2-26
DILEDERAAVDTYCR	HLA-DRB1,HLA-DRB5
EAAEDCEVLGQR	TBXAS1
EVTINPDTTCGNDCVCEHR	AMY1B
RLEQNLSGEEHVQELLK	GOLGA1
LSCAASGFTFSSYGMSWVR	IGHV3-23
LGQSDPAPLQHQMEIYQK	TKT
ISDLKICADEFPGSSATYR	METTL2B
ANSYTTKYAASVK	IGHV3OR15-7
NQLEIYNQPNQEGPFDVQETEIAVQAK	DMD
AIAHLATEYVFSDFLLKEPTEPK	PANX1
VAVNGVHSLQYK	LGALS8
TLTEEEVEEVLK	NAT2
NSQATASTSLLGPPPGLLTPPVATELSQNAR	CCAR2
EVMQGTDEHVVCK	IGHM
VLNGNPQQEDGGLAGVTEQQSGAFDRWEMIQAQELHNK	SYNE2
DVLQAAAAEHQDQGQEVSGEVR	GOLGA3
GCFQAEIVPVTTTVQDDKGTKR	ACAA1
RASLAPLQAEHSQPHEK	COBL
TFHEASEDCISRGGTLSTPQTGSENDALYEYLR	CLEC3B
AGAGAGAGAVLK	LAMA1
AGGDTHLGTAPQESQVVVEGGSGEGQGSPSQLLSDDETK	TBC1D9B
SNPEESLRAEQSPSVEENLSIEDLELLEGR	SYNC
SWLTTTSASQDIEK	NEK5
KEFLEPDSWETLDEQQFFTEEELKEYENIIALQENELK	NUCB2
EDHDEALKNTWDLHPTSSK	PRUNE2
ADIEMPFDPSKVVASGPGLQHGK	FLNB
LLALSGPFHYWGPVIDGHFLR	TG
EDEEEEEGENYQKGEQGEDSSEEK	CHGB
IQPEDMFVYDINEKDISGPSPSKK	APIP
NSSRDSGRGDSVSNSGSDALR	PDCD4
STPPSPPTHR	POM121C
QLGIPQTTVFTPVAR	ECM2
GENQSPIELHTK	CA3
QVVVEGQEPAKFWMALGGK	VIL1
VQVQPLELPMVTTIQVSSQLSGR	IFI35
ADNSVPGTPTR	PDE5A
LLGIHSVFCKPQNIR	PEX2
DPADASEAHESSSRGEAGAPGEEDIQGPTNADTEK	CHGB
ESQGERPHLSLLIPR	C17orf80
ALAVWSLDGQQALQVR	GNB1L
LLPWSPEHIDTR	PNLIPRP2
QHPALPQHQASVQNLPSFTVAPDHQTK	MUC12
ANIVASALAQIPQK	UGT2A3
LLSDTDDLILENFYDK	CLGN
SIAATDHEPTDARK	ENPEP
ILPPGEVPLKDLYPK	VWA8
RQDIQSDGFSIETCK	CAPN2
VLEELSMSSGELAFGK	MYO1A
SGAHSFISGLPQGYDTEVGEAGSQLSGGQQQAVALAR	TAP1
ADEVVSASVR	ADAM12
IPDPSAIKPEDWDESEPAQIEDSSVVKPAGWLDDEPK	CLGN
KPAAGLSAAPVPTTPAAGAPLMDFGNDFVPPAPR	RTN4
IVGSPFDPTTEQGPQIDK	ALDH1A2
ETEFSSAGHSLQDK	CEP85
EIDRNSQQEGSR	ARHGEF5
DDPLGEVGVK	HMCN2
EDYDGLKEEFRK	GSTO1
HLPLPYDEVICAANLK	FIG4
VAVVQYSDRTRPEFYLNSYMNQQDVVNAVR	COL6A3
LFGSPLSDYYAYSPVQER	H6PD
LASTLLDAITDKDPLVQEQVCSALCSLGEVRPVETLR	MROH1
LLHGMKDDVVPWHTSMQVADR	ABHD10
METKTESSGIETEPTVHHLPLSTEKVVQETVLVQER	EPB41L3
AEDTAMYYCAK	IGHV3-30
QPSNLPGTVAVHIISSTSLMAV	CAPN5
LQAAYNLVK	PFKM
ILNDLNMAIKPGEMTALVGPSGAGK	ABCB11
GYQSLSDSPPGAR	SEMA4B
ETVWHLEEFGR	HLA-DPA1
IQPEDMFVYDINEK	APIP
FHYLQVAFPGASDADLVPK	ADAP1
LQTNGALPDDLKQGR	CELA2B
DNTRNTVYLQMNSLR	IGHV3-74
TFAEAAGSGETLSVNQLVTFLQHQQR	PLCD1
AQEALLQLSQALSLMETVK	PLIN3
GLCVDGQCVCEDGFTGPDCAELSCPNDCHGR	TNC
IFLQTLDTHHR	MYO1G
LLAAEGSHVTANVVDPGVVNTDLYK	DHRSX
LEAEGEAMEDAAAPGNDR	NDUFV3
VVVNSPANANYQERFNPSALK	LDB3
GIETGSEDMEILPNGLAFISSGLKYPGIK	PON1
VSQGISSYLNWYQQKPGK	IGKV1D-37
GRPGPEGAGPTAGLDVR	KLF16
GADGAAGPR	COL23A1
TGQTILPSLNEVNHSYLSEK	SYNE1
ELESCKPGLLGGSLVLLR	AP5B1
HQLQSADSSRHSGTGQGQASSAVR	FLG
WMQVSNPEAGETVLGGQAQTGASTESGR	CRNN
EFKEEGEEMPR	ACIN1
KQGSTTDNACHLFAELDPNQPASAIVSFVSK	TNS1
RGPGGVWAAEAISDAR	SAA1
EEGLVCQNQDQQGPFK	MUC5AC
SLKPQQQQQQQQQQQQQQQQQQQQQQPPPAAANVR	ATXN2
CHLGPGHQAGPGLHRPPSPR	MUC1
VTTVSESTKR	SIRPA
GNLNFTCNGNSVISPVGNR	Pwp2,PWP2
LGFDISEQEVTAPAPAACQILKER	LHPP
IYVDIGYVDLSTIR	SLCO1B3
LYACEVTHQGLSSPVTK	IGKC
FQQLANISMSGNNLAEILPPALQDIKELQHNVQK	SYNE2
APKVLIYGASSLQSGVPSR	
GHPAVCQPQGR	KPRP
LSCAASGFMFSTYEMNWVR	IGHV3-48
FIRQLIVPNEK	AP3B1
ILPSSLMLPK	CLYBL
CQPGFHSLTEAGCRPCSCDPSGSIDECNVETGR	LAMC1
DDMLCAGNSQR	TPSAB1
SQRPHQGVDVLCSAGSTVYAPFTGMIVGQEKPYQNK	LECT2
VELQDWAGNEAYAEYHFR	FGA
VEKVPSFETAEGIGAELK	SLC30A9
GYPGVQGPEDLEWER	CHGB
GLVEVTIQNLSEEDK	MYOM3
QIAFPSGTPLHANSMVSENVIQSTAVTTVSSGTK	AIMP1
LARPVVPGPR	KLK10
NLGIDFEDIK	AHR
IDGYIISYR	TTN
YTLNEEWLLR	PLXND1
CIKWMGGVGYTK	ACADSB
ASLAPLQAEHSQPHEK	COBL
FRGQFVMEHHTLPDVK	FRAS1
TLSDCPALEGSQNGCQHENAAAVR	LOXL4
RGPDHEPAK	ZC3HAV1
VSLQALEAEAEAGAETEAVLQR	KIAA1522
NNEEYLALIFEKGGSYLAR	QSOX1
KTHTVVQPSVGAAAGPVVPPCPGR	AHSG
TAASGVEASSRPLDHAQPPSSLVIDKESEVYK	PDLIM1
KGEPGAEPGHFGVCVDSLTSDK	MYO9B
SHIYFWTLDGGSLSK	EML2
EVLAQQVQQSLEK	PPP1R21
VHTVMLPPASETFPPGMPCWVTGWGDVDNDEPLSPPFPLK	TPSAB1
IHEDEVDDMEEN	JMJD1C
TGSETPQAPVSGVGPVSGGPGGFGR	PSPC1
DISNDAFTALDPLGDK	DAB2
GLNLEEITVSRPDSK	MACF1
ASQALQSEVDTDLHTL	CD200R1
ESSWVTPESCFYKESWLTGK	IQGAP2
IEEIMPNGDPLLAGHNTVDEVYVSR	STAT2
SSAIKLEVYPTSLTKNDLEDSLLK	UGT2B15
SLLDLENGRSSHVSKR	PPL
HAFRPTNAAAATSHSTASR	PLEKHA1
IVVHKDWNSNQVSK	CELA2B
SMIYKDILLLGNNYVIHR	HNF4G
SNKGESPVEPAEPCR	CD27
DSRPSQAAGDNQGDEVK	THRAP3
YMEDYHQFHEDVKDAQEMLR	PPL
KMDQTMAANAQKNK	CMPK1
DPQVGHPAAQMEPEPAEPLAAAVEAANGAEQTR	SMTN
EVTERAENEEEINAELTAK	MYH2
DAVLKDLGDLIEATGFDR	TTI2
LDHFNFQR	DPP7
ANNSMEQGENLQK	FGD5
MIVSDVMQQAQYDQPLEK	AKAP10
EGQIQGAVHTQCI	C17orf58
HPARAPAQGDSEDR	RPH3A
LKEVFPMAALMPGAEK	PUDP
AFGLQAVDLVYIDFR	CLYBL
QGYHHEQSVDR	FLG
NLDKNTMGYLQWR	DNAJC11
AFSSLNTLPEELRPYVPLFCSILTK	PITRM1
AESHPEVSIEHLGQVVQCSREEGLVCQNQDQQGPFK	MUC5AC
EVLKESQLPTVMDFR	APOB
SQVMDEAMALQLR	PLEC
VQNHCQEPYYQATAAGALTCATPGTWK	C1RL
IIEDDEKPVDLTAGRR	PCLO
GQGWPEEEDGEDVR	MYLK
VPEPDYTKVPEPGSIKVPDQGFIK	SPRR3
VDIPPLIR	TBCK
VWPETPEEKAPAPAPEER	AEBP1
CLFDSLQPER	SHROOM2
NQVVLTMTNMNPVDTATYYCAR	
VISTTNAER	PGM3
GILEGELEGICGAGTWK	GCAT
QSASQLQK	IMMT
IPPGDLVFDPDQR	DUOX2
GQSESTEAPASGPPTGTARPQR	SPHKAP
HAGIGHGQASSAVR	FLG
EPWVEQEGPEYWDRETQK	HLA-C
KLYESLLVGSLPDVNK	GYS1
GMDTINTTFGTAVIK	EFHB
EAGKFSAVSEGQGDPPGGPAPTVLAPMPLAEVELK	GRIPAP1
WELLQQMNVDTRPINLEPIFQGYIDSLK	KRT2
GIYNQEENVRFDSDVGEYR	HLA-DRB5
PYAYWYQQKPGQAPVLVIYK	IGLV3-25
NNCLQGTGFLEEETTR	SLC18A1
DEAEFTCR	SIGLEC9
NSTLSEPGSGRGPPQEEEEEEDEEEEATKEDAEAPGIR	HDGF
RLAALALASSENSSSTPEECEETSEK	NOP56
MYALISDAQPLLLSTFSGDRR	GPLD1
PGGDGEGDPNHIER	ITIH5
ATLVCLVSDFYPGAVTVAWK	IGLC7
VDSAGFGDSVVQYANSR	ITGAX
ELKNGNLEVGVHIADVSHFIRPGNALDQESAR	DIS3
EGGANGITATNTVSGLMGLK	DPYD
NHNSLLSLPQEPYSFSKPAQQAMR	GAA
LAAAAAAQSVYAFSAR	GPX1
KQAEVVDTEWEK	DMD
VEPASAGK	TTN
QVTSSGVSYGGTVSLQDAVTR	SUN1
QAPGQGLEWMGR	IGHV1-69,IGHV1-69D,IGHV1-2
TYGQVSGEAIK	VCAN
SLDPALSMLIK	ESF1
ECTSLCCEALTCK	ADAMDEC1
SLDLDSIINAVR	KRT77
TAMVATVSPAANNYDETLSTLR	KIF13B
LSEEATEEPDAEEPATEELTAQEATAPEEVTK	CT47A3,CT47A8
VKFPTDTLQELLDVHAACER	GBP6
FQNEEEVFAWNNEVK	ALDH7A1
LAAAQGQAPLEPTQDGSAIETCPKGDEPR	EFL1
LENLLLVHYQPGGTAQGFGPAEPTPTSSYPTR	PEAK1
SQQTIPQLHSTVHLIEFAR	PLIN2
RGVESSGQPENNYKTTPPMLDSDGSFFLYSK	IGHG3
LGHCSLSESGCVSGSSSCGGPGNQR	MAP4
VIPIQAHQIVNGAPPARG	GFAP
LIHVMLMDNSTPQSEGGTLK	KDM3B
FSSACDMGGCTGALAR	ASMTL
SDSELNNEVAARK	CYBRD1
LSCEAWNVHGAQSGSILQLPDKK	SIGLEC10
AALAGGTTMIIDHVVPERGTSLLAAFDQWR	DPYSL2
GIPFPSIEVGPEDVEEAR	PLA2G4F
EHDVQNTFEEMEK	CBR4
QALSALEEAGAPAPGRPSPATAPVPSSQPK	MICALL2
KTTPIEAASSGAR	HCLS1
HPPPPPFQNQQRPPQR	PRR4
GIGWVPIGSLDVEK	NEB
LQGSVMELLQDVDGVIKR	TRIM5
ALQNFKEGNAIFTFPNTPVK	SQOR
GEPLHIVNSSNVTDEPLLK	VPS13C
AYPSQKPLAAWTQDLAMR	DNAH2
PCSCDPSGSIDECNVETGR	LAMC1
GGGAGFISGLTYLELDNPAGNKR	C7
NHLGSAWEESRDGSR	FLG
NHHGSAGEQSRDGSRHPGSHQEDR	FLG
SRIMQDQSEGNSLQNQALQTLQER	GOLGA5
SLDVLGWEERQLALVK	PANK4
QADIVTFPEINLMNESTELHTQLAK	SYNE1
MTENHVSQASVTIR	VWA8
GQAGGGGPGTGPGLGEAGSLATCGLPLAK	MSRB2
LISEVDGDGDGEISFQEFLTAAR	CALML5
DIQIGTTLR	USP8
EVLLHPLVAETQLGEAEVALEASGCPPPSR	VSIG10L
QLIVPNEK	AP3B1
LYVEPAAPLGALTYIPTLEPVSR	TTN
DGVLQQPMR	ELP2
SSTPSTTSAPTTSTTSFHTTSTTSPPTSSTSSTPQTSK	MUC5AC
GSSGSQASDSEGHSEDSDTQSVSAHGQAGPHQQSHQQSTR	FLG
LTLDESYDLVVENEEVLTLQETLEALSLSEYFSTFEK	SEC23IP
AAGFEEIEQDLTQR	DDX58
KSDIIIIAIHR	STEAP4
QMASPPSPLSGEFLDTK	LILRB4
YESQEPLAGQESPLSLATR	TNKS1BP1
SPEAPQPVLAMEEPAVPAPLPK	HCLS1
AFFDEEKDHWK	KIF3B
LLDDAMSADK	GLOD4
GAYHGCSPYTLGLTNVGIYK	AGXT2
TSNGQHFHLTSTFTMEDIYQNR	FRAS1
SAVGTATPYLHHPGDSHSGR	COMMD5
LDHGEESNESAESSNNWEK	SMARCAD1
GYCNPGIQLCSVGSYTINFR	ZC3HAV1
KHEAFESDLAAHQDRVEQIAAIAQELNELDYHNAVNVNDR	ACTN2
SRWQQGNIFSCSVMHEALHNHYTQK	IGHG3,IGHG4,IGHG2
QPEVPSLLAK	NIBAN1
LLIAPESAAPEEALGPAEEPEPGR	NLRP6
IREESVMLR	AGMAT
QQDVAQFADFQEVLTTR	SYNC
YFYTAVSRPSR	HLA-C
EEGEEMPR	ACIN1
TQTDSEAQESTATSDETK	ANK2
LKHELTDEELKSLFTNFANVVDK	AFM
AWCMNCFACSTCNTK	LIMS3,LIMS1,LIMS4
QFCVPGFKNNKGVAEVLR	SLC44A2
YATGGWETVFRPVSETCK	FUT8
DESMTAGTSNEEECWNGHSK	GPC6
DLHDQFQHQLR	VPS11
EAPAPPMEPEVPEMSQSK	C1orf87
LGVLHVGQKLEEQDEFEKIFK	SACM1L
MFAKEEAELTQEMSPEK	SIL1
LENNMLMLPSVRPQDAGTYICTATNR	HSPG2
NVVFIDMGHSAYQVSVCAFNK	HSPA4L
VDIKGPQVDVK	AHNAK2
QRSPAPGSPDEEGGAEALAAGIR	SYNM
VWDKSESGNWHCTASWK	SEH1L
VEQIAAIAQELNELDYHNAVNVNDR	ACTN2
DWAQTAFDESISLSAVGYFR	AOX1
LDSTDFTSTIK	TFRC
IDKPSLLTMMK	S100A7A,S100A7
LPQGLPTEENMSNTCLK	MRPL30
CRPQEDTGWVLFPVNK	EPPK1
NYVSAWELQR	WDR18
SAVQGPPDRDLCGCYSVSSVLPGCAEPWNHGK	IGHA1,IGHA2
EDLELIMTEMEIPR	HYPK
LHQLAYDTYQEFEEAYIPK	GH1
QILKQDFETLSQETK	EEA1
PQFLTCGHDK	EML1
ALAAAAADPEGPEAGCSLAWR	SLC27A3
SGHSSYGQHGFGSSQSSGYGQHGSSSGQTSGFGQHK	FLG2
MQYAPNTQVEILPQGR	CAPG
LLIYENNKR	IGLV1-51
GVFPPLLQK	FMO3
FIAPAASLGFR	NUDT6
TLFDTSIGPLVYSDQYLQISAR	SI
TVSLTPSPATQVETPDLVDHDNTSPLFR	PTPN12
VILEEHSACENEVSK	GCFC2
MGFTNVGPNNQPVSFQEIFEAK	SEPTIN14
FDFQGTCNYVLATTGCLGVSTQGLTPFTVTTK	FCGBP
TSLSVDHSR	MYLK
DAVCSGVTGAMNLAR	PLIN4
MDTESELDLISR	MTHFD1
RDAYVSCLNAIYQNNLTK	GSR
WKAPKSPVGVQPILNEHTFCAGMSK	HPR
IYTSGSTNYNPSLK	IGHV4-31,IGHV4-4,IGHV4-61,IGHV4-59
AAMPIVNLKDELLFPSWEALFSGSEGPLKPGAR	COL18A1
ITQSPSSLSASTGDR	IGKV1-8
AVPNMLKDMATETDASLSTLLTETK	TDRKH
YLKHQTFAHEVDGRSEQVHGVINLGNSLIER	SPTA1
YVDEENSDRETSNHR	KRI1
VKTVVQLEGDNKLVTAFK	FABP1
MQQEIAFQQVMSQIANVK	MCUR1
MVSALQQQQQQQR	TNRC6B
NIAFFSTMCLEGTAQGLVVNTGDR	ATP4A
ESGPVLVKPTETLTLTCTISGFSLSNAR	
EVGKDDYVK	GSTP1
STTQELMEDDCVKR	EPPK1
SLQAEPWFFGAIR	FRK
FIEGGDGHLSEDEEIKR	POSTN
KAEGAQNQGR	RRBP1
RAKPEGALHNNDGLYDPDCDESGLFK	EPCAM
DEESYYISEVGAYLTVSDPETVYQGIK	LAMP3
ASQSIRSYLNWYQQKPGK	IGKV1-39
ASAILPGVPGSETLSNEVFQESEEEK	NIBAN1
IKNEPVVFPEGPEISEELKDLILK	CAMKK1
GDVDVSLPKVEGDVK	AHNAK
QEEIISILEEK	PRUNE2
SEQELAEMIEEK	CLIP1
DQPGEPATEFSCQELEAGSLVYVHR	CSPG4
SPVLHFYVRPSGHEGAASGHTR	PFAS
VGDSVEAGDPAGDGVEAEGPAGDSMDAEGPAGR	CLIC6
VTLSALDTSESSFTPLVVIELAQDVKEQTK	ANO10
VLAVPAENYDYQILHK	LAMA3
SLEGSNDAVLLQR	DMD
SHEYQLESWADSQTSSCLCADEAK	A2ML1
IDLTTIVKPEAPFDLSVIYR	IL7R
DTVCSGVTGAVNLAR	PLIN4
STMECPPALIVHPPAGGMASGSSQPWAAASATPMLSSK	KDF1
HVATQHADEIYHQTDSILK	TSTD2
LLQAQAAGVDWREGAR	NOL9
VPVDVACR	EPPK1
NFNLPQLCIWK	GBP3
QLLGFPCVEVSGLSTER	MSLN
HFMPLSDVLYGR	BST1
LPTVTAKEDEEED	DPP6
SSYTHSLNR	MYCT1
VLPQELVDLPLVK	LRCH1
SIQASVDVSALK	AHNAK2
LFLDQDLMTLPIQNK	FECH
GVAEVLRDGDCPAVLIPSK	SLC44A2
TTQNIATGTKNTFGSGVTGAVNVAK	PLIN4
SSQFGIIGNDR	TNKS1BP1
SQFLEEGIGGTIPHVSPER	STEAP2
KPPPAPQQPPPPAPHPQQHPQQHPQNQAHGK	CKAP4
