protein_seq	peptides
MKLLTGLVFCSLVLGVSSRSFFSFLGEAFDGARDMWRAYSDMREANYIGSDKYFHARGNYDAAKRGPGGVWAAEAISDARENIQRFFGHGAEDSLADQAANEWGRSGKDPNHFRPAGLPERY	GPGGVWAAEAISDARENIQR,RGPGGVWAAEAISDARENIQR,GNYDAAKRGPGGVWAAEAISDAR,GPGGVWAAEAISDAR,RGPGGVWAAEAISDAR
MKLLTGLVFCSLVLGVSSRSFFSFLGEAFDGARDMWRAYSDMREANYIGSDKYFHARGNYDAAKRGPGGVWAAEAISDARENIQRFFGHGAEDSLADQAANEWGRSGRDPNHFRPAGLPEKY	GPGGVWAAEAISDARENIQR,RGPGGVWAAEAISDARENIQR,GNYDAAKRGPGGVWAAEAISDAR,GPGGVWAAEAISDAR,RGPGGVWAAEAISDAR
MKLLTGLVFCSLVLGVSSRSFFSFLGEAFDGARDMWRAYSDMREANYIGSDKYFHARGNYDAAKRGPGGVWAAEAISDARENIQRFFGHGAEDSLADQAANEWGRSGDPNHFRPAGLPEKY	GPGGVWAAEAISDARENIQR,RGPGGVWAAEAISDARENIQR,GNYDAAKRGPGGVWAAEAISDAR,GPGGVWAAEAISDAR,RGPGGVWAAEAISDAR
MKLLTGLVFCSLVLGVSSRSFFSFLGEAFDGARDMWRAYSDMREANYIGSDKYFHARGNYDAAKRGPGGVWAAEAISDARENIQRFFGHGAEDSLADQAANEWGRSGKDPNHFRPAGLPEKY	GPGGVWAAEAISDARENIQR,RGPGGVWAAEAISDARENIQR,GNYDAAKRGPGGVWAAEAISDAR,GPGGVWAAEAISDAR,RGPGGVWAAEAISDAR
MGCHSSKSTTVAAESQKLEEECEGREPGLETGTQAADCKDAPLKDGTPEPKS	LEEECEGREPGLETGTQAADCK,LEEECEGREPGLETGTQAADCKDAPLK
MRRSRSSAAAKLRGQKRSGASGASAAPAASAAAALAPSATRTRRSASQAGSKSQAVEKPPSEKPRLRRSSPRAQEEGPGEPPPPELALLPPPPPPPPTPATPTSSASNLDLGEQRERWETFQKRQKLTSEGAAKLLLDTFEYQGLVKHTGGCHCGAVRFEVWASADLHIFDCNCSICKKKQNRHFIVPASRFKLLKGAEHITTYTFNTHKAQHTFCKRCGVQSFYTPRSNPGGFGIAPHCLDEGTVRSMVTEEFNGSDWEKAMKEHKTIKNMSKE	SGASGASAAPAASAAAALAPSATR,RSGASGASAAPAASAAAALAPSATR,SGASGASAAPAASAAAALAPSATRTR
MRRSRSSAAAKLRGQKRSGASGASAAPAASAAAALAPSATRTRRSASQAGSKSQAVEKPPSEKPRLRRSSPRAQEEGPGEPPPPELALLPPPPPPPPTPATPTSSASNLDLGEQRERWETFQKRQKLTSEGAAKLLLDTFEYQGLVKHTGGCHCGAVRFEVWASADLHIFDCKYRNYI	SGASGASAAPAASAAAALAPSATR,RSGASGASAAPAASAAAALAPSATR,SGASGASAAPAASAAAALAPSATRTR
MVCLKLPGGSYMAVLTVTLMVLSSPLALAGDTRPCFLQQDKYECHFFNGTERVRFLHRGIYNQEENVRFDSDVGEYRAVTELGRPDAEYWNSQKDILEQARRGGHLLQTQLRGCGELHSAAASAGDCVSCKDPDPAAPQPPGLLCEWFLSRQHSQVVPERPGREGWGGVHRPDSEWRLDLPDSGDAGNSSSEWRGLHLPSGAPKRDEPSHSGMESTVICTEQDAEWNRGLCAGPALPWGRAIHLLQESERALWTSPNRTREL	GIYNQEENVRFDSDVGEYR,GIYNQEENVR
MVCLKLPGGSYMAVLTVTLMVLSSPLALAGDTRPCFLQQDKYECHFFNGTERVRFLHRGIYNQEENVRFDSDVGEYRAVTELGRPDAEYWNSQKDILEQARRGGHLLQTQLRGCGELHSAAASAGDCVSCKDPDPAAPQPPGLLCEWFLSRQHSQVVPERPGREGWGGVHRPDSEWRLDLPDSGDAGNSSSEWRGLHLPSGAPKRDEPSHSGMESTVICTEQDAEWSRGLCAGPALPWGRAIHLLQESERALWTSPNRTREL	GIYNQEENVRFDSDVGEYR,GIYNQEENVR
MVCLRLPGGSCMAVLTVTLMVLSSPLALAGDTRPRFLEYSTGECYFFNGTERVRLLERHFHNQEELLRFDSDVGEFRAVTELGRPVAESWNSQKDILEQARRGGHLLQTQLRGCGELHSAAASPSGDCVSFKDPAPAAPQPPGLFCEWFLSRQHSQVVPEWPGREDWGGVHGPDPQWRLDLPDPGDAGNSSSEWRGLHLPSGAPKRDKPSHSGMESTVICTEQDAEWSRGLCAGPALPWGRAVHLLQESERTLWTSAKRIPEL	HFHNQEELLRFDSDVGEFR,HFHNQEELLR
MVFRRFVEVGRVAYVSFGPHAGKLVAIVDVIDQNRALVDGPCTQVRRQAMPFKCMQLTDFILKFPHSAHQKYVRQAWQKADINTKWAATRWAKKIEARERKAKMTDFDRFKVMKAKKMRNRIIKNEVKKLQKAALLKASPKKAPGTKGTAAAAAAAAAAAAAAAKVPAKKITAASKKAPAQKVPAQKATGQKAAPAPKAQKGQKAPAQKAPAPKASGKKA	KAPGTKGTAAAAAAAAAAAAAAAK,GTAAAAAAAAAAAAAAAK,GTAAAAAAAAAAAAAAAKVPAKK
MEFGLSWVFLVALLRGVQCQVQLVESGGGVVQPGRSLRLSCAASGFTFSTYGMHWVRQAPGKGLEWVTIISYDGSIQYYADSVKGRFTISRDNSKNTLYLQMNSLRAEDTAVYFCAK	LSCAASGFTFSTYGMHWVR,AEDTAVYFCAK
MDWTWRILFLVAAATGAHSQVQLVQSGAEVKKPGASVKVSCKASGYTYTDYYMHWVRQAPGQGLEWMGWINPNSGGTNYAQKFQGRVTMTRDTSISTAYMDLSRLRSDDTAVYYCAR	ASGYTYTDYYMHWVR,DTSISTAYMDLSR
MLLLAPQMLSLLLLALPVLASPAYAAPAPVQALQQAGIVGGQEAPRSKWPWQVSLRVRDRYWMHFCGGSLIHPQWVLTAAHCLGPDVKDLAALRVQLREQHLYYQDQLLPVSRIIVHPQFYIIQTGADIALLELEEPVNISSRVHTVMLPPASETFPPGMPCWVTGWGDVDNDEPLSPPFPLKQVKVPIMENHICDAKYHLGAYTGDDVRIIRDDMLCAGNSQRDSCKGDSGGPLVCKVNGTWLQAGVVSWDEGCAQPNRPGIYTRVTYYLDWIHHYVPKKP	IIRDDMLCAGNSQR,DDMLCAGNSQR
MLSLLLLALPVLASPAYAAPAPVQALQQAGIVGGQEAPRSKWPWQVSLRVRDRYWMHFCGGSLIHPQWVLTAAHCLGPVQLREQHLYYQDQLLPVSRIIVHPQFYIIQTGADIALLELEEPVNISSRVHTVMLPPASETFPPGMPCWVTGWGDVDNDEPLSPPFPLKQVKVPIMENHICDAKYHLGAYTGDDVRIIRDDMLCAGNSQRDSCKGDSGGPLVCKVNGTWLQAGVVSWDEGCAQPNRPGIYTRVTYYLDWIHHYVPKKP	IIRDDMLCAGNSQR,DDMLCAGNSQR
MLSLLLLALPVLASRAYAAPAPVQALQQAGIVGGQEAPRSKWPWQVSLRVRDRYWMHFCGGSLIHPQWVLTAAHCLGPDVKDLATLRVQLREQHLYYQDQLLPVSRIIVHPQFYIIQTGADIALLELEEPVNISSRVHTVMLPPASETFPPGMPCWVTGWGDVDNDEPLPPPFPLKQVKVPIMENHICDAKYHLGAYTGDDVRIIRDDMLCAGNSQRDSCKGDSGGPLVCKVNGTWLQAGVVSWDEGCAQPNRPGIYTRVTYYLDWIHHYVPKKP	IIRDDMLCAGNSQR,DDMLCAGNSQR
MLLLAPQMLSLLLLALPVLASPAYAAPAPVQALQQAGIVGGQEAPRSKWPWQVSLRVRDRYWMHFCGGSLIHPQWVLTAAHCLGPDVKDLATLRVQLREQHLYYQDQLLPVSRIIVHPQFYIIQTGADIALLELEEPVNISSRVHTVMLPPASETFPPGMPCWVTGWGDVDNDEPLPPPFPLKQVKVPIMENHICDAKYHLGAYTGDDVRIIRDDMLCAGNSQRDSCKGDSGGPLVCKVNGTWLQAGVVSWDEGCAQPNRPGIYTRVTYYLDWIHHYVPKKP	IIRDDMLCAGNSQR,DDMLCAGNSQR
MLSLLLLALPVLASRAYAAPAPVQALQQAGIVGGQEAPRSKWPWQVSLRVRDPYWMHFCGGSLIHPQWVLTAAHCLGPDVKDLATLRVQLREQHLYYQDQLLPVSRIIVHPQFYIIQTGADIALLELEEPVNISSRVHTVMLPPASETFPPGMPCWVTGWGDVDNDEPLPPPFPLKQVKVPIMENHICDAKYHLGAYTGDDVRIIRDDMLCAGNSQRDSCKGDSGGPLVCKVNGTWLQAGVVSWDEGCAQPNRPGIYTRVTYYLDWIHHYVPKKP	IIRDDMLCAGNSQR,DDMLCAGNSQR
MLLLAPQMLSLLLLALPVLASRAYAAPAPVQALQQAGIVGGQEAPRSKWPWQVSLRVRDPYWMHFCGGSLIHPQWVLTAAHCLGPDVKDLATLRVQLREQHLYYQDQLLPVSRIIVHPQFYIIQTGADIALLELEEPVNISSRVHTVMLPPASETFPPGMPCWVTGWGDVDNDEPLPPPFPLKQVKVPIMENHICDAKYHLGAYTGDDVRIIRDDMLCAGNSQRDSCKGDSGGPLVCKVNGTWLQAGVVSWDEGCAQPNRPGIYTRVTYYLDWIHHYVPKKP	IIRDDMLCAGNSQR,DDMLCAGNSQR
MLSLLLLALPVLASRAYAAPAPVQALQQAGIVGGQEAPRSKWPWQVSLRVRDPYWMHFCGGSLIHPQWVLTAAHCLGPVQLREQHLYYQDQLLPVSRIIVHPQFYIIQTGADIALLELEEPVNISSRVHTVMLPPASETFPPGMPCWVTGWGDVDNDEPLPPPFPLKQVKVPIMENHICDAKYHLGAYTGDDVRIIRDDMLCAGNSQRDSCKGDSGGPLVCKVNGTWLQAGVVSWDEGCAQPNRPGIYTRVTYYLDWIHHYVPKKP	IIRDDMLCAGNSQR,DDMLCAGNSQR
MLSLLLLALPVLASPAYAAPAPVQALQQAGIVGGQEAPRSKWPWQVSLRVRDRYWMHFCGGSLIHPQWVLTAAHCLGPDVKDLAALRVQLREQHLYYQDQLLPVSRIIVHPQFYIIQTGADIALLELEEPVNISSRVHTVMLPPASETFPPGMPCWVTGWGDVDNDEPLSPPFPLKQVKVPIMENHICDAKYHLGAYTGDDVRIIRDDMLCAGNSQRDSCKGDSGGPLVCKVNGTWLQAGVVSWDEGCAQPNRPGIYTRVTYYLDWIHHYVPKKP	IIRDDMLCAGNSQR,DDMLCAGNSQR
MLSLLLLALPVLASPAYAAPAPVQALQQAGIVGGQEAPRSKWPWQVSLRVRDRYWMHFCGGSLIHPQWVLTAAHCLGPVQLREQHLYYQDQLLPVSRIIVHPQFYIIQTGADIALLELEEPVNISSRVHTVMLPPASETFPPGMPCWVTGWGDVDNDEPLPPPFPLKQVKVPIMENHICDAKYHLGAYTGDDVRIIRDDMLCAGNSQRDSCKGDSGGPLVCKVNGTWLQAGVVSWDEGCAQPNRPGIYTRVTYYLDWIHHYVPKKP	IIRDDMLCAGNSQR,DDMLCAGNSQR
MLSLLLLALPVLASRAYAAPAPVQALQQAGIVGGQEAPRSKWPWQVSLRVRDRYWMHFCGGSLIHPQWVLTAAHCLGPVQLREQHLYYQDQLLPVSRIIVHPQFYIIQTGADIALLELEEPVNISSRVHTVMLPPASETFPPGMPCWVTGWGDVDNDEPLPPPFPLKQVKVPIMENHICDAKYHLGAYTGDDVRIIRDDMLCAGNSQRDSCKGDSGGPLVCKVNGTWLQAGVVSWDEGCAQPNRPGIYTRVTYYLDWIHHYVPKKP	IIRDDMLCAGNSQR,DDMLCAGNSQR
MLLLAPQMLSLLLLALPVLASRAYAAPAPVQALQQAGIVGGQEAPRSKWPWQVSLRVRDRYWMHFCGGSLIHPQWVLTAAHCLGPDVKDLATLRVQLREQHLYYQDQLLPVSRIIVHPQFYIIQTGADIALLELEEPVNISSRVHTVMLPPASETFPPGMPCWVTGWGDVDNDEPLPPPFPLKQVKVPIMENHICDAKYHLGAYTGDDVRIIRDDMLCAGNSQRDSCKGDSGGPLVCKVNGTWLQAGVVSWDEGCAQPNRPGIYTRVTYYLDWIHHYVPKKP	IIRDDMLCAGNSQR,DDMLCAGNSQR
MLSLLLLALPVLASPAYAAPAPVQALQQAGIVGGQEAPRSKWPWQVSLRVRDRYWMHFCGGSLIHPQWVLTAAHCLGPDVKDLATLRVQLREQHLYYQDQLLPVSRIIVHPQFYIIQTGADIALLELEEPVNISSRVHTVMLPPASETFPPGMPCWVTGWGDVDNDEPLPPPFPLKQVKVPIMENHICDAKYHLGAYTGDDVRIIRDDMLCAGNSQRDSCKGDSGGPLVCKVNGTWLQAGVVSWDEGCAQPNRPGIYTRVTYYLDWIHHYVPKKP	IIRDDMLCAGNSQR,DDMLCAGNSQR
MGKVRGLRARVHQAAVRPKGEAAPGPAPPAPEATLPPASAAGKDWAFINTNIFARTKIDPSALVQKLELDVRSVTSVRRGEAGSSARSVPSIRRGAEAKTVLPKKEKMKLRREQWLQKIEAIKLAEQKHREERRRRATVVVGDLHPLRDALPELLGLEAGIRRQARSRESNKPRPSELSRMSAAQRQQLLEEERTRFQELLASPAYRASPLLAIGQTLARQMQLEDGGQL	ASPLLAIGQTLAR,DALPELLGLEAGIR
MGKVRGLRARVHQAAVRPKGEAAPGPAPPAPEATPPPASAAGKDWAFINTNIFARTKIDPSALVQKLELDVRSVTSVRRGAEAKTVLPKKEKMKLRREQWLQKIEAIKLAEQKHREERRRRATVVVGDLHPLRDALPELLGLEAGIRRQARSRESNKPRPSELSRMSAAQRQQLLEEERTRFQELLASPAYRASPLLAIGQTLARQMQLEDGGQL	ASPLLAIGQTLAR,DALPELLGLEAGIR
MGKVRGLRARVHQAAVRPKGEAAPGPAPPAPEATPPPASAAGKDWAFINTNIFARTKIDPSALVQKLELDVRSVTSVRRGEAGSSARSVPSIRRGAEAKTVLPKKEKMKLRREQWLQKIEAIKLAEQKHREERRRRATVVVGDLHPLRDALPELLGLEAGIRRQARSRESNKPRPSELSRMSAAQRQQLLEEERTRFQELLASPAYRASPLLAIGQTLARQMQLEDGGQL	ASPLLAIGQTLAR,DALPELLGLEAGIR
MGKVRGLRARVHQAAVRPKGEAAPGPAPPAPEATLPPASAAGKDWAFINTNIFARTKIDPSALVQKLELDVRSVTSVRRGAEAKTVLPKKEKMKLRREQWLQKIEAIKLAEQKHREERRRRATVVVGDLHPLRDALPELLGLEAGIRRQARSRESNKPRPSELSRMSAAQRQQLLEEERTRFQELLASPAYRASPLLAIGQTLARQMQLEDGGQL	ASPLLAIGQTLAR,DALPELLGLEAGIR
MELGLSWIFLLAILKGVQCEVQLVESGGGLVQPGRSLRLSCAASGFTFDDYAMHWVRQAPGKGLEWVSGISWNSGSIGYADSVKGRFTISRDNAKNSLYLQMNSLRAEDMALYYCAK	GLEWVSGISWNSGSIGYADSVK,AEDMALYYCAK
MTPGTQSPFFLLLLLTVLTVVTGSGHASSTPGGEKETSATQRSSVPSSTEKNAVSMTSSVLSSHSPGSGSSTTQGQDVTLAPATEPASGSAATWGQDVTSVPVTRPALGSTTPPAHDVTSAPDNKPAPGSTAPPAHGVTSAPDTRPAPGSTAPQAHGVTSAPDTRPAPGSTAPPAHGVTSAPDTRPAPGSTAPPAHGVTSAPDTRPAPGSTAPQAHGVTSAPDTRPAPGSTAPPAHGVTSAPDTRPAPGSTAPPAHGVTSAPDTRPAPGSTAPPAHGVTSAPESRPAPGSTAPAAHGVTSAPESRPAPGSTAPAAHGVTSAPESRPAPGSTAPPAHGVTSAPDTRPAPGSTAPPAHGVTSAPDTRPAPGSTAPPAHGVTSAPDTRPAPGSTAPPAHGVTSAPDTRPAPGSTAPPAHGVTSAPESRPAPGSTAPPAHGVTSAPESRPAPGSTAPAAHGVTSAPESRPAPGSTAPAAHGVTSAPESRPAPGSTAPPAHGVTSAPDTRPAPGSTAPPAHGVTSAPDTRPAPGSTAPPAHGVTSAPDTRPAPGSTAPPAHGVTSAPDTRPAPGSTAPPAHGVTSAPDTRPAPGSTAPPAHGVTSAPDTRPAPGSTAPPAHGVTSAPDTRPAPGSTAPPAHGVTSAPDTRPAPGSTAPAAHGVTSAPESRPAPGSTAPAAHGVTSAPESRPAPGSTAPRCHLGPGHQAGPGLHRPPSPRCHLGPGHQAGPGLHRPPSPRCHLGPGHQAGPGLHRPPSPRCHLGPGHQAGPGLHRPPSPRCHLGPGHQAGPGLHRPPSPRCHLGPGHQAGPGLHRPPSPRCHLGPGHQAGPGLHRPPSPRCHLGPGHQAGPGLHPGPGLHRPPSPRCHLGPGHQAGPGLHRPPSPWCHLGPGQQARLGLHRPSSPQCHLGLRLCIRLSFYSGAQRHLCQGYHNPSQQEHSILNSQPPLYSYHPCQPHQDCQHSPHGTSSHLLQSQHFSPVVYWGLFLFPVFSHFKPPVFLSGRSQHRLLPRAAERHFNVFADLTRGFSGPLQYVQARICGGTIDSGLPRRYHQCPRRGDTVQSVNGSSLSIPDDLRRQRECAISFLCPVWGWGARLGHRAAGAGLCSGCAGHCLSHCLGCLSVPPKELRAAGHLSSPGYLPSYERVPHLPHPWALCAPQYRSPLEGFCRWWQQPLLHKPSSGSHFCQLV	PAPGSTAPAAHGVTSAPESR,PAPGSTAPPAHGVTSAPESR,CHLGPGHQAGPGLHRPPSPR
MTPGTQSPFFLLLLLTVLTVVTGSGHASSTPGGEKETSATQRSSVPSSTEKNAVSMTSSVLSSHSPGSGSSTTQGQDVTLAPATEPASGSAATWGQDVTSVPVTRPALGSTTPPAHDVTSAPDNKPAPGSTAPPAHGVTSAPDTRPAPGSTAPQAHGVTSAPDTRPAPGSTAPPAHGVTSAPDTRPAPGSTAPPAHGVTSAPDTRPAPGSTAPAAHGVTSAPDTRPAPGSTAPQAHGVTSAPDTRPAPGSTAPTAHGVTSAPDTRPAPGSTAPPAHGVTSAPDTRPAPGSTAPPAHGVTSAPESRPAPGSTAPAAHGVTSAPESRPAPGSTAPPAHGVTSAPDTRPAPGSTAPPAHGVTSAPDTRPAPGSTAPAAHGVTSAPDTRPAPGSTAPQAHGVTSAPDTRPAPGSTAPPAHGVTSAPDTRPAPGSTAPPAHGVTSAPDTRPAPGSTAPPAHGVTSAPESRPAPGSTAPAAHGVTSAPESRPAPGSTAPAAHGVTSAPESRPAPGSTAPPAHGVTSAPDTRPAPGSTAPPAHGVTSAPDTRPAPGSTAPPSPRCHLGPGHQAGPGLHRPPSPRCHLGPGHQAGPGLHRPPSPRCHLGPGHQAGPGLHRPPSPRCHLGPGHQAGPGLHRARSPRCHLGPGEQAGPGLHRARSPRCHLGPGEQAGPGLHRPPSPRCHLGPGHQAGPGLHRPPSPRCHLGPGHQAGPGLHRPPSPRCHLGPGHQAGPGLHRPPSPRCHLGPGHQAGPGLHRPPSPRCHLGPGHQAGPGLHRPPQPTVSPRPRTPGRPRAPPPPQPTVSPRPRTPGRPRAPPHPQPTVSPRPRTPGRPRAPPRPRAPPPPQPTVSPRPRTPGRPRAPPPPQPMVSPRPRTTGPPWAPPPLQSTMSPRPQALHQAQLLLWCTTAPLPGLPQPQPARALHSQFPATTLILLPPLPAIAPRLMPVALTIARYLLSPPPITALLPSCLLGSLSFSCLFTFQTSSLIPLWKIPAPTTTKSCRETFLKCFCRFINKGVFWASPILSSGQDLWWYNLWPSEKVPSMSTTWRHSSISIKRKQPLDITRSQTSAVMCHFLSLPSLGLGCQAGASRCWCWSVFWLRWPLSISLPWLSVSAAERTTGSWTSFQPGIPTILASTPPTTPMGAMCPLAVPIVAPMRRFLQVMVAAASLTQTQQWQPLLPTC	PAPGSTAPAAHGVTSAPESR,PAPGSTAPPAHGVTSAPESR,CHLGPGHQAGPGLHRPPSPR,CHLGPGEQAGPGLHR
MTPGTQSPFFLLLLLTVLTVVTGSGHASSTPGGEKETSATQRSSVPSSTEKNAVSMTSSVLSSHSPGSGSSTTQGQDVTLAPATEPASGSAATWGQDVTSVPVTRPALGSTTPPAHDVTSAPDNKPAPGSTAPPAHGVTSAPDTRPAPGSTAPQAHGVTSAPDTRPAPGSTAPPAHGVTSAPDTRPAPGSTAPPAHGVTSAPDTRPAPGSTAPQAHGVTSAPDTRPAPGSTAPTAHGVTSAPDTRPAPGSTAPPAHGVTSAPDTRPAPGSTAPPAHGVTSAPESRPAPGSTAPAAHGVTSAPESRPAPGSTAPPAHGVTSAPDTRPAPGSTAPPAHGVTSAPDTRPAPGSTAPAAHGVTSAPDTRPAPGSTAPQAHGVTSAPDTRPAPGSTAPPAHGVTSAPDTRPAPGSTAPPAHGVTSAPDTRPAPGSTAPPAHGVTSAPESRPAPGSTAPAAHGVTSAPESRPAPGSTAPAAHGVTSAPESRPAPGSTAPPAHGVTSAPDTRPAPGSTAPPAHGVTSAPDTRPAPGSTAPPAHGVTSAPDTRPAPGSTAPPAHGVTSAPDTRPAPGSTAPPAHGVTSAPDTRPAPGSTAPPAHGVTSAPDTRPAPGSTAPPAHGVTSAPDTRPAPGSTAPAAHGVTSAPESRPAPGSTAPAAHGVTSAPESRPAPGSTASPRCHLGPGHQAGPGLHRPPSPRCHLGPGHQAGPGLHRPPSPRCHLGPGHQAGPGLHRPPSPRCHLGPGHQAGPGLHRPPSPRCHLGPGHQAGPGLHRPPSPRCHLGPGHQAGPGLHRPPSPRCHLGPGHQAGPGLHRTPSPRCHLGPGHQAGPGLHPGPGLHRPPSPRCHLGPGHQAGPGLHRPPSPWCHLGPGQQARLGLHRPSSPQCHLGLRLCIRLSFYSGAQRHLCQGYHNPSQQEHSILNSQPPLYSYHPCQPHQDCQHSPHGTSSHLLQSQHFSPVVYWGLFLFPVFSHFKPPVFLSGRSQHRLLPRAAERHFNVFADLTRGFSGPLQYVQARICGGTIDSGLPRRYHQCPRRGDTVQSVNGSSLSIPDDLRRQRECAISFLCPVWGWGARLGHRAAGAGLCSGCAGHCLSHCLGCLSVPPKELRAAGHLSSPGYLPSYERVPHLPHPWALCAPQYRSPLEGFCRWWQQPLLHKPSSGSHFCQLV	PAPGSTAPAAHGVTSAPESR,PAPGSTAPPAHGVTSAPESR,CHLGPGHQAGPGLHRPPSPR
MTPGTQSPFFLLLLLTVLTVVTGSGHASSTPGGEKETSATQRSSVPSSTEKNAVSMTSSVLSSHSPGSGSSTTQGQDVTLAPATEPASGSAATWGQDVTSVPVTRPALGSTTPPAHDVTSAPDNKPAPGSTAPPAHGVTSAPDTRPAPGSTAPQAHGVTSAPDTRPAPGSTAPPAHGVTSAPDTRPAPGSTAPPAHGVTSAPDTRPAPGSTAPAAHGVTSAPDTRPAPGSTAPQAHGVTSAPDTRPAPGSTAPTAHGVTSAPDTRPAPGSTAPPAHGVTSAPDTRPAPGSTAPPAHGVTSAPESRPAPGSTAPAAHGVTSAPESRPAPGSTAPPAHGVTSAPDTRPAPGSTAPPAHGVTSAPDTRPAPGSTAPAAHGVTSAPDTRPAPGSTAPQAHGVTSAPDTRPAPGSTAPPAHGVTSAPDTRPAPGSTAPPAHGVTSAPDTRPAPGSTAPPAHGVTSAPESRPAPGSTAPAAHGVTSAPESRPAPGSTAPAAHGVTSAPESRPAPGSTAPPAHGVTSAPDTRPAPGSTAPPAHGVTSAPDTRPAPGSTAPPAHGVTSAPDTRPAPGSTAPPAHGVTSAPDTRPAPGSTAPPAHGVTSAPDTRPAPGSTAPPAHGVTSAPDTRPAPGSTAPPAHGVTSAPDTRPAPGSTAPAAHGVTSAPESRPAPGSTAPAAHGVTSAPESRPAPGSTASPRCHLGPGHQAGPGLHRPPSPRCHLGPGHQAGPGLHRPPSPRCHLGPGHQAGPGLHRPPSPRCHLGPGHQAGPGLHRPPSPRCHLGPGHQAGPGLHRPPSPRCHLGPGHQAGPGLHRPPSPRCHLGPGHQAGPGLHRTPSPRCHLGPGHQAGPGLHPGPGLHRPPSPRCHLGPGHQAGPGLHRPPSPWCHLGPGQQARLGLHRPSSPQCHLGLRLCIRLSFYSGAQRHLCQGYHNPSQQEHSILNSQPPLYSYHPCQPHQDCQHSPHGTSSHLLQSQHFSPVVYWGLFLFPVFSHFKPPVFLSGRSQHRLLPRAAERHFNVFADLTRGFSGPLQYVQARICGGTIDSGLPRRYHQCPRRGDTVQSVNGSSLSIPDDLRRQRECAISFLCPVWGWGARLGHRAAGAGLCSGCAGHCLSHCLGCLSVPPKELRAAGHLSSPGYLPSYERVPHLPHPWALCAPQYRSPLEGFCRWWQQPLLHKPSSGSHFCQLV	PAPGSTAPAAHGVTSAPESR,PAPGSTAPPAHGVTSAPESR,CHLGPGHQAGPGLHRPPSPR
MTPGTQSPFFLLLLLTVLTVVTGSGHASSTPGGEKETSATQRSSVPSSTEKNAVSMTSSVLSSHSPGSGSSTTQGQDVTLAPATEPASGSAATWGQDVTSVPVTRPALGSTTPPAHDVTSAPDNKPAPGSTAPPAHGVTSAPDTRPAPGSTAPQAHGVTSAPDTRPAPGSTAPPAHGVTSAPDTRPAPGSTAPPAHGVTSAPDTRPAPGSTAPAAHGVTSAPDTRPAPGSTAPQAHGVTSAPDTRPAPGSTAPPAHGVTSAPDTRPAPGSTAPPAHGVTSAPDTRPAPGSTAPPAHGVTSAPESRPAPGSTAPAAHGVTSAPESRPAPGSTAPAAHGVTSAPDTRPAPGSTAPPSPRCHLGPGHQAGPGLHRPPSPRCHLGPGHQAGPGLHRPPQPTVSPRPRTPGRPRAPPPPPAHGVTSAPESRPAPGSTAPAAHGVTSAPESRPAPGSTAPAAHGVTSAPESRPAPGSTAPAAHGVTSAPDTRPAPGSTAPPSPRCHLGPGHQAGPGLHRPPSPRCHLGPGEQAGPGLHRARSPRCHLGPGEQAGPGLHRARSPRCHLGPGHQAGPGLHRPPSPRCHLGPGHQRAPPPPPAHGVTSAPDTRPAPGSTAPPAHGVTSAPDTRPAPGSTAPPAHGVTSAPDTRPAPGSTAPPAHGVTSAPDTRPAPGSTAPPAHGVTSAPDTRPAPGSTAPPAHGVTSAPDTRRAPGSTPAPGSTAPPAHGVTSAPDTRPAPGSTAPPAHGVTSAPDNRPALGSTAPPVHNVTSASGSASGSASTLVHNGTSARATTTPASKSTPFSIPSHHSDTPTTLASHSTKTDASSTHHSTVPPLTSSNHSTSPQLSTGVSFFFLSFHISNLQFNSSLEDPSTDYYQELQRDISEMFLQIYKQGGFLGLSNIKFRPGSVVVQLTLAFREGTINVHDVETQFNQYKTEAASRYNLTISDVSVSDVPFPFSAQSGAGVPGWGIALLVLVCVLVALAIVYLIALAVCQCRRKNYGQLDIFPARDTYHPMSEYPTYHTHGRYVPPSSTDRSPYEKVSAGNGGSSLSYTNPAVAATSANL	PAPGSTAPAAHGVTSAPESR,PAPGSTAPPAHGVTSAPESR,CHLGPGHQAGPGLHRPPSPR,CHLGPGEQAGPGLHR
MTPGTQSPFFLLLLLTVLTVVTGSGHASSTPGGEKETSATQRSSVPSSTEKNAVSMTSSVLSSHSPGSGSSTTQGQDVTLAPATEPASGSAATWGQDVTSVPVTRPALGSTTPPAHDVTSAPDNKPAPGSTAPPAHGVTSAPDTRPAPGSTAPQAHGVTSAPDTRPAPGSTAPPAHGVTSAPDTRPAPGSTAPPAHGVTSAPDTRPAPGSTAPAAHGVTSAPDTRPAPGSTAPQAHGVTSAPDTRPAPGSTAPTAHGVTSAPDTRPAPGSTAPPAHGVTSAPDTRPAPGSTAPPAHGVTSAPESRPAPGSTAPAAHGVTSAPESRPAPGSTAPPAHGVTSAPDTRPAPGSTAPPAHGVTSAPDTRPAPGSTAPAAHGVTSAPDTRPAPGSTAPQAHGVTSAPDTRPAPGSTAPPAHGVTSAPDTRPAPGSTAPPAHGVTSAPDTRPAPGSTAPPAHGVTSAPESRPAPGSTAPAAHGVTSAPESRPAPGSTAPAAHGVTSAPESRPAPGSTAPPAHGVTSAPDTRPAPGSTAPPAHGVTSAPDTRPAPGSTAPPAHGVTSAPDTRPAPGSTAPPAHGVTSAPDTRPAPGSTAPPAHGVTSAPDTRPAPGSTAPPAHGVTSAPDTRPAPGSTAPPAHGVTSAPDTRPAPGSTAPAAHGVTSAPESRPAPGSTAPAAHGVTSAPESRPAPGSTAPRCHLGPGHQAGPGLHRPPSPRCHLGPGHQAGPGLHRPPSPRCHLGPGHQAGPGLHRPPSPRCHLGPGHQAGPGLHRPPSPRCHLGPGHQAGPGLHRPPSPRCHLGPGHQAGPGLHRPPSPRCHLGPGHQAGPGLHRTPSPRCHLGPGHQAGPGLHPGPGLHRPPSPRCHLGPGHQAGPGLHRPPSPWCHLGPGQQARLGLHRPSSPQCHLGLRLCIRLSFYSGAQRHLCQGYHNPSQQEHSILNSQPPLYSYHPCQPHQDCQHSPHGTSSHLLQSQHFSPVVYWGLFLFPVFSHFKPPVFLSGRSQHRLLPRAAERHFNVFADLTRGFSGPLQYVQARICGGTIDSGLPRRYHQCPRRGDTVQSVNGSSLSIPDDLRRQRECAISFLCPVWGWGARLGHRAAGAGLCSGCAGHCLSHCLGCLSVPPKELRAAGHLSSPGYLPSYERVPHLPHPWALCAPQYRSPLEGFCRWWQQPLLHKPSSGSHFCQLV	PAPGSTAPAAHGVTSAPESR,PAPGSTAPPAHGVTSAPESR,CHLGPGHQAGPGLHRPPSPR
MTPGTQSPFFLLLLLTVLTVVTGSGHASSTPGGEKETSATQRSSVPSSTEKNAVSMTSSVLSSHSPGSGSSTTQGQDVTLAPATEPASGSAATWGQDVTSVPVTRPALGSTTPPAHDVTSAPDNKPAPGSTAPPAHGVTSAPDTRPAPGSTAPQAHGVTSAPDTRPAPGSTAPPAHGVTSAPDTRPAPGSTAPPAHGVTSAPDTRPAPGSTAPAAHGVTSAPDTRPAPGSTAPQAHGVTSAPDTRPAPGSTAPTAHGVTSAPDTRPAPGSTAPPAHGVTSAPDTRPAPGSTAPPAHGVTSAPESRPAPGSTAPPAHGVTSAPDTRPAPGSTAPPAHGVTSAPDTRPAPGSTAPAAHGVTSAPDTRPAPGSTAPQAHGVTSAPDTRPAPGSTAPPAHGVTSAPTRPAPGSTAPPSPRCHLGPGHQAGPGLHRPPPAPGSTAPPAHGVTSAPDTRPAPGSTAPPSPRCHLGPGHQAGPGLHRPPQPTVSPRPRTPGRPRAPPPPPAHGVTSAPDTRPAPGSTAPPSPRCHLGPGHQAGPGLHRPPSPRCHLGPGHQAGPGLHRPPQPTVSPRPRTPGRPRAPPPPPAHGVTSAPDTRPAPGSTAPAAHGVTSAPESRPAPGSTAPAAHGVTSAPDTRPAPGSTAPPAHGVTSAPDTRPAPGSTAPPAHGVTSAPDTRPAPRAPPPPQPTVSPRPRTPGRPRAPPPPQPTVSPRPRTPGRPRAPPPPPAHGVTSAPDTRPAPGSTAPPAHGVTSAPDTRPAPGSTAPPAHGVTSAPDTRPAPGSTPAPGSTAPPAHGVTSAPDTRPAPGSTAPPAHGVTSAPDNRPALGSTAPPVHNVTSASGSASGSASTLVHNGTSARATTTPASKSTPFSIPSHHSDTPTTLASHSTKTDASSTHHSTVPPLTSSNHSTSPQLSTGVSFFFLSFHISNLQFNSSLEDPSTDYYQELQRDISEMFLQIYKQGGFLGLSNIKFRPGSVVVQLTLAFREGTINVHDVETQFNQYKTEAASRYNLTISDVSVSDVPFPFSAQSGAGVPGWGIALLVLVCVLVALAIVYLIALAVCQCRRKNYGQLDIFPARDTYHPMSEYPTYHTHGRYVPPSSTDRSPYEKVSAGNGGSSLSYTNPAVAATSANL	PAPGSTAPAAHGVTSAPESR,PAPGSTAPPAHGVTSAPESR,CHLGPGHQAGPGLHRPPSPR
MTPGTQSPFFLLLLLTVLTVVTGSGHASSTPGGEKETSATQRSSVPSSTEKNAVSMTSSVLSSHSPGSGSSTTQGQDVTLAPATEPASGSAATWGQDVTSVPVTRPALGSTTPPAHDVTSAPDNKPAPGSTAPPAHGVTSAPDTRPAPGSTAPQAHGVTSAPDTRPAPGSTAPPAHGVTSAPDTRPAPGSTAPPSPRCHLGPGHQARPGLHRARSPRCHLGPGHQAGPGLHRPPSPRCHLGPGHQAGPGLHRPPSPRCHLSPGHQAGPGLHRRPSPRCHLGPGHQAGPGLHRPPSPRCHLGPGEQAGPGLHRARSPRCHLGPGEQAGPGLHRPPSPRCHLGPGHQARPGLHRPPSPRCHLGPGHQARPGLHRARSPRCHLGPGHQAGPGLHRPPSPRCHLGPGHQAGPGLHRPPQPTVSPRPRTPGRPRAPPRPQPTVSPRPRRAGRPRAPPPPPAHGVTSAPDTRPAPGSTAPPAHGVTSAPDTRPAPGSTAPPSPRCHLGPGHQAGPGLHRPPSPRCHLGPGHQAGPGLHRPPQPTVSPRPRTPGRPRAPPPPQPTVSPRPRTPGRPRAPPPPQPTVSPRPRTPGPPRAPPRPQPTVSPRPRTPGRPRAPPPPKPTVSPRPRTPGRPRAPPPPQPTVSPRPRTPGRPRAPPPPPAHGVTSAPESRPAPGSTAPPAHGVTSAPESRPAPGSTAPAAHGVTSAPESRPAPGSTAPAAHGVTSAPESRPAPGSTAPPAHGVTSAPDTRPAPGSTAPPAHGVTSAPDTRPAPGSTAPPAHGVTSAPDTRPAPGSTAPPSPRCHLGPGHQAGPGLHRPPSPRCHLGPGHQAGPAPQPTVSPRPRTPGRPRAPPPPQPTVSPRPRTPGRPRAPPPPQPTVSPRPRTPGRPRAPPPPQPTVSPRPRTPGRPRAPPPPQPTVSPRPRTPGRPRAPPRPRAPPPPQPTVSPRPRTPGRPRAPPPPPAHGVTSAPDNRPALGSTAPPVHNVTSASGSASGSASTLVHNGTSARATTTPASKSTPFSIPSHHSDTPTTLASHSTKTDASSTHHSTVPPLTSSNHSTSPQLSTGVSFFFLSFHISNLQFNSSLEDPSTDYYQELQRDISEMFLQIYKQGGFLGLSNIKFRPGSVVVQLTLAFREGTINVHDVETQFNQYKTEAASRYNLTISDVSVSDVPFPFSAQSGAGVPGWGIALLVLVCVLVALAIVYLIALAVCQCRRKNYGQLDIFPARDTYHPMSEYPTYHTHGRYVPPSSTDRSPYEKVSAGNGGSSLSYTNPAVAATSANL	PAPGSTAPAAHGVTSAPESR,PAPGSTAPPAHGVTSAPESR,CHLGPGHQAGPGLHRPPSPR,CHLGPGEQAGPGLHR
MTPGTQSPFFLLLLLTVLTVVTGSGHASSTPGGEKETSATQRSSVPSSTEKNAVSMTSSVLSSHSPGSGSSTTQGQDVTLAPATEPASGSAATWGQDVTSVPVTRPALGSTTPPAHDVTSAPDNKPAPGSTAPPAHGVTSAPDTRPAPGSTAPQAHGVTSAPDTRPAPGSTAPPAHGVTSAPDTRPAPGSTAPPAHGVTSAPDTRPAPGSTAPAAHGVTSAPDTRPAPGSTAPQAHGVTSAPDTRPAPGSTAPPAHGVTSAPDTRPAPGSTAPPAHGVTSAPDTRPAPGSTAPPAHGVTSAPESRPAPGSTAPAAHGVTSAPESRPAPGSTAPPAHGVTSAPDTRPAPGSTAPPAHGVTSAPDTRPAPGSTAPAAHGVTSAPDTRPAPGSTAPQAHGVTSAPDTRPAPGSTAPPAHGVTSAPDTRPAPGSTAPPAHGVTSAPDTRPAPGSTAPPAHGVTSAPDTRPAPGSTAPAAHGVTSAPESRPAPGSTAPAAHGVTSAPESRPAPGSTAPPAHGVTSAPDTRPAPGSTAPPAHGVTSAPDTRPAPGSTAPPAHGVTSAPDTRPAPGSTAPPSPRCHLGPGHQAGPGLHRPPSPRCHLGPGHQAGPGLHRPPSPRCHLGPGHQAGPGLHRPPSPRCHLGPGHQAGPGLHRTPSPRCHLGPGHQAGPGLHPGPGLHRPPSPRCHLGPGHQAGPGLHRPPSPWCHLGPGQQARLGLHRPSSPQCHLGLRLCIRLSFYSGAQRHLCQGYHNPSQQEHSILNSQPPLYSYHPCQPHQDCQHSPHGTSSHLLQSQHFSPVVYWGLFLFPVFSHFKPPVFLSGRSQHRLLPRAAERHFNVFADLTRGFSGPLQYVQARICGGTIDSGLPRRYHQCPRRGDTVQSVNGSSLSIPDDLRRQRECAISFLCPVWGWGARLGHRAAGAGLCSGCAGHCLSHCLGCLSVPPKELRAAGHLSSPGYLPSYERVPHLPHPWALCAPQYRSPLEGFCRWWQQPLLHKPSSGSHFCQLV	PAPGSTAPAAHGVTSAPESR,PAPGSTAPPAHGVTSAPESR,CHLGPGHQAGPGLHRPPSPR
MTPGTQSPFFLLLLLTVLTVVTGSGHASSTPGGEKETSATQRSSVPSSTEKNAVSMTSSVLSSHSPGSGSSTTQGQDVTLAPATEPASGSAATWGQDVTSVPVTRPALGSTTPPAHDVTSAPDNKPAPGSTAPPAHGVTSAPDTRPAPGSTAPQAHGVTSAPDTRPAPGSTAPPSPRCHLGPGHQARPGLHRPPSPRCHLGPGHQARPGLHRARSPRCHLGPGHQAGPGLHRPPSPRCHLGPGHQAGPGLHRPPSPRCHLGPGHQAGPGLHRPPSPRCHLGPGHQAGPGLHRPPSPRCHLGPGHQAGPGLHRARSPRCHLGPGEQAGPGLHRPPQPTVSPRPRTPGRPRAPPRPQPTVSPRPRRAGRPRAPPPPQPTVSPRPRTPGPPRAPPPPPAHGVTSAPDTRPAPGSTAPAAHGVTSAPDTRPAPGSTAPQAHGVTSAPDTRPAPGSTAPPSPRCHLGPGHQAGPGLHRPPSPRCHLGPGHQAGPGLHRPPSPRCHLGPGHQAGPGLHRPPSPRCHLGPGHQAGPGLHRPPSPRCHLGPGHQAGPGLHRPPSPRCHLGPGHQAGPGLHRPPSPRCHLGPGHQAGPGLHRPPSPRCHLGPGHQAGPGLHRPPQPTVSPRPRTPGRPRAPPPPPAHGVTSAPDTRPAPGSTAPPSPRCHLGPGHQAGPGLHRPPSPRCHLGPGEQAGPGLHRARSPRCHLGPGEQAGPGLHRPPSPRCHLGPGHQAGPAGSTAPPAHGVTSAPDTRPAPGSTAPPAHGVTSAPDTRPAPGSTAPPSPRCHLGPGHQAGPGLHRPPSPRCHLGPGHQAGPGLHRTPSPRCHLGPGHQAGPGLHPGPGLHRPPSPRCHLGPGHQAGPGLHRPPSPWCHLGPGQQARLGLHRPSSPQCHLGLRLCIRLSFYSGAQRHLCQGYHNPSQQEHSILNSQPPLYSYHPCQPHQDCQHSPHGTSSHLLQSQHFSPVVYWGLFLFPVFSHFKPPVFLSGRSQHRLLPRAAERHFNVFADLTRGFSGPLQYVQARICGGTIDSGLPRRYHQCPRRGDTVQSVNGSSLSIPDDLRRQRECAISFLCPVWGWGARLGHRAAGAGLCSGCAGHCLSHCLGCLSVPPKELRAAGHLSSPGYLPSYERVPHLPHPWALCAPQYRSPLEGFCRWWQQPLLHKPSSGSHFCQLV	CHLGPGHQAGPGLHRPPSPR,CHLGPGEQAGPGLHR
MTPGTQSPFFLLLLLTVLTVVTGSGHASSTPGGEKETSATQRSSVPSSTEKNAVSMTSSVLSSHSPGSGSSTTQGQDVTLAPATEPASGSAATWGQDVTSVPVTRPALGSTTPPAHDVTSAPDNKPAPGSTAPPAHGVTSAPDTRPAPGSTAPQAHGVTSAPDTRPAPGSTAPPAHGVTSAPDTRPAPGSTAPPAHGVTSAPDTRPAPGSTAPAAHGVTSAPDTRPAPGSTAPQAHGVTSAPDTRPAPGSTAPTAHGVTSAPDTRPAPGSTAPPAHGVTSAPDTRPAPGSTAPPAHGVTSAPESRPAPGSTAPAAHGVTSAPESRPAPGSTAPPAHGVTSAPDTRPAPGSTAPPAHGVTSAPDTRPAPGSTAPAAHGVTSAPDTRPAPGSTAPQAHGVTSAPDTRPAPGSTAPPAHGVTSAPDTRPAPGSTAPPAHGVTSAPDTRPAPGSTAPPAHGVTSAPESRPAPGSTAPAAHGVTSAPESRPAPGSTAPAAHGVTSAPESRPAPGSTAPPAHGVTSAPDTRPAPGSTAPPAHGVTSAPDTRPAPGSTAPPAHGVTSAPDTRPAPGSTAPPAHGVTSAPDTRPAPGSTAPPAHGVTSAPDTRPAPGSTAPPAHGVTSAPDTRPAPGSTAPPAHGVTSAPDTRPAPGSTAPPAHGVTSAPDTRPAPGSTAPAAHGVTSAPESRPAPGSTAPAAHGVTSAPESRPAPGSTAPPSPRCHLGPGHQAGPGLHRPPSPRCHLGPGHQAGPGLHRPPSPRCHLGPGHQAGPGLHRPPQPTVSPRPRTPGRPRAPPPPQPTVSPRPRTPGRPRAPPPPQPTVSPRPRTPGRPRAPPPPQPTVSPRPRTPGRPRAPPHPQPTVSPRPRTPGRPRAPPRPRAPPPPQPTVSPRPRTPGRPRAPPPPQPMVSPRPRTTGPPWAPPPLQSTMSPRPQALHQAQLLLWCTTAPLPGLPQPQPARALHSQFPATTLILLPPLPAIAPRLMPVALTIARYLLSPPPITALLPSCLLGSLSFSCLFTFQTSSLIPLWKIPAPTTTKSCRETFLKCFCRFINKGVFWASPILSSGQDLWWYNLWPSEKVPSMSTTWRHSSISIKRKQPLDITRSQTSAVMCHFLSLPSLGLGCQAGASRCWCWSVFWLRWPLSISLPWLSVSAAERTTGSWTSFQPGIPTILASTPPTTPMGAMCPLAVPIVAPMRRFLQVMVAAASLTQTQQWQPLLPTC	PAPGSTAPAAHGVTSAPESR,PAPGSTAPPAHGVTSAPESR,CHLGPGHQAGPGLHRPPSPR
MTPGTQSPFFLLLLLTVLTVVTGSGHASSTPGGEKETSATQRSSVPSSTEKNAVSMTSSVLSSHSPGSGSSTTQGQDVTLAPATEPASGSAATWGQDVTSVPVTRPALGSTTPPAHDVTSAPDNKPAPGSTAPPAHGVTSAPDTRPAPGSTAPQAHGVTSAPDTRPAPGSTAPPAHGVTSAPDTRPAPGSTAPPAHGVTSAPDTRPAPGSTAPAAHGVTSAPDTRPAPGSTAPQAHGVTSAPDTRPAPGSTAPPAHGVTSAPDTRPAPGSTAPPAHGVTSAPDTRPAPGSTAPPAHGVTSAPESRPAPGSTAPAAHGVTSAPESRPAPGSTAPAAHGVTSAPDTRPAPGSTAPPAHGVTSAPDTRPAPGSTAPPAHGVTSAPDTRPAPGSTAPPAHGVTSAPDTRPAPGSTAPPAHGVTSAPDTRPAPGSTAPPAHGVTSAPDTRPAPGSTAPPDTRPAPGSTAPPSPRCHLGPGHQARPGLHRARSPRCHLGPGHQAGPGLHRPPSPRCHLGPGEQAGPGLHRPPSPRCHLGPGHQAGPGLHRPPSPRCHLGPGHQAGPGLHRPPSPRCHLGPGHQAGPGLHRPPSPRCHLGPGHQAGPGLHRPPSPRCHLGPGHQAGPGLHRPPQPTVSPRPRTPGRPRAPPPPQPTVSPRPRTPGRPRAPPPPQPTVSPRPRTPGRPRAPPPPQPTVSPRPRTPGRPRAPPRPQPTVSPRPRTPGRPRAPPPPQPTVSPRPRRAGRPRAPPRPQPTVSPRHRRAGRPRAPPRPQPTVSPRPRRAGRPRAPPPPQPTVSPRPRTPGRPRAPPPPQPTVSPRPRTPGRPRGLHRPPSPRCHLGPGHQAGPGLHRPPSPRCHLGPGHQAGPGLHRPPSPRCHLGPGHQAGPGLHRPPSPRCHLGPGHQAGPGLHRTPSPRCHLGPGHQAGPGLHPGPGLHRPPSPRCHLGPGHQAGPGLHRPPSPWCHLGPGQQARLGLHRPSSPQCHLGLRLCIRLSFYSGAQRHLCQGYHNPSQQEHSILNSQPPLYSYHPCQPHQDCQHSPHGTSSHLLQSQHFSPVVYWGLFLFPVFSHFKPPVFLSGRSQHRLLPRAAERHFNVFADLTRGFSGPLQYVQARICGGTIDSGLPRRYHQCPRRGDTVQSVNGSSLSIPDDLRRQRECAISFLCPVWGWGARLGHRAAGAGLCSGCAGHCLSHCLGCLSVPPKELRAAGHLSSPGYLPSYERVPHLPHPWALCAPQYRSPLEGFCRWWQQPLLHKPSSGSHFCQLV	PAPGSTAPAAHGVTSAPESR,PAPGSTAPPAHGVTSAPESR,CHLGPGHQAGPGLHRPPSPR,CHLGPGEQAGPGLHR
MTPGTQSPFFLLLLLTVLTVVTGSGHASSTPGGEKETSATQRSSVPSSTEKNAVSMTSSVLSSHSPGSGSSTTQGQDVTLAPATEPASGSAATWGQDVTSVPVTRPALGSTTPPAHDVTSAPDNKPAPGSTAPPAHGVTSAPDTRPAPGSTAPQAHGVTSAPDTRPAPGSTAPPAHGVTSAPDTRPAPGSTAPPAHGVTSAPDTRPAPGSTAPAAHGVTSAPDTRPAPGSTAPQAHGVTSAPDTRPAPGSTAPTAHGVTSAPDTRPAPGSTAPPAHGVTSAPDTRPAPGSTAPPAHGVTSAPESRPAPGSTAPAAHGVTSAPESRPAPGSTAPPAHGVTSAPDTRPAPGSTAPPAHGVTSAPDTRPAPGSTAPAAHGVTSAPDTRPAPGSTAPQAHGVTSAPDTRPAPGSTAPPAHGVTSAPDTRPAPGSTAPPAHGVTSAPDTRPAPGSTAPPAHGVTSAPESRPAPGSTAPAAHGVTSAPESRPAPGSTAPAAHGVTSAPESRPAPGSTAPPAHGVTSAPDTRPAPGSTAPPAHGVTSAPDTRPAPGSTAPPAHGVTSAPDTRPAPGSTAPPAHGVTSAPDTRPAPGSTAPPAHGVTSAPDTRPAPGSTAPPAHGVTSAPDTRPAPGSTAPAAHGVTSAPESRPAPGSTAPAAHGVTSAPESRPAPGSTAPPAHGVTSAPDTRPAPGSTAPPSPRCHLGPGHQAGPGLHRPPSPRCHLGPGHQAGPGLHRPPQPTVSPRPRTPGRPRAPPPPQPTVSPRPRTPGRPRAPPPPQPTVSPRPRTPGRPRAPPPPQPTVSPRPRTPGRPRAPPHPQPTVSPRPRTPGRPRAPPRPRAPPPPQPTVSPRPRTPGRPRAPPPPQPMVSPRPRTTGPPWAPPPLQSTMSPRPQALHQAQLLLWCTTAPLPGLPQPQPARALHSQFPATTLILLPPLPAIAPRLMPVALTIARYLLSPPPITALLPSCLLGSLSFSCLFTFQTSSLIPLWKIPAPTTTKSCRETFLKCFCRFINKGVFWASPILSSGQDLWWYNLWPSEKVPSMSTTWRHSSISIKRKQPLDITRSQTSAVMCHFLSLPSLGLGCQAGASRCWCWSVFWLRWPLSISLPWLSVSAAERTTGSWTSFQPGIPTILASTPPTTPMGAMCPLAVPIVAPMRRFLQVMVAAASLTQTQQWQPLLPTC	PAPGSTAPAAHGVTSAPESR,PAPGSTAPPAHGVTSAPESR,CHLGPGHQAGPGLHRPPSPR
MTPGTQSPFFLLLLLTVLTVVTGSGHASSTPGGEKETSATQRSSVPSSTEKNAVSMTSSVLSSHSPGSGSSTTQGQDVTLAPATEPASGSAATWGQDVTSVPVTRPALGSTTPPAHDVTSAPDNKPAPGSTAPPAHGVTSAPDTRPAPGSTAPQAHGVTSAPDTRPAPGSTAPPAHGVTSAPDTRPAPGSTAPPAHGVTSAPDTRPAPGSTAPAAHGVTSAPDTRPAPGSTAPQAHGVTSAPDTRPAPGSTAPPAHGVTSAPDTRPAPGSTAAPAHGVTSAPDTRPAPGSTAPPAHGVTSAPESRPAPGSTAPAAHGVTSAPESRPAPGSTAPAAHGVTSAPESRPAPGSTAPPAHGVTSAPDTRPAPGSTAPPAHGVTSAPDTRPAPGSTAPAAHGVTSAPDTRPAPGSTAPQAHGVTSAPDTRPAPGSTAPPAHGVTSAPESRPAPGSTAPPAHGVTSAPDTRPAPGSTAPPAHGVTSAPESRPAPGSTAPAAHGVTSAPESRPAPGSTAPAAHGVTSAPESRPAPGSTAPPAHGVTSAPDTRPAPGSTAPPAHGVTSAPDTRPAPGSTAPPAHGVTSAPDTRPAPGSTAPPAHGVTSAPDTRPAPGSTAPPAHGVTSAPDTRPAPGSTAPAAHGVTSAPDTRPAPGSTAPQAHGVTSAPDTRPAPGSTAPPAHGVTSAPDTRPAPGSTAPPAHGVTSAPDTRPAPGSTAPPAHGVTSAPDTRPAPGSTAPAAHGVTSAPDTRPAPGSTAPAAHGVTSAPESRPAPGSTAPPAHGVTSAPDTRPAPGSTAPPAHGVTSAPDTRPAPGSTAPPAHGVTSAPDTRPAPGSTAPPSPRCHLGPGHQAGPGLHRPPSPRCHLGPGHQAGPGLHRPPSPRCHLGPGHQAGPGLHRPPQPTVSPRPRTPGRPRAPPPPQPTVSPRPRTPGRPGSTAPPSPRCHLGPGHQAGPGLHRPPSPRCHLGPGHQAGPGLHRPPSPRCHLGPGHQAGPAGSTAPPAHGVTSAPDTRPAPGSTAPPAHGVTSAPDTRPAPGSTAPPAHGVTSAPDTRPAPGSTAPPAHGVTSAPDTRPAPGSTAPPAHGVTSAPDTRPAPGSTPAPGSTASPAHGVTSAPDTRPAPGSTAPPAHGVTSAPDNRPALGSTAPPVHNVTSASGSASGSASTLVHNGTSARATTTPASKSTPFSIPSHHSDTPTTLASHSTKTDASSTHHSTVPPLTSSNHSTSPQLSTGVSFFFLSFHISNLQFNSSLEDPSTDYYQELQRDISEMFLQIYKQGGFLGLSNIKFRPGSVVVQLTLAFREGTINVHDVETQFNQYKTEAASRYNLTISDVSVSDVPFPFSAQSGAGVPGWGIALLVLVCVLVALAIVYLIALAVCQCRRKNYGQLDIFPARDTYHPMSEYPTYHTHGRYVPPSSTDRSPYEKVSAGNGGSSLSYTNPAVAATSANL	PAPGSTAPAAHGVTSAPESR,PAPGSTAPPAHGVTSAPESR,CHLGPGHQAGPGLHRPPSPR
MTPGTQSPFFLLLLLTVLTVVTGSGHASSTPGGEKETSATQRSSVPSSTEKNAVSMTSSVLSSHSPGSGSSTTQGQDVTLAPATEPASGSAATWGQDVTSVPVTRPALGSTTPPAHDVTSAPDNKPAPGSTAPPAHGVTSAPDTRPAPGSTAPQAHGVTSAPDTRPAPGSTAPPAHGVTSAPDTRPAPGSTAPPSPRCHLGPGHQARPGLHRARSPRCHLGPGHQAGPGLHRPPSPRCHLGPGHQAGPGLHRPHSPRCHLGPGHQAGPGLHRPPSPRCHLGPGHQAGPGLHRPPSPRCHLGPGEQAGPGLHRARSPRCHLGPGEQAGPGLHRPPQPTVSPRPRTPGPPRAPPPPPAHGVTSAPDTRPAPGSTAPAAHGVTSAPDTRPAPGSTAPQAHGVTSAPDTRPAPGSTAPPSPRCHLGPGHQAGPGLHRPPSPRCHLGPGHQAGPGLHRPPSAGPGLHRPPSPRCHLGPGHQAGPGLHRPPSPRCHLGPGHQAGPGLHRPPQPTVSPRPRTPGRPRAPPPPPAHGVTSAPDTRPAPGSTAPPAHGVTSAPDTRPAPGSTAPPAHGVTSAPDTRPAPGSTAPAAHGVTSAPESRPAPGSTAPAAHGVTSAPESRPAPGSTAPPSPRCHLGPGHQAGPGLHRPPSPRCHLGPGHQAGPGLHRPPSPRCHLGPGHQAGPGLHRPPSPRCHLGPGHQAGPGLHRPPSPRCHLGPGHQAGPAPQPTVSPRPRTPGRPRAPPPPPAHGVTSAPDTRPAPGSTAPPAHGVTSAPDTRPAPGSTPAPGSTAPPAHGVTSAPDTRPAPGSTAPPSPWCHLGPGQQARLGLHRPSSPQCHLGLRLCIRLSFYSGAQRHLCQGYHNPSQQEHSILNSQPPLYSYHPCQPHQDCQHSPHGTSSHLLQSQHFSPVVYWGLFLFPVFSHFKPPVFLSGRSQHRLLPRAAERHFNVFADLTRGFSGPLQYVQARICGGTIDSGLPRRYHQCPRRGDTVQSVNGSSLSIPDDLRRQRECAISFLCPVWGWGARLGHRAAGAGLCSGCAGHCLSHCLGCLSVPPKELRAAGHLSSPGYLPSYERVPHLPHPWALCAPQYRSPLEGFCRWWQQPLLHKPSSGSHFCQLV	PAPGSTAPAAHGVTSAPESR,CHLGPGHQAGPGLHRPPSPR,CHLGPGEQAGPGLHR
MTPGTQSPFFLLLLLTVLTVVTGSGHASSTPGGEKETSATQRSSVPSSTEKNAVSMTSSVLSSHSPGSGSSTTQGQDVTLAPATEPASGSAATWGQDVTSVPVTRPALGSTTPPAHDVTSAPDNKPAPGSTAPPAHGVTSAPDTRPAPGSTAPQAHGVTSAPDTRPAPGSTAPPAHGVTSAPDTRPAPGSTAPPAHGVTSAPDTRPAPGSTAPAAHGVTSAPDTRPAPGSTAPQAHGVTSAPDTRPAPGSTAPPAHGVTSAPDTRPAPGSTAPPAHGVTSAPDTRPAPGSTAPPAHGVTSAPESRPAPGSTAPPAHGVTSAPDTRPAPGSTAPPAHGVTSAPDTRPAPGSTAPPAHGVTSAPDTRPAPGSTAPPAHGVTSAPDTRPAPGSTAPPAHGVTSAPDTRPAPGSTAPPAHGVTSAPDTRPAPGSTAPPAHGVTSAPDTRPAPGSTAPPAHGVTSAPDTRPAPGSTAPPAHGVTSAPDTRPAPGSTAPPAHGVTSAPDTRPAPGSTAPPAHGVTSAPDTRPAPGSTAPPAHGVTSAPDTRPAPGSTAPPAHGVTSAPDTRPAPGSTAPPAHGVTSAPESRPAPGSTAPAAHGVTSAPESRPAPGSTAPAAHGVTSAPESRPAPGSTAPPAHGVTSAPDTRPAPGSTAPPSPRCHLGPGHQAGPGLHRPPSPRCHLGPGHQAGPGLHRPPSPRCHLGPGHQAGPGLHRPPSPRCHLGPGHQAGPGLHRPPSPRCHLGPGEQAGPGLHRARSPRCHLGPGEQAGPGLHRPPSPRCHLGPGHQAGPGLHRPPSPRCHLGPGHQAGPGLHRPPSPRCHLGPGHQAGPGLHRPPSPRCHLGPGHQAGPGLHRPPSPRCHLGPGHQAGPAGSTAPPAHGVTSAPDTRPAPGSTAPPAHGVTSAPDTRPAPGSTAPPAHGVTSAPDTRPAPGSTAPPAHGVTSAPDTRPAPGSTAPPAHGVTSAPDTRPAPGSTAPPAHGVTSAPDTRRAPGSTPAPGSTAPPAHGVTSAPDTRPAPGSTAPPAHGVTSAPDNRPALGSTAPPVHNVTSASGSASGSASTLVHNGTSARATTTPASKSTPFSIPSHHSDTPTTLASHSTKTDASSTHHSTVPPLTSSNHSTSPQLSTGVSFFFLSFHISNLQFNSSLEDPSTDYYQELQRDISEMFLQIYKQGGFLGLSNIKFRPGSVVVQLTLAFREGTINVHDVETQFNQYKTEAASRYNLTISDVSVSDVPFPFSAQSGAGVPGWGIALLVLVCVLVALAIVYLIALAVCQCRRKNYGQLDIFPARDTYHPMSEYPTYHTHGRYVPPSSTDRSPYEKVSAGNGGSSLSYTNPAVAATSANL	PAPGSTAPAAHGVTSAPESR,PAPGSTAPPAHGVTSAPESR,CHLGPGHQAGPGLHRPPSPR,CHLGPGEQAGPGLHR
MTPGTQSPFFLLLLLTVLTVVTGSGHASSTPGGEKETSATQRSSVPSSTEKNAVSMTSSVLSSHSPGSGSSTTQGQDVTLAPATEPASGSAATWGQDVTSVPVTRPALGSTTPPAHDVTSAPDNKPAPGSTAPPAHGVTSAPDTRPAPGSTAPQAHGVTSAPDTRPAPGSTAPPAHGVTSAPDTRPAPGSTAPPAHGVTSAPDTRPAPGSTAPAAHGVTSAPDTRPAPGSTAPQAHGVTSAPDTRPAPGSTAPTAHGVTSAPDTRPAPGSTAPPAHGVTSAPDTRPAPGSTAPPAHGVTSAPESRPAPGSTAPAAHGVTSAPESRPAPGSTAPPAHGVTSAPDTRPAPGSTAPPAHGVTSAPDTRPAPGSTAPAAHGVTSAPDTRPAPGSTAPQAHGVTSAPDTRPAPGSTAPPAHGVTSAPDTRPAPGSTAPPAHGVTSAPDTRPAPGSTAPPAHGVTSAPESRPAPGSTAPAAHGVTSAPESRPAPGSTAPAAHGVTSAPESRPAPGSTAPPAHGVTSAPDTRPAPGSTAPPAHGVTSAPDTRPAPGSTAPPAHGVTSAPDTRPAPGSTAPPAHGVTSAPDTRPAPGSTAPPAHGVTSAPDTRPAPGSTAPPAHGVTSAPDTRPAPGSTAPPAHGVTSAPDTRPAPGSTAPAAHGVTSAPESRPAPGSTAPPAHGVTSAPDTRPAPGSTAPPAHGVTSAPDTRPAPGSTAPPAHGVTSAPDTRPAPGSTAPPSPRCHLGPGHQAGPGLHRPPSPRCHLGPGHQAGPGLHRPPSPRCHLGPGHQAGPGLHRPPSPRCHLGPGHQAGPGLHRTPSPRCHLGPGHQAGPGLHPGPGLHRPPSPRCHLGPGHQAGPGLHRPPSPWCHLGPGQQARLGLHRPSSPQCHLGLRLCIRLSFYSGAQRHLCQGYHNPSQQEHSILNSQPPLYSYHPCQPHQDCQHSPHGTSSHLLQSQHFSPVVYWGLFLFPVFSHFKPPVFLSGRSQHRLLPRAAERHFNVFADLTRGFSGPLQYVQARICGGTIDSGLPRRYHQCPRRGDTVQSVNGSSLSIPDDLRRQRECAISFLCPVWGWGARLGHRAAGAGLCSGCAGHCLSHCLGCLSVPPKELRAAGHLSSPGYLPSYERVPHLPHPWALCAPQYRSPLEGFCRWWQQPLLHKPSSGSHFCQLV	PAPGSTAPAAHGVTSAPESR,PAPGSTAPPAHGVTSAPESR,CHLGPGHQAGPGLHRPPSPR
MTPGTQSPFFLLLLLTVLTVVTGSGHASSTPGGEKETSATQRSSVPSSTEKNAVSMTSSVLSSHSPGSGSSTTQGQDVTLAPATEPASGSAATWGQDVTSVPVTRPALGSTTPPAHDVTSAPDNKPAPGSTAPPAHGVTSAPDTRPAPGSTAPQAHGVTSAPDTRPAPGSTAPPAHGVTSAPDTRPAPGSTAPPAHGVTSAPDTRPAPGSTAPAAHGVTSAPDTRPAPGSTAPQAHGVTSAPDTRPAPGSTAPPAHGVTSAPDTRPAPGSTAPPAHGVTSAPDTRPAPGSTAPPAHGVTSAPESRPAPGSTAPPAHGVTSAPDTRPAPGSTAPPAHGVTSAPDTRPAPGSTAPPAHGVTSAPDTRPAPGSTAPPAHGVTSAPDTRPAPGSTAPPAHGVTSAPDTRPAPGSTAPPSPRCHLGPGHQAGPGLHRPPSPRCHLGPGHQAGPGLHRPPSPRCHLGPGHQAGPGLHRPPSPRCHLGPGEQAGPGLHRARSPRCHLGPGEQAGPGLHRARSPRCHLGPGHQAGPGLHRPPSPRCHLGPGHQAGPGLHRPPSPRCHLGPGHQAGPGLHRPPSPRCHLGPGEQAGPGLHRPPSPRCHLGPGHQAGPGLHRPPSPRCHLGPGHQAGPGLHRPPSPRCHLGPGEQAGPGLHRARSPRCHLGPGEQAGPGLHRARSPRCHLGPGEQAGPGLHRPPSPRCHLGPGHQAGPGLHRPPSPRCHLGPGHQAGPGLHRPPSPRCHLGPGHQAGPGLHRPPSPRCHLGPGHQAGPGLHRPPSPRCHLGPGHQAGPGLHRPPSPRCHLGPGEQAGPGLHRARSPRCHLGPGEQAGPGLHRARSPRCHLGPGEQAGPGLHRPPSPRCHLGPGHQAGPGLHRPPSPRCHLGPGHQAGPGLHRPPSPRCHLGPGHQAGPGLHRPPSPRCHLGPGHQAGPGLHRPPSPRCHLGPGHQAGPGLHRPPSPRCHLGPGHQAGPAGSTAPPAHGVTSAPDTRPAPGSTAPPAHGVTSAPDTRPAPGSTAPPAHGVTSAPDTRPAPGSTAPPAHGVTSAPDTRPAPGSTAPPAHGVTSAPDTRPAPGSTAPPAHGVTSAPDTRRAPGSTPAPGSTAPPAHGVTSAPDTRPAPGSTAPPAHGVTSAPDNRPALGSTAPPVHNVTSASGSASGSASTLVHNGTSARATTTPASKSTPFSIPSHHSDTPTTLASHSTKTDASSTHHSTVPPLTSSNHSTSPQLSTGVSFFFLSFHISNLQFNSSLEDPSTDYYQELQRDISEMFLQIYKQGGFLGLSNIKFRPGSVVVQLTLAFREGTINVHDVETQFNQYKTEAASRYNLTISDVSVSDVPFPFSAQSGAGVPGWGIALLVLVCVLVALAIVYLIALAVCQCRRKNYGQLDIFPARDTYHPMSEYPTYHTHGRYVPPSSTDRSPYEKVSAGNGGSSLSYTNPAVAATSANL	PAPGSTAPPAHGVTSAPESR,CHLGPGHQAGPGLHRPPSPR,CHLGPGEQAGPGLHR
MTPGTQSPFFLLLLLTVLTVVTGSGHASSTPGGEKETSATQRSSVPSSTEKNAVSMTSSVLSSHSPGSGSSTTQGQDVTLAPATEPASGSAATWGQDVTSVPVTRPALGSTTPPAHDVTSAPDNKPAPGSTAPPAHGVTLAPDTRPAPGSTAPQAHGVTSAPDTRPAPGSTAPPSPRCHLGPGHQARPGLHRPPQPTVSPRPRTPGPPRAPPRPQPTVSPRPRTPGRPRAPPPPKPTVSPRPRTPGRPRAPPPPQPTVSPRPRTPGRPRAPPPPPAHGVTSAPDTRPAPGSTAPPSPRCHLGPGEQAGPGLHRPPQPTVSPRPRTPGPAPGSTAPPSPRCHLGPGHQARPGLHRARSPRCHLGPGHQAGPGLHRPPSPRCHLGPGHQAGPGLHRPPQPTVSPRPRTPGRPWAPPPPQPTVSPRPWRAGRPRAPPPPPAHGVTSAPDTRPAPGSTAPPSPRCHLGPGHQARPGLHRARSPRCHLGPGHQAGPGLHRPPQPTVSPRPRRAGRPRAPPRPQPTVSPRPRRAGRPRAPPRPQPTVSPRPRRAGRPRAPPPPQPTVSPRPRTPGPPQAPPPPPAHGVTSAPDTRPAPGSTAPAAHGVTSAPDTRPAPGSTAPQAHGVTSAPDTRPAPGSTAPPAHGVTSAPDTRPAPGSTAPPSPRCHLGPGHQAGPGLHRPPSPRCHLGPGEQAGPGLHRAPQPTVSPRPRRAGRPRAPPRPQPTVSPRPRRAGRPRAPPPPQPTVSPRPRTPGRPRAPPPPPAHGVTSAPDTRPAPGSTAPPSPRCHLGPGHQAGPGLHRPPQPTVSPRPRTPGRPRAPPPPQPTVSPRPRTPGRPRAPPPPQPTVSPRPRTPGRPRGLHRPPQPTVSPRPRTPGRPRAPPPPPAHGVTSAPDTRPAPGSTAPPSPRCHLGPGHQAGPGLHRPPSPRCHLGPGHQAGPGLHRTPSPRCHLGPGHQAGPGLHPGPGLHRPPQPTVSPRPRTPGRPRAPPPPQPMVSPRPRTTGPPWAPPPLQSTMSPRPQALHQAQLLLWCTTAPLPGLPQPQPARALHSQFPATTLILLPPLPAIAPRLMPVALTIARYLLSPPPITALLPSCLLGSLSFSCLFTFQTSSLIPLWKIPAPTTTKSCRETFLKCFCRFINKGVFWASPILSSGQDLWWYNLWPSEKVPSMSTTWRHSSISIKRKQPLDITRSQTSAVMCHFLSLPSLGLGCQAGASRCWCWSVFWLRWPLSISLPWLSVSAAERTTGSWTSFQPGIPTILASTPPTTPMGAMCPLAVPIVAPMRRFLQVMVAAASLTQTQQWQPLLPTC	CHLGPGHQAGPGLHRPPSPR,CHLGPGEQAGPGLHR
MSTSSLRRQMKNIVHNYSEAEIKVREATSNDPWGPSSSLMSEIADLTYNVVAFSEIMSMIWKRLNDHGKNWRHVYKAMTLMEYLIKTGSERVSQQCKENMYAVQTLKDFQYVDRDGKDQGVNVREKAKQLVALLRDEDRLREERAHALKTKEKLAQTATASSAAVGSGPPPEAEQAWPQSSGEEELQLQLALAMSKEEADQPPSCGPEDDAQLQLALSLSREEHDKEERIRRGDDLRLQMAIEESKRETGGKEESSLMDLADVFTAPAPAPTTDPWGGPAPMAAAVPTAAPTSDPWGGPPVPPAADPWGGPAPTPASGDPWRPAAPAGPSVDPWGGTPAPAAGEGPTPDPWGSSDGGVPVSGPSASDPWTPAPAFSDPWGGSPAKPSTNGTTAAGGFDTEPDEFSDFDRLRTALPTSGSSAGELELLAGEVPARSPGAFDMSGVRGSLAEAVGSPPPAATPTPTPPTRKTPESFLGPNAALVDLDSLVSRPGPTLPGAKASNPFLPGGGPATGPSVTNPFQPAPPATLTLNQLRLSPVPPVPGAPPTYISPLGGGPGLPPMMPPGPPAPNTNPFLL	TPESFLGPNAALVDLDSLVSRPGPTLPGAK,KTPESFLGPNAALVDLDSLVSRPGPTLPGAK
MSTSSLRRQMKNIVHNYSEAEIKVREATSNDPWGPSSSLMSEIADLTYNVVAFSEIMSMIWKRLNDHGKNWRHVYKAMTLMEYLIKTGSERVSQQCKENMYAVQTLKDFQYVDRDGKDQGVNVREKAKQLVALLRDEDRLREERAHALKTKEKLAQTATASSAAVGSGPPPEAEQAWPQSSGEEELQLQLALAMSKEEADQEERIRRGDDLRLQMAIEESKRETGGKEESSLMDLADVFTAPAPAPTTDPWGGPAPMAAAVPTAAPTSDPWGGPPVPPAADPWGGPAPTPASGDPWRPAAPAGPSVDPWGGTPAPAAGEGPTPDPWGSSDGGVPVSGPSASDPWTPAPAFSDPWGGSPAKPSTNGTTAGGFDTEPDEFSDFDRLRTALPTSGSSAGELELLAGEVPARSPGAFDMSGVRGSLAEAVGSPPPAATPTPTPPTRKTPESFLGPNAALVDLDSLVSRPGPTLPGAKASNPFLPGGGPATGPSVTNPFQPAPPATLTLNQLRLSPVPPVPGAPPTYISPLGGGPGLPPMMPPGPPAPNTNPFLL	TPESFLGPNAALVDLDSLVSRPGPTLPGAK,KTPESFLGPNAALVDLDSLVSRPGPTLPGAK
MGDQSWLWNQAAPGVRSPVFACSVEKGNVPLVLSEHLAHSRDPGSGAVRFLISPEPWASAILGTSGLLASPVLPAALDAVTCQHLPQPSSGSRPISPRIGALCPLLLQPGTMSTSSLRRQMKNIVHNYSEAEIKVREATSNDPWGPSSSLMSEIADLTYNVVAFSEIMSMIWKRLNDHGKNWRHVYKAMTLMEYLIKTGSERVSQQCKENMYAVQTLKDFQYVDRDGKDQGVNVREKAKQLVALLRDEDRLREERAHALKTKEKLAQTATASSAAVGSGPPPEAEQAWPQSSGEEELQLQLALAMSKEEADQEERIRRGDDLRLQMAIEESKRETGGKEESSLMDLADVFTAPAPAPTTDPWGGPAPMAAAVPTAAPTSDPWGGPPVPPAADPWGGPAPTPASGDPWRPAAPAGPSVDPWGGTPAPAAGEGPTPDPWGSSDGGVPVSGPSASDPWTPAPAFSDPWGGSPAKPSTNGTTAAGGFDTEPDEFSDFDRLRTALPTSGSSAGELELLAGEVPARSPGAFDMSGVRGSLAEAVGSPPPAATPTPTPPTRKTPESFLGPNAALVDLDSLVSRPGPTLPGAKASNPFLPGGGPATGPSVTNPFQPAPPATLTLNQLRLSPVPPVPGAPPTYISPLGGGPGLPPMMPPGPPAPNTNPFLL	TPESFLGPNAALVDLDSLVSRPGPTLPGAK,KTPESFLGPNAALVDLDSLVSRPGPTLPGAK
MRVMAPRTLILLLSGALALTETWAGSHSMRYFSTSVSWPGRGEPRFIAVGYVDDTQFVRFDSDAASPRGEPREPWVEQEGPEYWDRETQKYKRQAQADRVNLRKLRGYYNQSEDGSHTLQRMFGCDLGPDGRLLRGYNQFAYDGKDYIALNEDLRSWTAADTAAQITQRKWEAAREAEQRRAYLEGTCVEWLRRYLENGKETLQRAEHPKTHVTHHPVSDHEATLRCWALGFYPAEITLTWQWDGEDQTQDTELVETRPAGDGTFQKWAAVVVPSGEEQRYTCHVQHEGLPEPLTLRWKPSSQPTIPIVGIVAGLAVLAVLAVLGAMVAVVMCRRKSSGHFLPTGGKGGSCSQAASSNSAQGSDESLIACKA	YFSTSVSWPGRGEPR,YFSTSVSWPGR
XRVMAPRTLILLLSGALALTETWAGSHSMRYFSTSVSWPGRGEPRFIAVGYVDDTQFVRFDSDAASPRGEPREPWVEQEGPEYWDRETQKYKRQAQADRVNLRKLRGYYNQSEDGSHTLQRMFGCDLGPDGRLLRGYNQFAYDGKDYIALNEDLRSWTAADTAAQITQRKWEAAREAEQRRAYLEGTCVEWLRRYLENGKETLQRAEHPKTHVTHHPVSDHEASRRWNLPEVGSCGGAFWRRAEIHVPCSARGAAGAPHPE	YFSTSVSWPGRGEPR,YFSTSVSWPGR
MRVMAPRTLILLLSGALALTETWAGSHSMRYFSTSVSWPGRGEPRFIAVGYVDDTQFVRFDSDAASPRGEPREPWVEQEGPEYWDRETQKYKRQAQADRVNLRKLRGYYNQSEDGSHTLQRMFGCDLGPDGRLLRGYNQFAYDGKDYIALNEDLRSWTAADTAAQITQRKWEAAREAEQRRAYLEGTCVEWLRRYLENGKETLQRAEHPKTHVTHHPVSDHEATLRCWALGFYPAEITLTWQWDGEDQTQDTELVETRPAGDGTFQKWAAVVVPSGEEQRYTCHVQHEGLPEPLTLRWKPSSQPTIPIVGIVAGLAVLAVLAVLGAMVAVVMCRRKSSGGKGGSCSQAASSNSAQGSDESLIACKA	YFSTSVSWPGRGEPR,YFSTSVSWPGR
MRVMAPRTLILLLSGALALTETWAGSHSMRYFSTSVSWPGRGEPRFIAVGYVDDTQFVRFDSDAASPRGEPREPWVEQEGPEYWDRETQKYKRQAQADRVNLRKLRGYYNQSEDEDVWLRPGAGRAPPPRV	YFSTSVSWPGRGEPR,YFSTSVSWPGR
XSTKGPSVFPLAPCSRSTSGGTAALGCLVKDYFPEPVTVSWNSGALTSGVHTFPAVLQSSGLYSLSSVVTVPSSSLGTQTYTCNVNHKPSNTKVDKRVELKTPLGDTTHTCPRCPEPKSCDTPPPCPRCPEPKSCDTPPPCPRCPGKPAQASPSSSSSSSAPELLGGPSVFLFPPKPKDTLMISRTPEVTCVVVDVSHEDPEVQFKWYVDGVEVHNAKTKPREEQYNSTFRVVSVLTVLHQDWLNGKEYKCKVSNKALPAPIEKTISKTKGQPREPQVYTLPPSREEMTKNQVSLTCLVKGFYPSDIAVEWESSGQPENNYNTTPPMLDSDGSFFLYSKLTVDKSRWQQGNIFSCSVMHEALHNRFTQKSLSLSPGK	CPGKPAQASPSSSSSSSAPELLGGPSVFLFPPKPK,PAQASPSSSSSSSAPELLGGPSVFLFPPKPK
XSTKGPSVFPLAPCSRSTSGGTAALGCLVKDYFPEPVTVSWNSGALTSGVHTFPAVLQSSGLYSLSSVVTVPSSSLGTQTYTCNVNHKPSNTKVDKRVELKTPLGDTTHTCPRCPEPKSCDTPPPCPRCPEPKSCDTPPPCPRCPGKPAQASPSSSSSSSAPELLGGPSVFLFPPKPKDTLMISRTPEVTCVVVDVSHEDPEVQFKWYVDGVEVHNAKTKPREEQFNSTFRVVSVLTVLHQDWLNGKEYKCKVSNKALPAPIEKTISKTKGQPREPQVYTLPPSREEMTKNQVSLTCLVKGFYPSDIAVEWESSGQPENNYNTTPPMLDSDGSFFLYSKLTVDKSRWQQGNIFSCSVMHEALHNRFTQKSLSLSPGK	CPGKPAQASPSSSSSSSAPELLGGPSVFLFPPKPK,PAQASPSSSSSSSAPELLGGPSVFLFPPKPK
MSLRNLWRDYKVLVVMVPLVGLIHLGWYRIKSSPVFQIPKNDNIPEQDSLGLSNLQKSQIQGK	NDNIPEQDSLGLSNLQK,SSPVFQIPKNDNIPEQDSLGLSNLQK
MARLCRRVPCTLLLGLAVVLLKARLVPAAARAELSRSDLSLIQQQQQQQQQQQQQQQQKQLEEAEEERTEVPGATSTLTVPVSVFMLKVQVNDIISRQYLSQAVVEVFVNYTKTNSTVTKSNGAVLIKVPYKLGLSLTIIAYKDGYVLTPLPWKTRRMPIYSSVTLSLFPQSQANIWLFEDTVLITGKLADAKSQPSVQFSKALIKLPDNHHISNVTGYLTVLQQFLKVDNFLHTTGITLNKPGFENIELTPLAAICVKIYSGGKELKVNGSIQVSLPLLRLNDISAGDRIPAWTFDMNTGAWVNHGRGMVKEHNNHLIWTYDAPHLGYWIAAPLPGTRGSGINEDSKDITAYHTVFLTAILGGTIVIVIGFFAVLLCYCRDKCGTPQKRERNITKLEVLKRDQTTSTTHINHISTVKVALKAEDKSQLFNAKNSSYSPQKKEPSKAETEERVSMVKTRDDFKIYNEDVSFLSVNQNNYSRNPTQSLEPNVGSKQPKHINNNLSSSLGDAQDEKRYLTGNEEAYGRSHIPEQLMHIYSQPIAILQTSDLFSTPEQLHTAKSATLPRKGQLVYGQLMEPVNRENFTQTLPKMPIHSHAQPPDAREEDIILEGQQSLPSQASDWSRYSSSLLESVSVPGTLNEAVVMTPFSSELQGISEQTLLELSKGKPSPHPRAWFVSLDGKPVAQVRHSFIDLKKGKRTQSNDTSLDSGVDMNELHSSRKLEREKTFIKSMHQPKILYLEDLDLSSSESGTTVCSPEDPALRHILDGGSGVIMEHPGEESPGRKSTVEDFEANTSPTKRRGRPPLAKRDSKTNIWKKREERPLIPIN	AELSRSDLSLIQQQQQQQQQQQQQQQQK,SDLSLIQQQQQQQQQQQQQQQQK
MARLCRRVPCTLLLGLAVVLLKARLVPAAARAELSRSDLSLIQQQQQQQQQQQQQQQQKQLEEAEEERTEVPGATSTLTVPVSVFMLKVQVNDIISRQYLSQAVVEVFVNYTKTNSTVTKSNGAVLIKVPYKLGLSLTIIAYKDGYVLTPLPWKTRRMPIYSSVTLSLFPQSQANIWLFEDTVLITGKLADAKSQPSVQFSKALIKLPDNHHISNVTGYLTVLQQFLKVDNFLHTTGITQ	AELSRSDLSLIQQQQQQQQQQQQQQQQK,SDLSLIQQQQQQQQQQQQQQQQK
MTPGTQSPFFLLLLLTVLTVVTGSGHASSTPGGEKETSATQRSSVPSSTEKNAVSMTSSVLSSHSPGSGSSTTQGQDVTLAPATEPASGSAATWGQDVTSVPVTRPALGSTTPPAHDVTSAPDNKPAPGSTAPPAHGVTSAPDTRPAPGSTAPQAHGVTSAPDTRPAPGSTAPPAHGVTSAPDTRPAPGSTAPPAHGVTSAPDTRPAPGSTAPAAHGVTSAPDTRPAPGSTAPQAHGVTSAPDTRPAPGSTAPTAHGVTSAPDTRPAPGSTAPPAHGVTSAPDTRPAPGSTAPPAHGVTSAPESRPAPGSTAPHAHGVTSAPESRPAPGSTAPPAHGVTSAPDTRPAPGSTAPPAHGVTSAPDTRPAPGSTAPAAHGVTSAPDTRPAPGSTAPQAHGVTSAPDTRPAPGSTAPPAHGVTSAPDTRLAPGSTAPPAHGVTSAPDTRPAPGSTAPPAHGVTSAPESRPAPGSTAPAAHGVTSAPESRPAPGSTAPAAHGVTSAPESRPAPGSTAPPAHGVTSAPDTRPAPGSTAPPAHGVTSAPDTRPAPGSTAPPAHGVTSAPESRPAPGSTAPPAHGVTSAPDTRPAPGSTAPPAHGVTSAPDTRPAPGSTAPPAHGVTSAPDTRPAPGSTAPPAHGVTSAPDTRPAPGSTAPAAHGVTSAPESRPAPGSTAPAAHGVTSAPESRPAPGSTAPPAHGVTSAPDTRPAPGSTAPPAHGVTSAPDTRPAPGSTAPPAHGVTSAPDTRPAPGSTAPPAHGVTSAPDTRPAPGSTAPPAHGVTSAPDTRPAPGSTAPPAHGVTSAPDTRPAPGSTAPPAHGVTSAPDTRPAPGSTAPPAHGVTSAPDTRPAPGSTPAPGSTAPPAHGVTSAPDTRPAPGSTAPPAHGVTSAPDNRPALGSTAPPVHNVTSASGSASGSASTLVHNGTSARATTTPASKSTPFSIPSHHSDTPTTLASHSTKTDASSTHHSTVPPLTSSNHSTSPQLSTGVSFFFLSFHISNLQFNSSLEDPSTDYYQELQRDISEMFLQIYKQGGFLGLSNIKFRPGSVVVQLTLAFREGTINVHDVETQFNQYKTEAASRYNLTISDVSVSDVPFPFSAQSGAGVPGWGIALLVLVCVLVALAIVYLIALAVCQCRRKNYGQLDIFPARDTYHPMSEYPTYHTHGRYVPPSSTDRSPYEKVSAGNGGSSLSYTNPAVAATSANL	PAPGSTAPAAHGVTSAPESR,PAPGSTAPPAHGVTSAPESR
MTPGTQSPFFLLLLLTVLTVVTGSGHASSTPGGEKETSATQRSSVPSSTEKNAVSMTSSVLSSHSPGSGSSTTQGQDVTLAPATEPASGSAATWGQDVTSVPVTRPALGSTTPPAHDVTSAPDNKPAPGSTAPPAHGVTSAPDTRPAPGSTAPQAHGVTSAPDTRPAPGSTAPPAHGVTSAPDTRPAPGSTAPPAHGVTSAPDTRPAPGSTAPAAHGVTSAPDTRPAPGSTAPQAHGVTSAPDTRPAPGSTAPPAHGVTSAPDTRPAPGSTAPPAHGVTSAPDTRPAPGSTAPPAHGVTSAPDTRPAPGSTAPPAHGVTSAPDTRPAPGSTAPPAHGVTSAPDTRPAPGSTAPPAHGVTSAPDTRPAPGSTAPPAHGVTSAPDTRPAPGSTAPPAHGVTSAPDTRPAPGSTAPPAHGVTSAPDTRPAPGSTAPPAHGVTSAPDTRPAPGSTAPPAHGVTSAPESRPAPGSTAPAAHGVTSAPESRPAPGSTAPAAHGVTSAPESRPAPGSTAPPAHGVTSAPDTRPAPGSTAPPAHGVTSAPDTRPAPGSTAPPAHGVTSAPDTRPAPGSTAPPAHGVTSAPDTRPAPGSTAPPAHGVTSAPESRPAPGSTAPPAHGVTSAPESRPAPGSTAPPAHGVTSAPDTRPAPGSTAPPAHGVTSAPDTRPAPGSTAPPAHGVTSAPESRPAPGSTAPAAHGVTSAPESRPAPGSTAPPAHGVTSAPDTRPAPGSTAPPAHGVTSAPDTRPAPGSTAPPAHGVTSAPDTRPAPGSTAPPAHGVTSAPDTRPAPGSTAPPAHGVTSAPDTRPAPGSTAPPAHGVTSAPDTRPAPGSTAPPAHGVTSAPDTRPAPGSTAPPAHGVTSAPDTRRAPGSTPAPGSTAPPAHGVTSAPDTRPAPGSTAPPAHGVTSAPDNRPALGSTAPPVHNVTSASGSASGSASTLVHNGTSARATTTPASKSTPFSIPSHHSDTPTTLASHSTKTDASSTHHSTVPPLTSSNHSTSPQLSTGVSFFFLSFHISNLQFNSSLEDPSTDYYQELQRDISEMFLQIYKQGGFLGLSNIKFRPGSVVVQLTLAFREGTINVHDVETQFNQYKTEAASRYNLTISDVSVSDVPFPFSAQSGAGVPGWGIALLVLVCVLVALAIVYLIALAVCQCRRKNYGQLDIFPARDTYHPMSEYPTYHTHGRYVPPSSTDRSPYEKVSAGNGGSSLSYTNPAVAATSANL	PAPGSTAPAAHGVTSAPESR,PAPGSTAPPAHGVTSAPESR
MTPGTQSPFFLLLLLTVLTVVTGSGHASSTPGGEKETSATQRSSVPSSTEKNAVSMTSSVLSSHSPGSGSSTTQGQDVTLAPATEPASGSAATWGQDVTSVPVTRPALGSTTPPAHDVTSAPDNKPAPGSTAPPAHGVTSAPDTRPAPGSTAPQAHGVTSAPDTRPAPGSTAPPAHGVTSAPDTRPAPGSTAPPAHGVTSAPDTRPAPGSTAPAAHGVTSAPDTRPAPGSTAPQAHGVTSAPDTRPAPGSTAPPAHGVTSAPDTRPAPGSTAPPAHGVTSAPDTRPAPGSTAPPAHGVTSAPESRPAPGSTAPAAHGVTSAPESRPAPGSTAPAAHGVTSAPESRPAPGSTAPPAHGVTSAPDTRPAPGSTAPPAHGVTSAPDTRPAPGSTAPPAHGVTSAPDTRPAPGSTAPPAHGVTSAPDTRPAPGSTAPPAHGVTSAPDTRPAPGSTAPPAHGVTSAPESRPAPGSTAPAAHGVTSAPDTRPAPGSTAPPAHGVTSAPDTRPAPGSTAPPAHGVTSAPDTRPAPGSTAPPAHGVTSAPDTRPAPGSTAPPAHGVTSAPDTRPAPGSTAPPAHGVTSAPESRPAPGSTAPAAHGVTSAPDTRPAPGSTAPPAHGVTSAPDTRPAPGSTAPPAHGVTSAPDTRPAPGSTAPPAHGVTSAPDTRPAPGSTAPPAHGVTSAPDTRPAPGSTAPAAHGVTSAPESRPAPGSTAPAAHGVTSAPESRPAPGSTAPPAHGVTSAPDTRPAPGSTAPPAHGVTSAPDTRPAPGSTAPPAHGVTSAPDTRPAPGSTAPPAHGVTSAPDTRPAPGSTAPPAHGVTSAPDTRPAPGSTAPPAHGVTSAPDTRPAPGSTAPPAHGVTSAPDTRPAPGSTAPPAHGVTSAPDTRPAPGSTAPPAHGVTSAPDTRRAPGSTPAPGSTAPPAHGVTSAPDTRPAPGSTAPPAHGVTSAPDNRPALGSTAPPVHNVTSASGSASGSASTLVHNGTSARATTTPASKSTPFSIPSHHSDTPTTLASHSTKTDASSTHHSTVPPLTSSNHSTSPQLSTGVSFFFLSFHISNLQFNSSLEDPSTDYYQELQRDISEMFLQIYKQGGFLGLSNIKFRPGSVVVQLTLAFREGTINVHDVETQFNQYKTEAASRYNLTISDVSVSDVPFPFSAQSGAGVPGWGIALLVLVCVLVALAIVYLIALAVCQCRRKNYGQLDIFPARDTYHPMSEYPTYHTHGRYVPPSSTDRSPYEKVSAGNGGSSLSYTNPAVAATSANL	PAPGSTAPAAHGVTSAPESR,PAPGSTAPPAHGVTSAPESR
MTPGTQSPFFLLLLLTVLTVVTGSGHASSTPGGEKETSATQRSSVPSSTEKNAVSMTSSVLSSHSPGSGSSTTQGQDVTLAPATEPASGSAATWGQDVTSVPVTRPALGSTTPPAHDVTSAPDNKPAPGSTAPPAHGVTSAPDTRPAPGSTAPQAHGVTSAPDTRPAPGSTAPPAHGVTSAPDTRPAPGSTAPPAHGVTSAPDTRPAPGSTAPAAHGVTSAPDTRPAPGSTAPQAHGVTSAPDTRPAPGSTAPPAHGVTSAPDTRPAPGSTAPPTHGVTSAPDTRPAPGSTAPPAHGVTSAPDTRPAPGSTAPPAHGVTSAPDTRPAPGSTAPPAHGVTSAPDTRPAPGSTAPPAHGVTSAPESRPAPGSTAPAAPGVTSAPESRPAPGSTAPAAHGVTSAPDTRPAPGSTAPPAHGVTSAPDTRPAPGSTAPPAHGVTSAPDTRPAPGSTAPPAHGVTSAPDTRPAPGSTAPPAHGVTSAPDTRPAPGSTAPPAHGVTSAPDTRPAPGSTAPPAHGVTSAPDTRPAPGSTAPPAHGVTSAPDTRPAPGSTAPPTHGVTSAPDTRPAPGSTAPPAHGVTSAPDTRPAPGSTAPPAHGVTSAPDTRPAPGSTAPPAHGVTSAPDTRPAPGSTAPPAHGVTSAPDTRPAPGSTAPPAHGVTSAPESRPAPGSTAPAAHGVTSAPESRPAPGSTAPAAHGVTSAPESRPAPGSTAPPAHGVTSAPDTRPAPGSTAPPAHGVTSAPDTRPAPGSTAPPAHGVTSAPDTRPAPGSTAPPTHGVTSAPDTRPAPGSTAPPAHGVTSAPDTRPAPGSTAPPAHGVTSAPDTRPAPGSTAPPAHGVTSAPDTRPAPGSTAPPAHGVTSAPDTRPAPGSTAPPAHGVTSAPDTRPAPGSTAPPAHGVTSAPDTRRAPGSTPAPGSTAPPAHGVTSAPDTRPAPGSTAPPAHGVTSAPDNRPALGSTAPPVHNVTSASGSASGSASTLVHNGTSARATTTPASKSTPFSIPSHHSDTPTTLASHSTKTDASSTHHSTVPPLTSSNHSTSPQLSTGVSFFFLSFHISNLQFNSSLEDPSTDYYQELQRDISEMFLQIYKQGGFLGLSNIKFRPGSVVVQLTLAFREGTINVHDVETQFNQYKTEAASRYNLTISDVSVSDVPFPFSAQSGAGVPGWGIALLVLVCVLVALAIVYLIALAVCQCRRKNYGQLDIFPARDTYHPMSEYPTYHTHGRYVPPSSTDRSPYEKVSAGNGGSSLSYTNPAVAATSANL	PAPGSTAPAAHGVTSAPESR,PAPGSTAPPAHGVTSAPESR
MTPGTQSPFFLLLLLTVLTVVTGSGHASSTPGGEKETSATQRSSVPSSTEKNAVSMTSSVLSSHSPGSGSSTTQGQDVTLAPATEPASGSAATWGQDVTSVPVTRPALGSTTPPAHDVTSAPDNKPAPGSTAPPAHGVTSAPDTRPAPGSTAPQAHGVTSAPDTRPAPGSTAPPAHGVTSAPDTRPAPGSTAPPAHGVTSAPDTRPAPGSTAPAAHGVTSAPDTRPAPGSTAPQAHGVTSAPDTRPAPGSTAPPAHGVTSAPDTRPAPGSTAPPAHGVTSAPDTRPAPGSTAPPAHGVTSAPDTRPAPGSTAPPAHGVTSAPDTRPAPGSTAPPAHGVTSAPDTRPAPGSTAPPAHGVTSAPESRPAPGSTAPAAHGVTSAPESRPAPGSTAPAAHGVTSAPDTRPAPGSTAPPAHGVTSAPESRPAPGSTAPPAHGVTSAPDTRPAPGSTAPPAHGVTSAPDTRPAPGSTAPPAHGVTSAPDTRPAPGSTAPPAHGVTSAPDTRPAPGSTAPPAHGVTSAPDTRPAPGSTAPPAHGVTSAPDTRPAPGSTAPPAHGVTSAPDTRPAPGSTAPPAHGVTSAPDTRPAPGSTAPPAHGVTSAPDTRPAPGSTAPPAHGVTSAPDTRPAPGSTAPPAHGVTSAPDTRPAPGSTAPPAHGVTSAPDTRPAPGSTAPPAHGVTSAPDTRPAPGSTAPAAHGVTSAPESRPAPGSTAPAAHGVTSAPESRPAPGSTAPPAHGVTSAPDTRPAPGSTAPPAHGVTSAPDTRPAPGSTAPPAHGVTSAPDTRPAPGSTAPPAHGVTSAPDTRPAPGSTAPPAHGVTSAPDTRPAPGSTAPPAHGVTSAPDTRPAPGSTAPPAHGVTSAPDTRPAPGSTAPPAHGVTSAPDTRPAPGSTAPPAHGVTSAPDTRRAPGSTRAPGSTAPPAHGVTSAPDTRPAPGSTAPPAHGVTSAPDNRPALGSTAPPVHNVTSASGSASGSASTLVHNGTSARATTTPASKSTPFSIPSHHSDTPTTLASHSTKTDASSTHHSTVPPLTSSNHSTSPQLSTGVSFFFLSFHISNLQFNSSLEDPSTDYYQELQRDISEMFLQIYKQGGFLGLSNIKFRPGSVVVQLTLAFREGTINVHDVETQFNQYKTEAASRYNLTISDVSVSDVPFPFSAQSGAGVPGWGIALLVLVCVLVALAIVYLIALAVCQCRRKNYGQLDIFPARDTYHPMSEYPTYHTHGRYVPPSSTDRSPYEKVSAGNGGSSLSYTNPAVAATSANL	PAPGSTAPAAHGVTSAPESR,PAPGSTAPPAHGVTSAPESR
MTPGTQSPFFLLLLLTVLTDPTLLLLTATTAPKPATVVTGSGHASSTPGGEKETSATQRSSVPSSTEKNAVSMTSSVLSSHSPGSGSSTTQGQDVTLAPATEPASGSAATWGQDVTSVPVTRPALGSTTPPAHDVTSAPDNKPAPGSTAPPAHGVTSAPDTRPAPGSTAPQAHGVTSAPDTRPAPGSTAPPAHGVTSAPDTRPAPGSTAPPAHGVTSAPDTRPAPGSTAPAAHGVTSAPDTRPAPGSTAPQAHGVTSAPESRPAPGSTAPPAHGVTSAPDTRPAPGSTAPPAHGVTSAPDTRPAPGSTAPPAHGVTSAPESRPAPGSTAPAAHGVTSAPESRPAPGSTAPPAHGVTSAPDTRPAPGSTAPPAHGVTSAPDTRPAPGSTAPAAHGVTSAPDTRPAPGSTAPQAHGVTSAPDTRPAPGSTAPPAHGVTSAPDTRPAPGSTAPPAHGVTSAPDTRPAPGSTAPPAHGVTSAPESRPAPGSTAPAAHGVTSAPESRPAPGSTAPAAHGVTSAPESRPAPGSTAPPAHGVTSAPDTRPAPGSTAPPAHGVTSAPDTRPAPGSTAPPAHGVTSAPDTRPAPGSTAPPAHGVTSAPDTRPAPGSTAPPAHGVTSAPDTRPAPGSTAPPAHGVTSAPDTRPAPGSTAPAAHGVTSAPESRPAPGSTAPAAHGVTSAPESRPAPGSTAPPAHGVTSAPDTRPAPGSTAPPAHGVTSAPDTRPAPGSTAPPAHGVTSAPDTRPAPGSTAPPAHGVTSAPDTRPAPGSTAPPAHGVTSAPDTRPAPGSTAPPAHGVTSAPDTRPAPGSTASPRCHLGPGHQAGPGLHRTPSPRCHLGPGHQAGPGLHPGPGSTAPPAHGVTSAPDTRPAPGSTAPPAHGVTSAPDTRPAPGSTAPPAHGVTSAPDTRPAPGSTPAPGSTAPPAHGVTSAPDTRPAPGSTAPPAHGVTSAPDNRPALGSTAPPVHNVTSASGSASGSASTLVHNGTSARATTTPASKSTPFSIPSHHSDTPTTLASHSTKTDASSTHHSTVPPLTSSNHSTSPQLSTGVSFFFLSFHISNLQFNSSLEDPSTDYYQELQRDISEMFLQIYKQGGFLGLSNIKFRPGSVVVQLTLAFREGTINVHDVETQFNQYKTEAASRYNLTISDVSVSDVPFPFSAQSGAGVPGWGIALLVLVCVLVALAIVYLIALAVCQCRRKNYGQLDIFPARDTYHPMSEYPTYHTHGRYVPPSSTDRSPYEKVSAGNGGSSLSYTNPAVAATSANL	PAPGSTAPAAHGVTSAPESR,PAPGSTAPPAHGVTSAPESR
MTPGTQSPFFLLLLLTVLTVVTGSGHASSTPGGEKETSATQRSSVPSSTEKNAVSMTSSVLSSHSPGSGSSTTQGQDVTLAPATEPASGSAATWGQDVTSVPVTRPALGSTTPPAHDVTSAPDNKPAPGSTAPPAHGVTSAPDTRPAPGSTAPQAHGVTSAPDTRPAPGSTAPPAHGVTSAPDTRPAPGSTAPPAHGVTSAPDTRPAPGSTAPAAHGVTSAPDTRPAPGSTAPQAHGVTSAPDTRPAPGSTAPPAHGVTSAPDTRPAPGSTAAPAHGVTSAPDTRPAPGSTAPPAHGVTSAPESRPAPGSTAPAAHGVTSAPESRPAPGSTAPPAHGVTSAPDTRPAPGSTAPPAHGVTSAPESRPAPGSTAPAAHGVTSAPESRPAPGSTAPAAHGVTSAPESRPAPGSTAPPAHGVTSAPDTRPAPGSTAPPAHGVTSAPDTRPAPGSTAPPTHGVTSAPDTRPAPGSTAPAAHGVTSAPDTRPAPGSTAPQAHGVTSAPDTRPAPGSTAPPAHGVTSAPDTRPAPGSTAPPAHGVTSAPDTRPAPGSTAPPTHGVTSAPDTRPAPGSTAPPAHGVTSAPDTRPAPGSTAPPAHGVTSAPDTRPAPGSTAPPAHGVTSAPDTRPAPGSTAPPAHGVTSAPDTRPAPGSTAPPAHGVTSAPDTRPAPGSTAPPAHGVTSAPDTRPAPGSTAPPAHGVTSAPDTRPAPGSTAPPAHGVTSAPDTRPAPGSTAPPAHGVTSAPDTRPAPGSTAPPAHGVTSAPDTRPAPGSTAPPTHGVTSAPDTRPAPGSTAPPAHGVTSAPDTRPAPGSTAPPAHGVTSAPDTRPAPGSTAPPAHGVTSAPDTRPAPGSTAPPAHGVTSAPDTRPAPGSTAPPAHGVTSAPDTRPAPGSTAPPAHGVTSAPDTRPAPGSTPAPGSTAPPAHGVTSAPDTRPAPGSTAPPAHGVTSAPDNRPALGSTAPPVHNVTSASGSASGSASTLVHNGTSARATTTPASKSTPFSIPSHHSDTPTTLASHSTKTDASSTHHSTVPPLTSSNHSTSPQLSTGVSFFFLSFHISNLQFNSSLEDPSTDYYQELQRDISEMFLQIYKQGGFLGLSNIKFRPGSVVVQLTLAFREGTINVHDVETQFNQYKTEAASRYNLTISDVSVSDVPFPFSAQSGAGVPGWGIALLVLVCVLVALAIVYLIALAVCQCRRKNYGQLDIFPARDTYHPMSEYPTYHTHGRYVPPSSTDRSPYEKVSAGNGGSSLSYTNPAVAATSANL	PAPGSTAPAAHGVTSAPESR,PAPGSTAPPAHGVTSAPESR
MTPGTQSPFFLLLLLTVLTVVTGSGHASSTPGGEKETSATQRSSVPSSTEKNAVSMTSSVLSSHSPGSGSSTTQGQDVTLAPATEPASGSAATWGQDVTSVPVTRPALGSTTPPAHDVTSAPDNKPAPGSTAPPAHGVTSAPDTRPAPGSTAPQAHGVTSAPDTRPAPGSTAPPAHGVTSAPDTRPAPGSTAPPAHGVTSAPDTRPAPGSTAPAAHGVTSAPDTRPAPGSTAPQAHGVTSAPDTRPAPGSTAPTAHGVTSAPDTRPAPGSTAPPAHGVTSAPDTRPAPGSTAPPAHGVTSAPESRPAPGSTAPAAHGVTSAPDTRPAPGSTAPPAHGVTSAPDTRPAPGSTAPPAHGVTSAPDTRPAPGSTAPAAHGVTSAPDTTPAPGSTAPQAHGVTSAPDTRPAPGSTAPPAHGVTSAPDTRPAPGSTAPPAHGVTSAPDTRPAPGSTAPPAHGVTSAPESRPAPGSTAPAAHGVTSAPESRPAPGSTAPAAHGVTSAPESRPAPGSTAPPAHGVTSAPDTRPAPGSTAPPAHGVTSAPDTRPAPGSTAPPAHGVTSAPDTRPAPGSTAPPAHGVTSAPDTRPAPGSTAPPAHGVTSAPDTRPAPGSTAPPAHGVTSAPDTRPAPGSTAPPAHGVTSAPDTRPAPGSTAPAAHGVTSAPESRPAPGSTAPAAHGVTSAPESRPAPGSTAPPAHGVTSAPDTRPAPGSTAPPAHGVTSAPDTRPAPGSTAPPAHGVTSAPDTRPAPGSTAPPAHGVTSAPDTRPAPGSTAPPAHGVTSAPDTRPAPGSTAPPAHGVTSAPDTRPAPGSTAPPAHGVTSAPDTRPAPGSTAPPAHGVTSAPDTRPAPGSTPAPGSTAPPAHGVTSAPDTRPAPGSTAPPAHGVTSAPDNRPALGSTAPPVHNVTSASGSASGSASTLVHNGTSARATTTPASKSTPFSIPSHHSDTPTTLASHSTKTDASSTHHSTVPPLTSSNHSTSPQLSTGVSFFFLSFHISNLQFNSSLEDPSTDYYQELQRDISEMFLQIYKQGGFLGLSNIKFRPGSVVVQLTLAFREGTINVHDVETQFNQYKTEAASRYNLTISDVSVSDVPFPFSAQSGAGVPGWGIALLVLVCVLVALAIVYLIALAVCQCRRKNYGQLDIFPARDTYHPMSEYPTYHTHGRYVPPSSTDRSPYEKVSAGNGGSSLSYTNPAVAATSANL	PAPGSTAPAAHGVTSAPESR,PAPGSTAPPAHGVTSAPESR
MTPGTQSPFFLLLLLTVLTVVTGSGHASSTPGGEKETSATQRSSVPSSTEKNAVSMTSSVLSSHSPGSGSSTTQGQDVTLAPATEPASGSAATWGQDVTSVPVTRPALGSTTPPAHDVTSAPDNKPAPGSTAPPAHGVTSAPDTRPAPGSTAPQAHGVTSAPDTRPAPGSTAPPAHGVTSAPDTRPAPGSTAPPAHGVTSAPDTRPAPGSTAPAAHGVTSAPDTRPAPGSTAPQAHGVTSAPDTRPAPGSTAPTAHGVTSAPDTRPAPGSTAPPAHGVTSAPDTRPAPGSTAPPAHGVTSAPESRPAPGSTAPAAHGVTSAPESRPAPGSTAPPAHGVTSAPDTRPAPGSTAPPAHGVTSAPDTRPAPGSTAPAAHGVTSAPDTRPAPGSTAPQAHGVTSAPDTRPAPGSTAPPAHGVTSAPDTRPAPGSTAPPAHGVTSAPDTRPAPGSTAPPAHGVTSAPESRPAPGSTAPAAHGVTSAPESRPAPGSTAPAAHGVTSAPESRPAPGSTAPPAHGVTSAPDTRPAPGSTAPPAHGVTSAPDTRPAPGSTAPPAHGVTSAPDTRPAPGSTAPPAHGVTSAPDTRPAPGSTAPPAHGVTSAPDTRPAPGSTAPPAHGVTSAPDTRPAPGSTAPPAHGVTSAPDTRPAPGSTAPAAHGVTSAPESRPAPGSTAPAAHGVTSAPESRPAPGSTAPPAHGVTSAPDTRPAPGSTAPPAHGVTSAPDTRPAPGSTAPPAHGVTSAPDTRPAPGSTAPPAHGVTSAPDTRPAPGSTAPPAHGVTSAPDTRPAPGSTAPPAHGVTSAPDTRPAPGSTAPPAHGVTSAPDTRPAPGSTAPPAHGVTSAPDTRPAPGSTAPPAHGVTSAPDTRPAPGSTPAPGSTAPPAHGVTSAPDTRPAPGSTAPPAHGVTSAPDNRPALGSTAPPVHNVTSASGSASGSASTLVHNGTSARATTTPASKSTPFSIPSHHSDTPTTLASHSTKTDASSTHHSTVPPLTSSNHSTSPQLSTGVSFFFLSFHISNLQFNSSLEDPSTDYYQELQRDISEMFLQIYKQGGFLGLSNIKFRPGSVVVQLTLAFREGTINVHDVETQFNQYKTEAASRYNLTISDVSVSDVPFPFSAQSGAGVPGWGIALLVLVCVLVALAIVYLIALAVCQCRRKNYGQLDIFPARDTYHPMSEYPTYHTHGRYVPPSSTDRSPYEKVSAGNGGSSLSYTNPAVAATSANL	PAPGSTAPAAHGVTSAPESR,PAPGSTAPPAHGVTSAPESR
MTPGTQSPFFLLLLLTVLTVVTGSGHASSTPGGEKETSATQRSSVPSSTEKNAVSMTSSVLSSHSPGSGSSTTQGQDVTLAPATEPASGSAATWGQDVTSVPVTRPALGSTTPPAHDVTSAPDNKPAPGSTAPPAHGVTSAPDTRPAPGSTAPQAHGVTSAPDTRPAPGSTAPPAHGVTSAPDTRPAPGSTAPPAHGVTSAPDTRPAPGSTAPAAHGVTSAPDTRPAPGSTAPQAHGVTSAPDTRPAPGSTAPTAHGVTSAPDTRPAPGSTAPPAHGVTSAPDTRPAPGSTAPPAHGVTSAPESRPAPGSTAPAAHGVTSAPESRPAPGSTAPPAHGVTSAPDTRPAPGSTAPPAHGVTSAPDTRPAPGSTAPAAHGVTSAPDTRPAPGSTAPQAHGVTSAPDTRPAPGSTAPPAHGVTSAPDTRPAPGSTAPPAHGVTSAPDTRPAPGSTAPPAHGVTSAPESRPAPGSTAPAAHGVTSAPESRPAPGSTAPAAHGVTSAPESRPAPGSTAPPAHGVTSAPDTRPAPGSTAPPAHGVTSAPDTRPAPGSTAPPAHGVTSAPDTRPAPGSTAPPAHGVTSAPDTRPAPGSTAPPAHGVTSAPDTRPAPGSTAPPAHGVTSAPDTRPAPGSTAPPAHGVTSAPDTRPAPGSTAPPAHGVTSAPDTRPAPGSTAPAAHGVTSAPESRPAPGSTAPAAHGVTSAPESRPAPGSTAPPAHGVTSAPDTRPAPGSTAPPAHGVTSAPDTRPAPGSTAPPAHGVTSAPDTRPAPGSTAPPAHGVTSAPDTRPAPGSTAPPAHGVTSAPDTRPAPGSTAPPAHGVTSAPDTRPAPGSTAPPAHGVTSAPDTRPAPGSTPAPGSTAPPAHGVTSAPDTRPAPGSTAPPAHGVTSAPDNRPALGSTAPPVHNVTSASGSASGSASTLVHNGTSARATTTPASKSTPFSIPSHHSDTPTTLASHSTKTDASSTHHSTVPPLTSSNHSTSPQLSTGVSFFFLSFHISNLQFNSSLEDPSTDYYQELQRDISEMFLQIYKQGGFLGLSNIKFRPGSVVVQLTLAFREGTINVHDVETQFNQYKTEAASRYNLTISDVSVSDVPFPFSAQSGAGVPGWGIALLVLVCVLVALAIVYLIALAVCQCRRKNYGQLDIFPARDTYHPMSEYPTYHTHGRYVPPSSTDRSPYEKVSAGNGGSSLSYTNPAVAATSANL	PAPGSTAPAAHGVTSAPESR,PAPGSTAPPAHGVTSAPESR
MTPGTQSPFFLLLLLTVLTVVTGSGHASSTPGGEKETSATQRSSVPSSTEKNAVSMTSSVLSSHSPGSGSSTTQGQDVTLAPATEPASGSAATWGQDVTSVPVTRPALGSTTPPAHDVTSAPDNKPAPGSTAPPAHGVTSAPDTRPAPGSTAPQAHGVTSAPDTRPAPGSTAPPAHGVTSAPDTRPAPGSTAPPAHGVTSAPDTRPAPGSTAPAAHGVTSAPDTRPAPGSTAPQAHGVTSAPDTRPAPGSTAPPAHGVTSAPDTRPAPGSTAPPAHGVTSAPDTRPAPGSTAPPAHGVTSAPESRPAPGSTAPAAHGVTSAPESRPAPGSTAPAAHGVTSAPESRPAPGSTAPPAHGVTSAPDTRPAPGSTAPPAHGVTSAPDTRPAPGSTAPAAHGVTSAPDTRPAPGSTAPQAHGVTSAPDTRPAPGSTAPPAHGVTSAPDTRPAPGSTAPPAHGVTSAPDTRPAPGSTAPPAHGVTSAPESRPAPGSTAPAAHGVTSAPESRPAPGSTAPAAHGVTSAPESRPAPGSTAPPAHGVTSAPESRPAPGSTAPPAHGVTSAPESRPAPGSTAPPAHGVTSAPDTRPAPGSTAPPAHGVTSAPDTRPAPGSTAPPAHGVTSAPDTRPAPGSTAPPAHGVTSAPDTRPAPGSTAPPAHGVTSAPDTRPAPGSTAPPAHGVTSAPDTRPAPGSTAPPAHGVTSAPDTRPAPGSTPAPGSTAPPAHGVTSAPDTRPAPGSTAPPAHGVTSAPDNRPALGSTAPPVHNVTSASGSASGSASTLVHNGTSARATTTPASKSTPFSIPSHHSDTPTTLASHSTKTDASSTHHSTVPPLTSSNHSTSPQLSTGVSFFFLSFHISNLQFNSSLEDPSTDYYQELQRDISEMFLQIYKQGGFLGLSNIKFRPGSVVVQLTLAFREGTINVHDVETQFNQYKTEAASRYNLTISDVSVSDVPFPFSAQSGAGVPGWGIALLVLVCVLVALAIVYLIALAVCQCRRKNYGQLDIFPARDTYHPMSEYPTYHTHGRYVPPSSTDRSPYEKVSAGNGGSSLSYTNPAVAATSANL	PAPGSTAPAAHGVTSAPESR,PAPGSTAPPAHGVTSAPESR
SHSPGSGSSTTQGQDVTLAPATEPASGSAATWGQDVTSVPVTRPALGSTTPPAHDVTSAPDNKPAPGSTAPPAHGVTSAPDTRPAPGSTAPQAHGVTSAPDTRPAPGSTAPPAHGVTSAPDTRPAPGSTAPPAHGVTSAPDTRPAPGSTAPAAHGVTSAPDTRPAPGSTAPQAHGVTSAPDTRPAPGSTAPPAHGVTSAPDTRPAPGSTAPPAHGVTSAPDTRPAPGSTAPPAHGVTSAPESRPAPGSTAPAAHGVTSAPESRPAPGSTAPAAHGVTSAPESRPAPGSTAPPAHGVTSAPDTRPAPGSTAPPAHGVTSAPDTRPAPGSTAPAAHGVTSAPDTRPAPGSTAPQAHGVTSAPDTRPAPGSTAPPAHGVTSAPDTRPAPGSTAPPAHGVTSAPDTRPAPGSTAPPAHGVTSAPESRPAPGSTAPAAHGVTSAPESRPAPGSTAPAAHGVTSAPESRPAPGSTAPPAHGVTSAPDTRPAPGSTAPPAHGVTSAPDTRPAPGSTAPPAHGVTSAPDTRPAPGSTAPPAHGVTSAPDTRPAPGSTAPPAHGVTSAPESRPAPGSTAPAAHGVTSAPESRPAPGSTAPAAHGVTSAPESRPAPGSTAPPAHGVTSAPDTRPAPGSTAPPAHGVTSAPDTRPAPGSTAPPAHGVTSAPDTRPAPGSTAPPAHGVTSAPDTRPAPGSTAPPAHGVTSAPDTRPAPGSTAPPAHGVTSAPDTRPAPGSTAPPAHGVTSAPDTRPAPGSTAPPAHGVTSAPDTRPAPGSTAPPAHGVTSAPDTRPAPGSTPAPGSTAPPAHGVTSAPDTRPAPGSTAPPAHGVTSAPDNRPALGSTAPPVHNVTSASGSASGSASTLVHNGTSARATTTPASKSTPFSIPSHHSDTPTTLASHSTKTDASSTHHSTVPPLTSSNHSTSPQLSTGVSFFFLSFHISNLQFNSSLEDPSTDYYQELQRDISEMFLQIYKQGGFLGLSNIKFRPGSVVVQLTLAFREGTINVHDVETQFNQYKTEAASRYNLTISDVSVSDVPFPFSAQSGAGVPGWGIALLVLVCVLVALAIVYLIALAVCQCRRKNYGQLDIFPARDTYHPMSEYPTYHTHGRYVPPSSTDRSPYEKVSAGNGGSSLSYTNPAVAATSANL	PAPGSTAPAAHGVTSAPESR,PAPGSTAPPAHGVTSAPESR
MTPGTQSPFFLLLLLTVLTVVTGSGHASSTPGGEKETSATQRSSVPSSTEKNAVSMTSSVLSSHSPGSGSSTTQGQDVTLAPATEPASGSAATWGQDVTSVPVTRPALGSTTPPAHDVTSAPDNKPAPGSTAPPAHGVTSAPDTRPAPGSTAPQAHGVTSAPDTRPAPGSTAPPAHGVTSAPDTRPAPGSTAPPAHGVTSAPDTRPAPGSTAPAAHGVTSAPDTRPAPGSTAPQAHGVTSAPDTRPAPGSTAPPAHGVTSAPDTRPAPGSTAPPAHGVTSAPDTRPAPGSTAPPAHGVTSAPESRPAPGSTAPAAHGVTSAPESRPAPGSTAPAAHGVTSAPESRPAPGSTAPPAHGVTSAPDTRPAPGSTAPPAHGVTSAPDTRPAPGSTAPPAHGVTSAPDTRPAPGSTAPPAHGVTSAPDTRPAPGSTAPPAHGVTSAPDTRPAPGSTAPPAHGVTSAPESRPAPGSTAPAAHGVTSAPESRPAPGSTAPAAHGVTSAPDTRPAPGSTAPPAHGVTSAPDTRPAPGSTAPPAHGVTSAPDTRPAPGSTAPPSHGVTSAPDTRPAPGSTAPPAHGVTSAPESRPAPGSTAPAAHGVTSAPDTRPAPGSTAPAAHGVTSAPDTRPAPGSTAPPAHGVTSAPDTRPAPGSTAPPAHGVTSAPDTRPAPGSTAPAAHGVTSAPESRPAPGSTAPAAHGVTSAPESRPAPGSTAPPAHGVTSAPDTRPAPGSTAPPAHGVTSAPDTRPAPGSTAPPAHGVTSAPDTRPAPGSTAPPAHGVTSAPDTRPAPGSTAPPAHGVTSAPDTRPAPGSTAPPAHGVTSAPDTRPAPGSTAPPAHGVTSAPDTRPAPGSTAPPAHGVTSAPDTRPAPGSTAPPAHGVTSAPDTRPAPGSTAPPAHGVTSAPDTRRAPGSTPAPGSTAPPAHGVTSAPDTRPAPGSTAPPAHGVTSAPDNRPALGSTAPPVHNVTSASGSASGSASTLVHNGTSARATTTPASKSTPFSIPSHHSDTPTTLASHSTKTDASSTHHSTVPPLTSSNHSTSPQLSTGVSFFFLSFHISNLQFNSSLEDPSTDYYQELQRDISEMFLQIYKQGGFLGLSNIKFRPGSVVVQLTLAFREGTINVHDVETQFNQYKTEAASRYNLTISDVSVSDVPFPFSAQSGAGVPGWGIALLVLVCVLVALAIVYLIALAVCQCRRKNYGQLDIFPARDTYHPMSEYPTYHTHGRYVPPSSTDRSPYEKVSAGNGGSSLSYTNPAVAATSANL	PAPGSTAPAAHGVTSAPESR,PAPGSTAPPAHGVTSAPESR
MTPGTQSPFFLLLLLTVLTVVTGSGHASSTPGGEKETSATQRSSVPSSTEKNAVSMTSSVLSSHSPGSGSSTTQGQDVTLAPATEPASGSAATWGQDVTSVPVTRPALGSTTPPAHDVTSAPDNKPAPGSTAPPAHGVTLAPDTRPAPGSTAPQAHGVTSAPDTRPAPGSTAPPAHGVTSAPDTRPAPGSTAPPAHGVTSAPDTRPAPGSTAPAAHGVTSAPDTRPAPGSTAPQAHGVTSAPDTRPAPGSTAPPAHGVTSAPDTRPAPGSTAPPAHGVTSAPESRPAPGSTAPAAHGVTSAPESRPAPGSTAPAAHGVTSAPESRPAPGSTAPPAHGVTSAPDTRPAPGSTAPPAHGVTSAPDTRPAPGSTAPAAHGVTSAPDTRPAPGSTAPQAHGVTSAPDTRPAPGSTAPPAHGVTSAPDTRPALGSTAPPAHGVTSALDTRPAPGSTAPPAHGVTSAPESRPAPGSTAPAAHGVTSAPESRPAPGSTAPAAHGVTSAPDTRPAPGSTAPPAHGVTSAPDTRPAPGSTAPPAHGVTSAPDTRPAPGSTAPPTHGVTSAPDTRPAPGSTAPPAHGVTSAPDTRPAPGSTAPAAHGVTSAPDTRPAPGSTAPQAHGVTSAPDTRPAPGSTAPPAHGVTSAPDTRPAPGSTAPPAHGVTSAPESRPAPGSTAPAAHGVTSAPESRPAPGSTAPAAHGVTSAPESRPAPGSTAPPAHGVTSAPDTRPAPGSTAPPAHGVTSAPDTRPAPGSTAPPAHGVTSAPDTRPAPGSTAPPAHGVTSAPDTRPAPGSTAPPAHGVTSAPDTRPAPGSTAPPAHGVTSAPDTRPAPGSTAPPAHGVTSAPDTRPAPGSTAPPAHGVTSAPDTRPAPGSTAPPAHGVTSAPDTRPAPGSTAPPAHGVTSAPDTRPAPGSTPAPGSTAPPAHGVTSAPDTRPAPGSTAPPAHGVTSAPDNRPALGSTAPPVHNVTSASGSASGSASTLVHNGTSARATTTPASKSTPFSIPSHHSDTPTTLASHSTKTDASSTHHSTVPPLTSSNHSTSPQLSTGVSFFFLSFHISNLQFNSSLEDPSTDYYQELQRDISEMFLQIYKQGGFLGLSNIKFRPGSVVVQLTLAFREGTINVHDVETQFNQYKTEAASRYNLTISDVSVSDVPFPFSAQSGAGVPGWGIALLVLVCVLVALAIVYLIALAVCQCRRKNYGQLDIFPARDTYHPMSEYPTYHTHGRYVPPSSTDRSPYEKVSAGNGGSSLSYTNPAVAATSANL	PAPGSTAPAAHGVTSAPESR,PAPGSTAPPAHGVTSAPESR
MTPGTQSPFFLLLLLTVLTVVTGSGHASSTPGGEKETSATQRSSVPSSTEKNAVSMTSSVLSSHSPGSGSSTTQGQDVTLAPATEPASGSAATWGQDVTSVPVTRPALGSTTPPAHDVTSAPDNKPAPGSTAPPAHGVTSAPDTRPAPGSTAPQAHGVTSAPDTRPAPGSTAPPAHGVTSAPDTRPAPGSTAPPAHGVTSAPDTRPAPGSTAPAAHGVTSAPDTRPAPGSTAPQAHGVTSAPDTRPAPGSTAPTAHGVTSAPDTRPAPGSTAPPAHGVTSAPDTRPAPGSTAPPAHGVTSAPESRPAPGSTAPAAHGVTSAPESRPAPGSTAPPAHGVTSAPDTRPAPGSTAPPAHGVTSAPDTRPAPGSTAPAAHGVTSAPDTRPAPGSTAPQAHGVTSAPDTRPAPGSTAPPAHGVTSAPDTRPAPGSTAPPAHGVTSAPDTRPAPGSTAPPAHGVTSAPDTRPAPGSTAPPAHGVTSAPDTRPAPGSTAPPAHGVTSAPDTRPAPGSTAPPAHGVTSAPDTRPAPGSTAPPAHGVTSAPDTRPAPGSTAPPAHGVTSAPDTRPAPGSTAPPAHGVTSAPDTRPAPGSTAPAAHGVTSAPESRPAPGSTAPAAHGVTSAPESRPAPGSTAPPAHGVTSAPDTRPAPGSTAPPAHGVTSAPDTRPAPGSTAPPAHGVTSAPDTRPAPGSTAPAAHGVTSAPESRPAPGSTAPPAHGVTSAPDTRPAPGSTAPPAHGVTSAPDTRPAPGSTAPPAHGVTSAPDTRPAPGSTAPPAHGVTSAPDTRPAPGSTAPPAHGVTSAPDTRPAPGSTAPPAHGVTSAPDTRPAPGSTAPPAHGVTSAPDTRPAPGSTPAPGSTAPPAHGVTSAPDTRPAPGSTAPPAHGVTSAPDNRPALGSTAPPVHNVTSASGSASGSASTLVHNGTSARATTTPASKSTPFSIPSHHSDTPTTLASHSTKTDASSTHHSTVPPLTSSNHSTSPQLSTGVSFFFLSFHISNLQFNSTLEDPSTDYYQELQRDISEMFLQIYKQGGFLGLSNIKFRPGSVVVQLTLAFREGTINVHDVETQFNQYKTEAASRYNLTISDVSVSDVPFPFSAQSGAGVPGWGIALLVLVCVLVALAIVYLIALAVCQCRRKNYGQLDIFPARDTYHPMSEYPTYHTHGRYVPPSSTDRSPYEKVSAGNGGSSLSYTNPAVAATSANL	PAPGSTAPAAHGVTSAPESR,PAPGSTAPPAHGVTSAPESR
MTPGTQSPFFLLLLLTVLTVVTGSGHASSTPGGEKETSATQRSSVPSSTEKNAVSMTSSVLSSHSPGSGSSTTQGQDVTLAPATEPASGSAATWGQDVTSVPVTRPALGSTTPPAHDVTSAPDNKPAPGSTAPPAHGVTSAPDTRPAPGSTAPQAHGVTSAPDTRPAPGSTAPPAHGVTSAPDTRPAPGSTAPPAHGVTSAPDTRPAPGSTAPAAHGVTSAPDTRPAPGSTAPQAHGVTSAPDTRPAPGSTAPPAHGVTSAPDTRPAPGSTAPPAHGVTSAPDTRPAPGSTAPPAHGVTSAPDTRPAPGSTAPPAHGVTSAPDTRPAPGSTAPPAHGVTSAPDTRPAPGSTAPPAHGVTSAPESRPAPGSTAPPAHGVTSAPESRPAPGSTAPPAHGVTSAPDTRPAPGSTAPPAHGVTSAPDTRPAPGSTAPPAHGVTSAPESRPAPGSTAPAAHGVTSAPESRPAPGSTAPAAHGVTSAPESRPAPGSTAPPAHGVTSAPDTRPAPGSTAPPAHGVTSAPDTRPAPGSTAPPAHGVTSAPDTRPAPGSTAPPAHGVTSAPESRPAPGSTAPPAHGVTSAPESRPAPGSTAPAAHGVTSAPESRPAPGSTAPAAHGVTSAPDTRPAPGSTAPPAHGVTSAPDTRPAPGSTAPPAHGVTSAPDTRPAPGSTAPPAHGVTSAPDTRPAPGSTAPAAHGVTSAPESRPAPGSTAPAAHGVTSAPESRPAPGSTAPPAHGVTSAPDTRPAPGSTAPPAHGVTSAPDTRPAPGSTAPPAHGVTSAPDTRPAPGSTAPPAHGVTSAPDTRPAPGSTAPPAHGVTSAPDTRPAPGSTAPPAHGVTSAPDTRPAPGSTAPPAHGVTSAPDTRPAPGSTAPPAHGVTSAPDTRPAPGSTAPPAHGVTSAPDTRRAPGSTPAPGSTAPPAHGVTSAPDTRPAPGSTAPPAHGVTSAPDNRPALGSTAPPVHNVTSASGSASGSASTLVHNGTSARATTTPASKSTPFSIPSHHSDTPTTLASHSTKTDASSTHHSTVPPLTSSNHSTSPQLSTGVSFFFLSFHISNLQFNSSLEDPSTDYYQELQRDISEMFLQIYKQGGFLGLSNIKFRPGSVVVQLTLAFREGTINVHDVETQFNQYKTEAASRYNLTISDVSVSDVPFPFSAQSGAGVPGWGIALLVLVCVLVALAIVYLIALAVCQCRRKNYGQLDIFPARDTYHPMSEYPTYHTHGRYVPPSSTDRSPYEKVSAGNGGSSLSYTNPAVAATSANL	PAPGSTAPAAHGVTSAPESR,PAPGSTAPPAHGVTSAPESR
MTPGTQSPFFLLLLLTVLTVVTGSGHASSTPGGEKETSATQRSSVPSSTEKNAVSMTSSVLSSHSPGSGSSTTQGQDVTLAPATEPASGSAATWGQDVTSVPVTRPALGSTTPPAHDVTSAPDNKPAPGSTAPPAHGVTSAPDTRPAPGSTAPQAHGVTSAPDTRPAPGSTAPPAHGVTSAPDTRPAPGSTAPPAHGVTSAPDTRPAPGSTAPAAHGVTSAPDTRPAPGSTAPQAHGVTSAPDTRPAPGSTAPPAHGVTSAPDTRPAPGSTAPPAHGVTSAPDTRPAPGSTAPPAHGVTSAPESRPAPGSTAPAAHGVTSAPESRPAPGSTAPAAHGVTSAPESRPAPGSTAPPAHGVTSAPDTRPAPGSTAPPAHGVTSAPDTRPAPGSTAPPAHGVTSAPDTRPAPGSTAPPAHGVTSAPDTRPAPGSTAPPAHGVTSAPDTRPAPGSTAPPAHGVTSAPESRPAPGSTAPAAHGVTSAPDTRPAPGSTAPPAHGVTSAPDTRPAPGSTAPPAHGVTSAPDTRPAPGSTAPPAHGVTSAPDTRPAPGSTAPPAHGVTSAPDTRPAPGSTAPPAHGVTSAPDTRPAPGSTAPPAHGVTSAPDTRPAPGSTAPPAHGVTSAPDTRPAPGSTAPPAHGVTSAPDTRPAPGSTAPPAHGVTSAPESRPAPGSTAPAAHGVTSAPESRPAPGSTAPAAHGVTSAPESRPAPGSTAPPAHGVTSAPDTRPAPGSTAPPAHGVTSAPDTRPAPGSTAPPAHGVTSAPDTRPAPGSTAPPAHGVTSAPDTRPAPGSTAPPAHGVTSAPDTRPPAPGSTAPPAHGVTSAPDTRPAPGSTAPPAHGVTSAPDTRPAPGSTAPPAHGVTSAPDTRPAPGSTAPPAHGVTSAPDTRPAPGSTAPPAHGVTSAPDTRRAPGSTPAPGSTAPPAHGVTSAPDTRPAPGSTAPPAHGVTSAPDNRPALGSTAPPVHNVTSASGSASGSASTLVHNGTSARATTTPASKSTPFSIPSHHSDTPTTLASHSTKTDASSTHHSTVPPLTSSNHSTSPQLSTGVSFFFLSFHISNLQFNSSLEDPSTDYYQELQRDISEMFLQIYKQGGFLGLSNIKFRPGSVVVQLTLAFREGTINVHDVETQFNQYKTEAASRYNLTISDVSVSDVPFPFSAQSGAGVPGWGIALLVLVCVLVALAIVYLIALAVCQCRRKNYGQLDIFPARDTYHPMSEYPTYHTHGRYVPPSSTDRSPYEKVSAGNGGSSLSYTNPAVAATSANL	PAPGSTAPAAHGVTSAPESR,PAPGSTAPPAHGVTSAPESR
MTPGTQSPFFLLLLLTVLTVVTGSGHASSTPGGEKETSATQRSSVPSSTEKNAVSMTSSVLSSHSPGSGSSTTQGQDVTLAPATEPASGSAATWGQDVTSVPVTRPALGSTTPPAHDVTSAPDNKPAPGSTAPPAHGVTSAPDTRPAPGSTAPQAHGVTSAPDTRPAPGSTAPPAHGVTSAPDTRPAPGSTAPPAHGVTSAPDTRPAPGSTAPAAHGVTSAPDTRPAPGSTAPQAHGVTSAPDTRPAPGSTAPPAHGVTSAPDTRPAPGSTAPPAHGVTSAPDTRPAPGSTAPPAHGVTSAPDTRPAPGSTAPPAHGVTSAPDTRPAPGSTAPPAHGVTSAPDTRPAPGSTAPPAHGVTSAPESRPAPGSTAPAAHGVTSAPESRPAPGSTAPAAHGVTSAPDTRPAPGSTAPPAHGVTSAPDTRPAPGSTAPPAHGVTSAPESRPAPGSTAPAAHGVTSAPESRPAPGSTAPAAHGVTSAPDTRPAPGSTAPPAHGVTSAPDTRPAPGSTAPPAHGVTSAPDTRPAPGSTAPPAHGVTSAPDTRPAPGSTAPPAHGVTSAPDTRPAPGSTAPPAHGVTSAPDTRPAPGSTAPPAHGVTSAPDTRPAPGSTAPPAHGVTSAPDTRPAPGSTAPPAHGVTSAPDTRPAPGSTAPPAHGVTSAPDTRPAPGSTAPPAHGVTSAPDTRPAPGSTAPPAHGVTSAPDTRPAPGSTAPAAHGVTSAPESRPAPGSTAPAAHGVTSAPESRPAPGSTAPPAHGVTSAPDTRPAPGSTAPPAHGVTSAPDTRPAPGSTAPPAHGVTSAPDTRPAPGSTAPPAHGVTSAPDTRPAPGSTAPPAHGVTSAPDTRPAPGSTAPPAHGVTSAPDTRPAPGSTAPPAHGVTSAPDTRPAPGSTAPPAHGVTSAPDTRRAPGSTPAPGSTAPPAHGVTSAPDTRPAPGSTAPPAHGVTSAPDNRPALGSTAPPVHNVTSASGSASGSASTLVHNGTSARATTTPASKSTPFSIPSHHSDTPTTLASHSTKTDASSTHHSTVPPLTSSNHSTSPQLSTGVSFFFLSFHISNLQFNSSLEDPSTDYYQELQRDISEMFLQIYKQGGFLGLSNIKFRPGSVVVQLTLAFREGTINVHDVETQFNQYKTEAASRYNLTISDVSVSDVPFPFSAQSGAGVPGWGIALLVLVCVLVALAIVYLIALAVCQCRRKNYGQLDIFPARDTYHPMSEYPTYHTHGRYVPPSSTDRSPYEKVSAGNGGSSLSYTNPAVAATSANL	PAPGSTAPAAHGVTSAPESR,PAPGSTAPPAHGVTSAPESR
MTPGTQSPFFLLLLLTVLTVVTGSGHASSTPGGEKETSATQRSSVPSSTEKNAVSMTSSVLSSHSPGSGSSTTQGQDVTLAPATEPASGSAATWGQDVTSVPVTRPALGSTTPPAHDVTSAPDNKPAPGSTAPPAHGVTSAPDTRPAPGSTAPQAHGVTSAPDTRPAPGSTAPPAHGVTSAPDTRPAPGSTAPPAHGVTSAPDTRPAPGSTAPAAHGVTSAPDTRPAPGSTAPQAHGVTSAPDTRPAPGSTAPPAHGVTSAPDTRPAPGSTAPPAHGVTSAPDTRPAPGSTAPPAHGVTSAPDTRPAPGSTAPPAHGVTSAPDTRPAPGSTAPPAHGVTSAPDTRPAPGSTAPPAHGVTSAPESRPAPGSTAPAAHGVTSAPESRPAPGSTAPAAHGVTSAPDTRPAPGSTAPPAHGVTSAPDTRPAPGSTAPPAHGVTSAPDTRPAPGSTAPPAHGVTSAPDTRPAPGSTAPPAHGVTSAPDTRPAPGSTAPPAHGVTSAPDTRPAPGSTAPPAHGVTSAPDTRPAPGSTAPPAHGVTSAPDTRPAPGSTAPPAHGVTSAPESRPAPGSTAPAAHGVTSAPDTRPAPGSTAPPAHGVTSAPDTRPAPGSTAPPAHGVTSAPDTRPAPGSTAPPAHGVTSAPDTRPAPGSTAPPAHGVTSAPDTRPAPGSTAPPAHGVTSAPDTRPAPGSTAPAAHGVTSAPESRPAPGSTAPAAHGVTSAPESRPAPGSTAPPAHGVTSAPDTRPAPGSTAPPAHGVTSAPDTRPAPGSTAPPAHGVTSAPDTRPAPGSTAPPAHGVTSAPDTRPAPGSTAPPAHGVTSAPDTRPAPGSTAPPAHGVTSAPDTRPAPGSTAPPAHGVTSAPDTRPAPGSTAPPAHGVTSAPDTRPAPGSTAPPAHGVTSAPDTRRAPGSTRAPGSTAPPAHGVTSAPDTRPAPGSTAPPAHGVTSAPDNRPALGSTAPPVHNVTSASGSASGSASTLVHNGTSARATTTPASKSTPFSIPSHHSDTPTTLASHSTKTDASSTHHSTVPPLTSSNHSTSPQLSTGVSFFFLSFHISNLQFNSSLEDPSTDYYQELQRDISEMFLQIYKQGGFLGLSNIKFRPGSVVVQLTLAFREGTINVHDVETQFNQYKTEAASRYNLTISDVSVSDVPFPFSAQSGAGVPGWGIALLVLVCVLVALAIVYLIALAVCQCRRKNYGQLDIFPARDTYHPMSEYPTYHTHGRYVPPSSTDRSPYEKVSAGNGGSSLSYTNPAVAATSANL	PAPGSTAPAAHGVTSAPESR,PAPGSTAPPAHGVTSAPESR
PGSGSSTTQGQDVTLAPATEPASGSAATWGQDVTSVPVTRPALGSTTPPAHDVTSAPDNKPAPGSTAPPAHGVTSAPDTRPAPGSTAPQAHGVTSAPDTRPAPGSTAPPAHGVTSAPDTRPAPGSTAPPAHGVTSAPDTRPAPGSTAPAAHGVTSAPDTRPAPGSTAPQAHGVTSAPDTRPAPGSTAPPAHGVTSAPDTRPAPGSTAPPAHGVTSAPDTRPAPGSTAPPAHGVTSAPESRPAPGSTAPAAHGVTSAPESRPAPGSTAPAAHGVTSAPESRPAPGSTAPPAHGVTSAPDTRPAPGSTAPPAHGVTSAPDTRPAPGSTAPAAHGVTSAPDTRPAPGSTAPPAHGVTSAPDTRPAPGSTAPPAHGVTSAPDTRPAPGSTAPPAHGVTSAPDTRPAPGSTAPPAHGVTSAPESRPAPGSTAPAAHGVTSAPESRPAPGSTAPAAHGVTSAPESRPAPGSTAPPAHGVTSAPESRPAPGSTAPPAHGVTSAPDTRPAPGSTAPPAHGVTSAPDTRPAPGSTAPPAHGVTSAPDTRPAPGSTAPPAHGVTSAPDTRPAPGSTAPPAHGVTSAPDTRPAPGSTAPPAHGVTSAPDTRPAPGSTAPPAHGVTSAPESRPAPGSTAPAAHGVTSAPESRPAPGSTAPAAHGVTSAPESRPAPGSTAPPAHGVTSAPDTRPAPGSTAPPAHGVTSAPDTRPAPGSTAPPAHGVTSAPDTRPAPGSTAPPAHGVTSAPDTRPAPGSTAPPAHGVTSAPDTRPAPGSTAPPAHGVTSAPDTRPAPGSTAPPAHGVTSAPDTRPAPGSTPAPGSTAPPAHGVTSAPDTRPAPGSTAPPAHGVTSAPDNRPALGSTAPPVHNVTSASGSASGSASTLVHNGTSARATTTPASKSTPFSIPSHHSDTPTTLASHSTKTDASSTHHSTVPPLTSSNHSTSPQLSTGVSFFFLSFHISNLQFNSSLEDPSTDYYQELQRDISEMFLQIYKQGGFLGLSNIKFRPGSVVVQLTLAFREGTINVHDVETQFNQYKTEAASRYNLTISDVSVSDVPFPFSAQSGAGVPGWGIALLVLVCVLVALAIVYLIALAVCQCRRKNYGQLDIFPARDTYHPMSEYPTYHTHGRYVPPSSTDRSPYEKVSAGNGGSSLSYTNPAVAATSANL	PAPGSTAPAAHGVTSAPESR,PAPGSTAPPAHGVTSAPESR
MTPGTQSPFFLLLLLTVLTVVTGSGHASSTPGGEKETSATQRSSVPSSTEKNAVSMTSSVLSSHSPGSGSSTTQGQDVTLAPATEPASGSAATWGQDVTSVPVTRPALGSTTPPAHDVTSAPDNKPAPGSTAPPAHGVTSAPDTRPAPGSTAPQAHGVTSAPDTRPAPGSTAPPAHGVTSAPDTRPAPGSTAPPAHGVTSAPDTRPAPGSTAPAAHGVTSAPDTRPAPGSTAPQAHGVTSAPDTRPAPGSTAPPAHGVTSAPDTRPAPGSTAPPAHGVTSAPDTRPAPGSTAPPAHGVTSAPESRPAPGSTAPAAHGVTSAPESRPAPGSTAPPAHGVTSAPDTRPAPGSTAPPAHGVTSAPTRPAPGSTAPPAHGVTSAPDTRPAPGSTAPPAHGVTSAPDTRPAPGSTAPPAHGVTSAPESRPAPGSTAPPAHGVTSAPESRPAPGSTAPPAHGVTSAPDTRPAPGSTAPPAHGVTSAPDTRPAPGSTAPPAHGVTSAPDTRPAPGSTAPPAHGVTSAPDTRPAPGSTAPAAHGVTSAPESRPAPGSTAPAAHGVTSAPESRPAPGSTAPPAHGVTSAPDTRPAPGSTAPPAHGVTSAPDTRPAPGSTAPPAHGVTSAPDTRPAPGSTAPPAHGVTSAPDTRPAPGSTAPPAHGVTSAPDTRPAPGSTAPPAHGVTSAPDTRPAPGSTAPPAHGVTSAPDTRPAPGSTAPPAHGVTSAPDTRPAPGSTAPPAHGVTSAPDTRRAPGSTPAPGSTAPPAHGVTSAPDTRPAPGSTAPPAHGVTSAPDNRPALGSTAPPVHNVTSASGSASGSASTLVHNGTSARATTTPASKSTPFSIPSHHSDTPTTLASHSTKTDASSTHHSTVPPLTSSNHSTSPQLSTGVSFFFLSFHISNLQFNSSLEDPSTDYYQELQRDISEMFLQIYKQGGFLGLSNIKFRPGSVVVQLTLAFREGTINVHDVETQFNQYKTEAASRYNLTISDVSVSDVPFPFSAQSGAGVPGWGIALLVLVCVLVALAIVYLIALAVCQCRRKNYGQLDIFPARDTYHPMSEYPTYHTHGRYVPPSSTDRSPYEKVSAGNGGSSLSYTNPAVAATSANL	PAPGSTAPAAHGVTSAPESR,PAPGSTAPPAHGVTSAPESR
MTPGTQSPFFLLLLLTVLTVVTGSGHASSTPGGEKETSATQRSSVPSSTEKNAVSMTSSVLSSHSPGSGSSTTQGQDVTLAPATEPASGSAATWGQDVTSVPVTRPALGSTTPPAHDVTSAPDNKPAPGSTAPPAHGVTSAPDTRPAPGSTAPQAHGVTSAPDTRPAPGSTAPPAHGVTSAPDTRPAPGSTAPPAHGVTSAPDTRPAPGSTAPAAHGVTSAPDTRPAPGSTAPQAHGVTSAPDTRPAPGSTAPPAHGVTSAPDTRPAPGSTAPPAHGVTSAPDTRPAPGSTAPPAHGVTSAPESRPAPGSTAPAAHGVTSAPESRPAPGSTAPAAHGVTSAPESRPAPGSTAPPAHGVTSAPDTRPAPGSTAPPAHGVTSAPDTRPAPGSTAPPAHGVTSAPDTRPAPGSTAPPAHGVTSAPDTRPAPGSTAPPAHGVTSAPDTRPAPGSTAPPAHGVTSAPESRPAPGSTAPAAHGVTSAPDTRPAPGSTAPPAHGVTSAPDTRPAPGSTAPPAHGVTSAPDTRPAPGSTAPPAHGVTSAPDTRPAPGSTAPPAHGVTSAPDTRPAPGSTAPPAHGVTSAPDTRPAPGSTAPPAHGVTSAPDTRPAPGSTAPPAHGVTSAPDTRPAPGSTAPPAHGVTSAPDTRPAPGSTAPPAHGVTSAPESRPAPGSTAPPAHGVTSAPDTRPAPGSTAPAAHGVTSAPESRPAPGSTAPAAHGVTSAPESRPAPGSTAPPAHGVTSAPDTRPAPGSTAPPAHGVTSAPDTRPAPGSTAPPAHGVTSAPDTRPAPGSTAPPAHGVTSAPDTRPAPGSTAPPAHGVTSAPDTRPAPGSTAPPAHGVTSAPDTRPAPGSTAPPAHGVTSAPDTRPAPGSTAPPAHGVTSAPDTRPAPGSTAPPAHGVTSAPDTRRAPGSTPAPGSTAPPAHGVTSAPDTRPAPGSTAPPAHGVTSAPDNRPALGSTAPPVHNVTSASGSASGSASTLVHNGTSARATTTPASKSTPFSIPSHHSDTPTTLASHSTKTDASSTHHSTVPPLTSSNHSTSPQLSTGVSFFFLSFHISNLQFNSSLEDPSTDYYQELQRDISEMFLQIYKQGGFLGLSNIKFRPGSVVVQLTLAFREGTINVHDVETQFNQYKTEAASRYNLTISDVSVSDVPFPFSAQSGAGVPGWGIALLVLVCVLVALAIVYLIALAVCQCRRKNYGQLDIFPARDTYHPMSEYPTYHTHGRYVPPSSTDRSPYEKVSAGNGGSSLSYTNPAVAATSANL	PAPGSTAPAAHGVTSAPESR,PAPGSTAPPAHGVTSAPESR
MTPGTQSPFFLLLLLTVLTVVTGSGHASSTPGGEKETSATQRSSVPSSTEKNAVSMTSSVLSSHSPGSGSSTTQGQDVTLAPATEPASGSAATWGQDVTSVPVTRPALGSTTPPAHDVTSAPDNKPAPGSTAPPAHGVTSAPDTRPAPGSTAPQAHGVTSAPDTRPAPGSTAPPAHGVTSAPDTRPAPGSTAPPAHGVTSAPDTRPAPGSTAPAAHGVTSAPDTRPAPGSTAPQAHGVTSAPDTRPAPGSTAPTAHGVTSAPDTRPAPGSTAPPAHGVTSAPDTRPAPGSTAPPAHGVTSAPESRPAPGSTAPAAHGVTSAPESRPAPGSTAPPAHGVTSAPDTRPAPGSTAPPAHGVTSAPDTRPAPGSTAPAAHGVTSAPDTRPAPGSTAPQAHGVTSAPDTRPAPGSTAPPAHGVTSAPDTRPAPGSTAPPAHGVTSAPDTRPAPGSTAPPAHGVTSAPDTRPAPGSTAPPAHGVTSAPDTRPAPGSTAPPAHGVTSAPDTRPAPGSTAPPAHGVTSAPDTRPAPGSTAPPAHGVTSAPDTRPAPGSTAPPAHGVTSAPDTRPAPGSTAPPAHGVTSAPDTRPAPGSTAPAAHGVTSAPESRPAPGSTAPAAHGVTSAPESRPAPGSTAPPAHGVTSAPDTRPAPGSTAPPAHGVTSAPDTRPAPGSTAPPAHGVTSAPDTRPAPGSTAPPAHGVTSAPDTRPAPGSTAPPAHGVTSAPDTRPAPGSTAPPAHGVTSAPDTRPAPGSTAPPAHGVTSAPDTRPAPGSTAPPAHGVTSAPDTRPAPGSTPAPGSTAPPAHGVTSAPDTRPAPGSTAPPAHGVTSAPDNRPALGSTAPPVHNVTSASGSASGSASTLVHNGTSARATTTPASKSTPFSIPSHHSDTPTTLASHSTKTDASSTHHSTVPPLTSSNHSTSPQLSTGVSFFFLSFHISNLQFNSSLEDPSTDYYQELQRDISEMFLQIYKQGGFLGLSNIKFRPGSVVVQLTLAFREGTINVHDVETQFNQYKTEAASRYNLTISDVSVSDVPFPFSAQSGAGVPGWGIALLVLVCVLVALAIVYLIALAVCQCRRKNYGQLDIFPARDTYHPMSEYPTYHTHGRYVPPSSTDRSPYEKVSAGNGGSSLSYTNPAVAATSANL	PAPGSTAPAAHGVTSAPESR,PAPGSTAPPAHGVTSAPESR
MTPGTQSPFFLLLLLTVLTVVTGSGHASSTPGGEKETSATQRSSVPSSTEKNAVSMTSSVLSSHSPGSGSSTTQGQDVTLAPATEPASGSAATWGQDVTSVPVTRPALGSTTPPAHDVTSAPDNKPAPGSTAPPAHGVTSAPDTRPAPGSTAPQAHGVTSAPDTRPAPGSTAPPAHGVTSAPDTRPAPGSTAPPAHGVTSAPDTRPAPGSTAPAAHGVTSAPDTRPAPGSTAPQAHGVTSAPDTRPAPGSTAPPAHGVTSAPDTRPAPGSTAPPAHGVTSAPDTRPAPGSTAPPAHGVTSAPDTRPAPGSTAPPAHGVTSAPDTRPAPGSTAPPAHGVTSAPDTRPAPGSTAPPAHGVTSAPESRPAPGSTAPAAHGVTSAPESRPAPGSTAPAAHGVTSAPDTRPAPGSTAPPAHGVTSAPDTRPAPGSTAPPAHGVTSAPDTRPAPGSTAPPAHGVTSAPDTRPAPGSTAPAAHGVTSAPDTRPAPGSTAPPAHGVTSAPDTRPAPGSTAPPAHGVTSAPDTRPAPGSTAPPAHGVTSAPDTRPAPGSTAPPAHGVTSAPDTRPAPGSTAPPAHGVTSAPESRPAPGSTAPPAHGVTSAPESRPAPGSTAPPAHGVTSAPDTRPAPGSTAPPAHGVTSAPDTRPAPGSTAPPAHGVTSAPESRPAPGSTAPAAHGVTSAPESRPAPGSTAPAAHGVTSAPESRPAPGSTAPPAHGVTSAPDTRPAPGSTAPPAHGVTSAPDTRPAPGSTAPPAHGVTSAPDTRPAPGSTAPPAHGVTSAPDTRPAPGSTAPPAHGVTSAPDTRPAPGSTAPPAHGVTSAPDTRPAPGSTAPPAHGVTSAPDTRPAPGSTAPPAHGVTSAPDTRPAPGSTAPPAHGVTSAPDTRPAPGSTAPPAHGVTSAPDTRRAPGSTRAPGSTAPPAHGVTSAPDTRPAPGSTAPPAHGVTSAPDNRPALGSTAPPVHNVTSASGSASGSASTLVHNGTSARATTTPASKSTPFSIPSHHSDTPTTLASHSTKTDASSTHHSTVPPLTSSNHSTSPQLSTGVSFFFLSFHISNLQFNSSLEDPSTDYYQELQRDISEMFLQIYKQGGFLGLSNIKFRPGSVVVQLTLAFREGTINVHDVETQFNQYKTEAASRYNLTISDVSVSDVPFPFSAQSGAGVPGWGIALLVLVCVLVALAIVYLIALAVCQCRRKNYGQLDIFPARDTYHPMSEYPTYHTHGRYVPPSSTDRSPYEKVSAGNGGSSLSYTNPAVAATSANL	PAPGSTAPAAHGVTSAPESR,PAPGSTAPPAHGVTSAPESR
MTPGTQSPFFLLLLLTVLTVVTGSGHASSTPGGEKETSATQRSSVPSSTEKNAVSMTSSVLSSHSPGSGSSTTQGQDVTLAPATEPASGSAATWGQDVTSVPVTRPALGSTTPPAHDVTSAPDNKPAPGSTAPPAHGVTSAPDTRPAPGSTAPQAHGVTSAPDTRPAPGSTAPPAHGVTSAPDTRPAPGSTAPPAHGVTSAPDTRPAPGSTAPAAHGVTSAPDTRPAPGSTAPQAHGVTSAPDTRPAPGSTAPTAHGVTSAPDTRPAPGSTAPPAHGVTSAPDTRPAPGSTAPPAHGVTSAPESRPAPGSTAPAAHGVTSAPESRPAPGSTAPPAHGVTSAPDTRPAPGSTAPPAHGVTSAPDTRPAPGSTAPAAHGVTSAPDTRPAPGSTAPQAHGVTSAPDTRPAPGSTAPPAHGVTSAPDTRPAPGSTAPPAHGVTSAPDTRPAPGSTAPPAHGVTSAPESRPAPGSTAPAAHGVTSAPESRPAPGSTAPAAHGVTSAPESRPAPGSTAPPAHGVTSAPDTRPAPGSTAPPAHGVTSAPDTRPAPGSTAPPTHGVTSAPDTRPAPGSTAPPAHGVTSAPDTRPAPGSTAPPAHGVTSAPDTRPAPGSTAPPAHGVTSAPDTRPAPGSTAPPAHGVTSAPDTRPAPGSTAPAAHGVTSAPESRPAPGSTAPAAHGVTSAPESRPAPGSTAPPAHGVTSAPDTRPAPGSTAPPAHGVTSAPDTRPAPGSTAPPAHGVTSAPDTRPAPGSTAPPAHGVTSAPDTRPAPGSTAPPSPRCHLGPGHQAGPGLHRPPQPTVSPRPRTPGRPRAPPPPQPTVSPRPRTPGRPRAPPHPQPTVSPRPRTPGRPRAPPRPRAPPPPQPTVSPRPRTPGRPRAPPPPQPMVSPRPRTTGPPWAPPPLQSTMSPRPQALHQAQLLLWCTTAPLPGLPQPQPARALHSQFPATTLILLPPLPAIAPRLMPVALTIARYLLSPPPITALLPSCLLGSLSFSCLFTFQTSSLIPLWKIPAPTTTKSCRETFLKCFCRFINKGVFWASPILSSGQDLWWYNLWPSEKVPSMSTTWRHSSISIKRKQPLDITRSQTSAVMCHFLSLPSLGLGCQAGASRCWCWSVFWLRWPLSISLPWLSVSAAERTTGSWTSFQPGIPTILASTPPTTPMGAMCPLAVPIVAPMRRFLQVMVAAASLTQTQQWQPLLPTC	PAPGSTAPAAHGVTSAPESR,PAPGSTAPPAHGVTSAPESR
MTPGTQSPFFLLLLLTVLTVVTGSGHASSTPGGEKETSATQRSSVPSSTEKNAVSMTSSVLSSHSPGSGSSTTQGQDVTLAPATEPASGSAATWGQDVTSVPVTRPALGSTTPPAHDVTSAPDNKPAPGSTAPPAHGVTSAPDTRPAPGSTAPQAHGVTSAPDTRPAPGSTAPPAHGVTSAPDTRPAPGSTAPPAHGVTSAPDTRPAPGSTAPAAHGVTSAPDTRPAPGSTAPQAHGVTSAPDTRPAPGSTAPPAHGVTSAPDTRPAPGSTAPPAHGVTSAPDTRPAPGSTAPPAHGVTSAPESRPAPGSTAPHAHGVTSAPESRPAPGSTAPPAHGVTSAPDTRPAPGSTAPPAHGVTSAPDTRPAPGSTAPAAHGVTSAPDTRPAPGSTAPPAHGVTSAPDTRPAPGSTAPPAHGVTSAPDTRPAPGSTAPPAHGVTSAPDTRPAPGSTAPPAHGVTSAPESRPAPGSTAPAAHGVTSAPESRPAPGSTAPAAHGVTSAPESRPAPGSTAPPAHGVTSAPESRPAPGSTAPPAHGVTSAPDTRPAPGSTAPPAHGVTSAPDTRPAPGSTAPPAHGVTSAPDTRPAPGSTAPPAHGVTSAPDTRPAPGSTAPPAHGVTSAPDTRPAPGSTAPPAHGVTSAPDTRPAPGSTAPPAHGVTSAPESRPAPGSTAPAAHGVTSAPESRPAPGSTAPAAHGVTSAPESRPAPGSTAPPAHGVTSAPDTRPAPGSTAPPAHGVTSAPDTRPAPGSTAPPAHGVTSAPDTRPAPGSTAPPAHGVTSAPDTRPAPGSTAPPAHGVTSAPDTRPAPGSTAPPAHGVTSAPDTRPAPGSTAPPAHGVTSAPDTRPAPGSTPAPGSTAPPAHGVTSAPDTRPAPGSTAPPAHGVTSAPDNRPALGSTAPPVHNVTSASGSASGSASTLVHNGTSARATTTPASKSTPFSIPSHHSDTPTTLASHSTKTDASSTHHSTVPPLTSSNHSTSPQLSTGVSFFFLSFHISNLQFNSSLEDPSTDYYQELQRDISEMFLQIYKQGGFLGLSNIKFRPGSVVVQLTLAFREGTINVHDVETQFNQYKTEAASRYNLTISDVSVSDVPFPFSAQSGAGVPGWGIALLVLVCVLVALAIVYLIALAVCQCRRKNYGQLDIFPARDTYHPMSEYPTYHTHGRYVPPSSTDRSPYEKVSAGNGGSSLSYTNPAVAATSANL	PAPGSTAPAAHGVTSAPESR,PAPGSTAPPAHGVTSAPESR
MTPGTQSPFFLLLLLTVLTVVTGSGHASSTPGGEKETSATQRSSVPSSTEKNAVSMTSSVLSSHSPGSGSSTTQGQDVTLAPATEPASGSAATWGQDVTSVPVTRPALGSTTPPAHDVTSAPDNKPAPGSTAPPAHGVTSAPDTRPAPGSTAPQAHGVTSAPDTRPAPGSTAPPAHGVTSAPDTRPAPGSTAPPAHGVTSAPDTRPAPGSTAPAAHGVTSAPDTRPAPGSTAPQAHGVTSAPDTRPAPGSTAPPAHGVTSAPDTRPAPGSTAPPAHGVTSAPDTRPAPGSTAPPAHGVTSAPDTRPAPGSTAPPAHGVTSAPDTRPAPGSTAPPAHGVTSAPDTRPAPGSTAPPAHGVTSAPESRPAPGSTAPAAHGVTSAPESRPAPGSTAPAAHGVTSAPDTRPAPGSTAPPAHGVTSAPDTRPAPGSTAPPAHGVTSAPDTRPAPGSTAPPAHGVTSAPDTRPAPGSTAPPAHGVTSAPDTRPAPGSTAPPAHGVTSAPDTRPAPGSTAPPAHGVTSAPDTRPAPGSTAPPAHGVTSAPDTRPAPGSTAPPTHGVTSAPDTRPAPGSTAPPAHGVTSAPDTRPAPGSTAPPAHGVTSAPDTRPAPGSTAPPAHGVTSAPDTRPAPGSTAPPAHGVTSAPDTRPAPGSTAPPAHGVTSAPDTRPAPGSTAPPAHGVTSAPESRPAPGSTAPAAHGVTSAPESRPAPGSTAPAAHGVTSAPDTRPAPGSTAPPAHGVTSAPDTRPAPGSTAPPAHGVTSAPDTRPAPGSTAPPAHGVTSAPDTRPAPGSTAPPAHGVTSAPDTRPPAPGSTAPPAHGVTSAPDTRPAPGSTAPPAHGVTSAPDTRPAPGSTAPPAHGVTSAPDTRPAPGSTAPPAHGVTSAPDTRPAPGSTAPPAHGVTSAPDTRRAPGSTPAPGSTAPPAHGVTSAPDTRPAPGSTAPPAHGVTSAPDNRPALGSTAPPVHNVTSASGSASGSASTLVHNGTSARATTTPASKSTPFSIPSHHSDTPTTLASHSTKTDASSTHHSTVPPLTSSNHSTSPQLSTGVSFFFLSFHISNLQFNSSLEDPSTDYYQELQRDISEMFLQIYKQGGFLGLSNIKFRPGSVVVQLTLAFREGTINVHDVETQFNQYKTEAASRYNLTISDVSVSDVPFPFSAQSGAGVPGWGIALLVLVCVLVALAIVYLIALAVCQCRRKNYGQLDIFPARDTYHPMSEYPTYHTHGRYVPPSSTDRSPYEKVSAGNGGSSLSYTNPAVAATSANL	PAPGSTAPAAHGVTSAPESR,PAPGSTAPPAHGVTSAPESR
MTPGTQSPFFLLLLLTVLTVVTGSGHASSTPGGEKETSATQRSSVPSSTEKNAVSMTSSVLSSHSPGSGSSTTQGQDVTLAPATEPASGSAATWGQDVTSVPVTRPALGSTTPPAHDVTSAPDNKPAPGSTAPPAHGVTSAPDTRPAPGSTAPQAHGVTSAPDTRPAPGSTAPPAHGVTSAPDTRPAPGSTAPPAHGVTSAPDTRPAPGSTAPAAHGVTSAPDTRPAPGSTAPQAHGVTSAPDTRPAPGSTAPTAHGVTSAPDTRPAPGSTAPPAHGVTSAPDTRPAPGSTAPPAHGVTSAPESRPAPGSTAPAAHGVTSAPESRPAPGSTAPPAHGVTSAPDTRPAPGSTAPPAHGVTSAPDTRPAPGSTAPAAHGVTSAPDTRPAPGSTAPQAHGVTSAPDTRPAPGSTAPPAHGVTSAPDTRPAPGSTAPPAHGVTSAPDTRPAPGSTAPPAHGVTSAPESRPAPGSTAPAAHGVTSAPESRPAPGSTAPAAHGVTSAPESRPAPGSTAPPAHGVTSAPDTRPAPGSTAPPAHGVTSAPDTRPAPGSTAPPAHGVTSAPDTRPAPGSTAPPAHGVTSAPDTRPAPGSTAPPAHGVTSAPDTRPAPGSTAPPAHGVTSAPDTRPAPGSTAPAAHGVTSAPESRPAPGSTAPAAHGVTSAPESRPAPGSTAPPAHGVTSAPDTRPAPGSTAPPAHGVTSAPDTRPAPGSTAPPAHGVTSAPDTRPAPGSTAPPAHGVTSAPDTRPAPGSTAPPAHGVTSAPDTRPAPGSTAPPAHGVTSAPDTRPAPGSTAPPAHGVTSAPDTRPAPGSTAPPAHGVTSAPDTRPAPGSTPAPGSTAPPAHGVTSAPDTRPAPGSTAPPAHGVTSAPDNRPALGSTAPPVHNVTSASGSASGSASTLVHNGTSARATTTPASKSTPFSIPSHHSDTPTTLASHSTKTDASSTHHSTVPPLTSSNHSTSPQLSTGVSFFFLSFHISNLQFNSSLEDPSTDYYQELQRDISEMFLQIYKQGGFLGLSNIKFRPGSVVVQLTLAFREGTINVHDVETQFNQYKTEAASRYNLTISDVSVSDVPFPFSAQSGAGVPGWGIALLVLVCVLVALAIVYLIALAVCQCRRKNYGQLDIFPARDTYHPMSEYPTYHTHGRYVPPSSTDRSPYEKVSAGNGGSSLSYTNPAVAATSANL	PAPGSTAPAAHGVTSAPESR,PAPGSTAPPAHGVTSAPESR
MTPGTQSPFFLLLLLTVLTVVTGSGHASSTPGGEKETSATQRSSVPSSTEKNAVSMTSSVLSSHSPGSGSSTTQGQDVTLAPATEPASGSAATWGQDVTSVPVTRPALGSTTPPAHDVTSAPDNKPAPGSTAPPAHGVTLAPDTRPAPGSTAPQAHGVTSAPDTRPAPGSTAPPAHGVTSAPDTRPAPGSTAPPAHGVTSAPDTRPAPGSTAPAAHGVTSAPDTRPAPGSTAPQAHGVTSAPDTRPAPGSTAPPAHGVTSAPDTRPAPGSTAPPAHGVTSAPDTRPAPGSTAPPAHGVTSAPDTRPAPGSTAPPAHGVTSAPDTRPAPGSTAPPAHGVTSAPDTRPAPGSTAPPAHGVTSAPDTRPAPGSTAPPAHGVTSAPESRPAPGSTAPAAHGVTSAPESRPAPGSTAPAAHGVTSAPESRPAPGSTAPPAHGVTSAPDTRPAPGSTAPPAHGVTSAPDTRPAPGSTAPAAHGVTSAPDTRPAPGSTAPQAHGVTSAPDTRPAPGSTAPPAHGVTSAPDTRPAPGSTAPPAHGVTSAPDTRPAPGSTAPPAHGVTSAPESRPAPGSTAPPAHGVTSAPDTRPAPGSTAPPAHGVTSAPDTRPAPGSTAPPAHGVTSAPDTRPAPGSTAPPAHGVTSAPDTRPAPGSTAPPAHGVTSAPDTRPAPGSTAPPAHGVTSAPDTRPAPGSTAPPAHGVTSAPESRPAPGSTAPAAHGVTSAPESRPAPGSTAPAAHGVTSAPESRPAPGSTAPPAHGVTSAPDTRPAPGSTAPPAHGVTSAPDTRPAPGSTAPPAHGVTSAPDTRPAPGSTAPPAHGVTSAPDTRPAPGSTAPPAHGVTSAPDTRPAPGSTAPPAHGVTSAPDTRPAPGSTAPPAHGVTSAPDTRPAPGSTAPPAHGVTSAPDTRPAPGSTPAPGSTAPPAHGVTSAPDTRPAPGSTAPPAHGVTSAPDNRPALGSTAPPVHNVTSASGSASGSASTLVHNGTSARATTTPASKSTPFSIPSHHSDTPTTLASHSTKTDASSTHHSTVPPLTSSNHSTSPQLSTGVSFFFLSFHISNLQFNSSLEDPSTDYYQELQRDISEMFLQIYKQGGFLGLSNIKFRPGSVVVQLTLAFREGTINVHDVETQFNQYKTEAASRYNLTISDVSVSDVPFPFSAQSGAGVPGWGIALLVLVCVLVALAIVYLIALAVCQCRRKNYGQLDIFPARDTYHPMSEYPTYHTHGRYVPPSSTDRSPYEKVSAGNGGSSLSYTNPAVAATSANL	PAPGSTAPAAHGVTSAPESR,PAPGSTAPPAHGVTSAPESR
MTPGTQSPFFLLLLLTVLTVVTGSGHASSTPGGEKETSATQRSSVPSSTEKNAVSMTSSVLSSHSPGSGSSTTQGQDVTLAPATEPASGSAATWGQDVTSVPVTRPALGSTTPPAHDVTSAPDNKPAPGSTAPPAHGVTSAPDTRPAPGSTAPQAHGVTSAPDTRPAPGSTAPPAHGVTSAPDTRPAPGSTAPPAHGVTSAPDTRPAPGSTAPAAHGVTSAPDTRPAPGSTAPQAHGVTSAPDTRPAPGSTAPPAHGVTSAPDTRPAPGSTAPPAHGVTSAPDTRPAPGSTAPPAHGVTSAPDTRPAPGSTAPPAHGVTSAPDTRPAPGSTAPPAHGVTSAPDTRPAPGSTAPPAHGVTSAPDTRPAPGSTAPAAHGVTSAPESRPAPGSTAPAAHGVTSAPESRPAPGSTAPPAHGVTSAPDTRPAPGSTAPPAHGVTSAPDTRPAPGSTAPPAHGVTSAPDTRPAPGSTAPPAHGVTSAPDTRPAPGSTAPPAHGVTSAPDTRPAPGSTAPPAHGVTSAPDTRPAPGSTAPPAHGVTSAPDTRPAPGSTAPPAHGVTSAPDTRPAPGSTAPPAHGVTSAPDTRPAPGSTAPAAHGVTSAPDTRPAPGSTAPQAHGVTSAPDTRPAPGSTAPPAHGVTSAPDTRPAPGSTAPPAHGVTSAPDTRPAPGSTAPPAHGVTSAPESRPAPGSTAPAAHGVTSAPESRPAPGSTAPAAHGVTSAPESRPAPGSTAPPAHGVTSAPDTRPAPGSTAPPAHGVTSAPDTRPAPGSTAPPAHGVTSAPDTRPAPGSTAPPAHGVTSAPDTRPPAPGSTAPPAHGVTSAPDTRPAPGSTAPPAHGVTSAPDTRPAPGSTAPPAHGVTSAPDTRPAPGSTAPPAHGVTSAPDTRPAPGSTAPPAHGVTSAPDTRPAPGSTPAPGSTAPPAHGVTSAPDTRPAPGSTAPPAHGVTSAPDNRPALGSTAPPVHNVTSASGSASGSASTLVHNGTSARATTTPASKSTPFSIPSHHSDTPTTLASHSTKTDASSTHHSTVPPLTSSNHSTSPQLSTGVSFFFLSFHISNLQFNSSLEDPSTDYYQELQRDISEMFLQIYKQGGFLGLSNIKFRPGSVVVQLTLAFREGTINVHDVETQFNQYKTEAASRYNLTISDVSVSDVPFPFSAQSGAGVPGWGIALLVLVCVLVALAIVYLIALAVCQCRRKNYGQLDIFPARDTYHPMSEYPTYHTHGRYVPPSSTDRSPYEKVSAGNGGSSLSYTNPAVAATSANL	PAPGSTAPAAHGVTSAPESR,PAPGSTAPPAHGVTSAPESR
MTPGTQSPFFLLLLLTVLTVVTGSGHASSTPGGEKETSATQRSSVPSSTEKNAVSMTSSVLSSHSPGSGSSTTQGQDVTLAPATEPASGSAATWGQDVTSVPVTRPALGSTTPPAHDVTSAPDNKPAPGSTAPPAHGVTSAPDTRPAPGSTAPQAHGVTSAPDTRPAPGSTAPPAHGVTSAPDTRPAPGSTAPPAHGVTSAPDTRPAPGSTAPAAHGVTSAPDTRPAPGSTAPQAHGVTSAPDTRPAPGSTAPPAHGVTSAPDTRPAPGSTAPPAHGVTSAPDTRPAPGSTAPPAHGVTSAPDTRPAPGSTAPPAHGVTSAPDTRPAPGSTAPPAHGVTSAPDTRPAPGSTAPPAHGVTSAPDTRPAPGSTAPPAHGVTSAPDTRPAPGSTAPPAHGVTSAPDTRPAPGSTAPPAHGVTSAPDTRPAPGSTAPPAHGVTSAPDTRPAPGSTAPPAHGVTSAPESRPAPGSTAPAAHGVTSAPDTRPAPGSTAPPAHGVTSAPDTRPAPGSTAPPAHGVTSAPDTRPAPGSTAPPAHGVTSAPDTRPAPGSTAPPAHGVTSAPDTRPAPGSTAPPAHGVTSAPDTRPAPGSTAPPAHGVTSAPDTRPAPGSTAPAAHGVTSAPESRPAPGSTAPAAHGVTSAPESRPAPGSTAPPAHGVTSAPDTRPAPGSTAPPAHGVTSAPDTRPAPGSTAPPAHGVTSAPDTRPAPGSTAPPAHGVTSAPDTRPAPGSTAPPAHGVTSAPDTRPAPGSTAPPAHGVTSAPDTRPAPGSTAPPAHGVTSAPDTRPAPGSTAPPAHGVTSAPDTRPAPGSTAPPAHGVTSAPDTRRAPGSTRAPGSTAPPAHGVTSAPDTRPAPGSTAPPAHGVTSAPDNRPALGSTAPPVHNVTSASGSASGSASTLVHNGTSARATTTPASKSTPFSIPSHHSDTPTTLASHSTKTDASSTHHSTVPPLTSSNHSTSPQLSTGVSFFFLSFHISNLQFNSSLEDPSTDYYQELQRDISEMFLQIYKQGGFLGLSNIKFRPGSVVVQLTLAFREGTINVHDVETQFNQYKTEAASRYNLTISDVSVSDVPFPFSAQSGAGVPGWGIALLVLVCVLVALAIVYLIALAVCQCRRKNYGQLDIFPARDTYHPMSEYPTYHTHGRYVPPSSTDRSPYEKVSAGNGGSSLSYTNPAVAATSANL	PAPGSTAPAAHGVTSAPESR,PAPGSTAPPAHGVTSAPESR
MTPGTQSPFFLLLLLTVLTVVTGSGHASSTPGGEKETSATQRSSVPSSTEKNAVSMTSSVLSSHSPGSGSSTTQGQDVTLAPATEPASGSAATWGQDVTSVPVTRPALGSTTPPAHDVTSAPDNKPAPGSTAPPAHGVTSAPDTRPAPGSTAPQAHGVTSAPDTRPAPGSTAPPAHGVTSAPDTRPAPGSTAPPAHGVTSAPDTRPAPGSTAPAAHGVTSAPDTRPAPGSTAPQAHGVTSAPDTRPAPGSTAPTAHGVTSAPDTRPAPGSTAPPAHGVTSAPDTRPAPGSTAPPAHGVTSAPESRPAPGSTAPAAHGVTSAPESRPAPGSTAPPAHGVTSAPDTRPAPGSTAPPAHGVTSAPDTRPAPGSTAPAAHGVTSAPDTRPAPGSTAPQAHGVTSAPDTRPAPGSTAPPAHGVTSAPDTRPAPGSTAPPAHGVTSAPDTRPAPGSTAPPAHGVTSAPESRPAPGSTAPAAHGVTSAPDTRPAPGSTAPPAHGVTSAPDTRPAPGSTAPPAHGVTSAPDTRPAPGSTAPPAHGVTSAPDTRPAPGSTAPPAHGVTSAPDTRPAPGSTAPPAHGVTSAPDTRPAPGSTAPAAHGVTSAPESRPAPGSTAPAAHGVTSAPESRPAPGSTAPPAHGVTSAPDTRPAPGSTAPPAHGVTSAPDTRPAPGSTAPPAHGVTSAPDTRPAPGSTAPPAHGVTSAPDTRPAPGSTAPPAHGVTSAPDTRPAPGSTAPPAHGVTSAPDTRPAPGSTAPPAHGVTSAPDTRPAPGSTAPPAHGVTSAPDTRPAPGSTPAPGSTAPPAHGVTSAPDTRPAPGSTAPPAHGVTSAPDNRPALGSTAPPVHNVTSASGSASGSASTLVHNGTSARATTTPASKSTPFSIPSHHSDTPTTLASHSTKTDASSTHHSTVPPLTSSNHSTSPQLSTGVSFFFLSFHISNLQFNSSLEDPSTDYYQELQRDISEMFLQIYKQGGFLGLSNIKFRPGSVVVQLTLAFREGTINVHDVETQFNQYKTEAASRYNLTISDVSVSDVPFPFSAQSGAGVPGWGIALLVLVCVLVALAIVYLIALAVCQCRRKNYGQLDIFPARDTYHPMSEYPTYHTHGRYVPPSSTDRSPYEKVSAGNGGSSLSYTNPAVAATSANL	PAPGSTAPAAHGVTSAPESR,PAPGSTAPPAHGVTSAPESR
MTPGTQSPFFLLLLLTVLTVVTGSGHASSTPGGEKETSATQRSSVPSSTEKNAVSMTSSVLSSHSPGSGSSTTQGQDVTLAPATEPASGSAATWGQDVTSVPVTRPALGSTTPPAHDVTSAPDNKPAPGSTAPPAHGVTSAPDTRPAPGSTAPQAHGVTSAPDTRPAPGSTAPPAHGVTSAPDTRPAPGSTAPPAHGVTSAPDTRPAPGSTAPAAHGVTSAPDTRPAPGSTAPQAHGVTSAPDTRPAPGSTAPPAHGVTSAPDTRPAPGSTAPPAHGVTSAPDTRPAPGSTAPPAHGVTSAPDTRPAPGSTAPPAHGVTSAPDTRPAPGSTAPPAHGVTSAPDTRPAPGSTAPPAHGVTSAPESRPAPGSTAPAAHGVTSAPESRPAPGSTAPAAHGVTSAPESRPAPGSTAPAAHGVTSAPESRPAPGSTAPPAHGVTSAPDTRPAPGSTAPPAHGVTSAPDTRPAPGSTAPPAHGVTSAPDTRPAPGSTAPPAHGVTSAPDTRPAPGSTAPPAHGVTSAPDTRPAPGSTAPPAHGVTSAPDTRPAPGSTAPPAHGVTSAPDTRPAPGSTAPPAHGVTSAPESRPAPGSTAPAAHGVTSAPESRPAPGSTAPAAHGVTSAPESRPAPGSTAPPAHGVTSAPDTRPAPGSTAPPAHGVTSAPDTRPAPGSTAPPAHGVTSAPDTRPAPGSTAPAAHGVTSAPESRPAPGSTAPAAHGVTSAPESRPAPGSTAPPAHGVTSAPDTRPAPGSTAPPAHGVTSAPDTRPAPGSTAPPAHGVTSAPDTRPAPGSTAPPAHGVTSAPDTRPAPGSTAPPAHGVTSAPDTRPAPGSTAPPAHGVTSAPDTRPAPGSTAPPAHGVTSAPDTRPAPGSTAPPAHGVTSAPDTRPAPGSTAPPAHGVTSAPDTRRAPGSTPAPGSTAPPAHGVTSAPDTRPAPGSTAPPAHGVTSAPDNRPALGSTAPPVHNVTSASGSASGSASTLVHNGTSARATTTPASKSTPFSIPSHHSDTPTTLASHSTKTDASSTHHSTVPPLTSSNHSTSPQLSTGVSFFFLSFHISNLQFNSSLEDPSTDYYQELQRDISEMFLQIYKQGGFLGLSNIKFRPGSVVVQLTLAFREGTINVHDVETQFNQYKTEAASRYNLTISDVSVSDVPFPFSAQSGAGVPGWGIALLVLVCVLVALAIVYLIALAVCQCRRKNYGQLDIFPARDTYHPMSEYPTYHTHGRYVPPSSTDRSPYEKVSAGNGGSSLSYTNPAVAATSANL	PAPGSTAPAAHGVTSAPESR,PAPGSTAPPAHGVTSAPESR
MTPGTQSPFFLLLLLTVLTVVTGSGHASSTPGGEKETSATQRSSVPSSTEKNAVSMTSSVLSSHSPGSGSSTTQGQDVTLAPATEPASGSAATWGQDVTSVPVTRPALGSTTPPAHDVTSAPDNKPAPGSTAPPAHGVTSAPDTRPAPGSTAPQAHGVTSAPDTRPAPGSTAPPAHGVTSAPDTRPAPGSTAPPAHGVTSAPDTRPAPGSTAPAAHGVTSAPDTRPAPGSTAPQAHGVTSAPDTRPAPGSTAPPAHGVTSAPDTRPAPGSTAPPAHGVTSAPDTRPAPGSTAPPAHGVTSAPESRPAPGSTAPAAHGVTSAPESRPAPGSTAPAAHGVTSAPESRPAPGSTAPPAHGVTSAPDTRPAPGSTAPPAHGVTSAPDTRPAPGSTAPPAHGVTSAPDTRPAPGSTAPPAHGVTSAPDTRPAPGSTAPPAHGVTSAPESRPAPGSTAPPAHGVTSAPESRPAPGSTAPAAHGVTSAPDTRPAPGSTAPPAHGVTSAPDTRPAPGSTAPPAHGVTSAPDTRPAPGSTAPPAHGVTSAPDTRPAPGSTAPPAHGVTSAPDTRPAPGSTAPPAHGVTSAPESRPAPGSTAPAAHGVTSAPESRPAPGSTAPAAHGVTSAPDTRPAPGSTAPPAHGVTSAPDTRPAPGSTAPPAHGVTSAPDTRPAPGSTAPAAHGVTSAPESRPAPGSTAPAAHGVTSAPESRPAPGSTAPPAHGVTSAPDTRPAPGSTAPPAHGVTSAPDTRPAPGSTAPPAHGVTSAPDTRPAPGSTAPPAHGVTSAPDTRPAPGSTAPPAHGVTSAPDTRPAPGSTAPPAHGVTSAPDTRPAPGSTAPPAHGVTSAPDTRPAPGSTAPPAHGVTSAPDTRPAPGSTAPPAHGVTSAPDTRPAPGSTAPPAHGVTSAPDTRRAPGSTRAPGSTAPPAHGVTSAPDTRPAPGSTAPPAHGVTSAPDNRPALGSTAPPVHNVTSASGSASGSASTLVHNGTSARATTTPASKSTPFSIPSHHSDTPTTLASHSTKTDASSTHHSTVPPLTSSNHSTSPQLSTGVSFFFLSFHISNLQFNSSLEDPSTDYYQELQRDISEMFLQIYKQGGFLGLSNIKFRPGSVVVQLTLAFREGTINVHDVETQFNQYKTEAASRYNLTISDVSVSDVPFPFSAQSGAGVPGWGIALLVLVCVLVALAIVYLIALAVCQCRRKNYGQLDIFPARDTYHPMSEYPTYHTHGRYVPPSSTDRSPYEKVSAGNGGSSLSYTNPAVAATSANL	PAPGSTAPAAHGVTSAPESR,PAPGSTAPPAHGVTSAPESR
PGSGSSTTQGQDVTLAPATEPASGSAATWGQDVTSVPVTRPALGSTTPPAHDVTSAPDNKPAPGSTAPPAHGVTSAPDTRPAPGSTAPQAHGVTSAPDTRPAPGSTAPPAHGVTSAPDTRPAPGSTAPPAHGVTSAPDTRPAPGSTAPAAHGVTSAPDTRPAPGSTAPQAHGVTSAPDTRPAPGSTAPTAHGVTSAPDTRPAPGSTAPPAHGVTSAPDTRPAPGSTAPPAHGVTSAPESRPAPGSTAPAAHGVTSAPESRPAPGSTAPPAHGVTSAPDTRPAPGSTAPPAHGVTSAPDTRPAPGSTAPAAHGVTSAPDTRPAPGSTAPQAHGVTSAPDTRPAPGSTAPPAHGVTSAPDTRPAPGSTAPPAHGVTSAPDTRPAPGSTAPPAHGVTSAPESRPAPGSTAPAAHGVTSAPESRPAPGSTAPAAHGVTSAPESRPAPGSTAPPSHGVTSAPDTRPAPGSTAPPAHGVTSAPDTRPAPGSTAPPAHGVTSAPDTRPAPGSTAPPAHGVTSAPDTRPAPGSTAPPAHGVTSAPDTRPAPGSTAPPAHGVTSAPDTRPAPGSTAPPAHGVTSAPDTRPAPGSTAPPAHGVTSAPDTRPAPGSTAPAAHGVTSAPESRPAPGSTAPAAHGVTSAPESRPAPGSTAPPAHGVTSAPDTRPAPGSTAPPAHGVTSAPDTRPAPGSTAPPAHGVTSAPDTRPAPGSTAPPAHGVTSAPDTRPAPGSTAPPAHGVTSAPDTRPAPGSTAPPAHGVTSAPDTRPAPGSTAPPAHGVTSAPDTRPAPGSTAPPAHGVTSAPDTRPAPGSTPAPGSTAPPAHGVTSAPDTRPAPGSTAPPAHGVTSAPDNRPALGSTAPPVHNVTSASGSASGSASTLVHNGTSARATTTPASKSTPFSIPSHHSDTPTTLASHSTKTDASSTHHSTVPPLTSSNHSTSPQLSTGVSFFFLSFHISNLQFNSSLEDPSTDYYQELQRDISEMFLQIYKQGGFLGLSNIKFRPGSVVVQLTLAFREGTINVHDVETQFNQYKTEAASRYNLTISDVSVSDVPFPFSAQSGAGVPGWGIALLVLVCVLVALAIVYLIALAVCQCRRKNYGQLDIFPARDTYHPMSEYPTYHTHGRYVPPSSTDRSPYEKVSAGNGGSSLSYTNPAVAATSANL	PAPGSTAPAAHGVTSAPESR,PAPGSTAPPAHGVTSAPESR
MTPGTQSPFFLLLLLTVLTVVTGSGHASSTPGGEKETSATQRSSVPSSTEKNAVSMTSSVLSSHSPGSGSSTTQGQDVTLAPATEPASGSAATWGQDVTSVPVTRPALGSTTPPAHDVTSAPDNKPAPGSTAPPAHGVTSAPDTRPAPGSTAPQAHGVTSAPDTRPAPGSTAPPAHGVTSAPDTRPAPGSTAPPAHGVTSAPDTRPAPGSTAPAAHGVTSAPDTRPAPGSTAPQAHGVTSAPDTRPAPGSTAPPAHGVTSAPDTRPAPGSTAAPAHGVTSAPDTRPAPGSTAPPAHGVTSAPDTRPAPGSTAPPAHGVTSAPDTRPAPGSTAPPAHGVTSAPDTRPAPGSTAPPAHGVTSAPDTRPAPGSTAPAAHGVTSAPDTRPAPGSTAPQAHGVTSAPDTRPAPGSTAPPAHGVTSAPDTRPAPGSTAPPAHGVTSAPDTRPAPGSTAPPAHGVTSAPESRPAPGSTAPAAHGVTSAPESRPAPGSTAPAAHGVTSAPESRPAPGSTAPPAHGVTSAPDTRPAPGSTAPPAHGVTSAPDTRPAPGSTAPPAHGVTSAPDTRPAPGSTAPPAHGVTSAPDTRPAPGSTAPPAHGVTSAPDTRPAPGSTAPPAHGVTSAPDTRPAPGSTAPPAHGVTSAPDTRPAPGSTAPPAHGVTSAPDTRPAPGSTAPPAHGVTSAPDTRPAPGSTAPPAHGVTSAPDTRPAPGSTAPPAHGVTSAPDTRPAPGSTAPPAHGVTSAPDTRPAPGSTAPPAHGVTSAPDTRPAPGSTAPPAHGVTSAPDTRPAPGSTAPPAHGVTSAPDTRPAPGSTAPPAHGVTSAPDTRPAPGSTAPPAHGVTSAPDTRPAPGSTAPPAHGVTSAPDTRPAPGSTAPPAHGVTSAPDTRPAPGSTAPPAHGVTSAPDTRPAPGSTPAPGSTAPPAHGVTSAPDTRPAPGSTAPPAHGVTSAPDNRPALGSTAPPVHNVTSASGSASGSASTLVHNGTSARATTTPASKSTPFSIPSHHSDTPTTLASHSTKTDASSTHHSTVPPLTSSNHSTSPQLSTGVSFFFLSFHISNLQFNSSLEDPSTDYYQELQRDISEMFLQIYKQGGFLGLSNIKFRPGSVVVQLTLAFREGTINVHDVETQFNQYKTEAASRYNLTISDVSVSDVPFPFSAQSGAGVPGWGIALLVLVCVLVALAIVYLIALAVCQCRRKNYGQLDIFPARDTYHPMSEYPTYHTHGRYVPPSSTDRSPYEKVSAGNGGSSLSYTNPAVAATSANL	PAPGSTAPAAHGVTSAPESR,PAPGSTAPPAHGVTSAPESR
MTPGTQSPFFLLLLLTVLTVVTGSGHASSTPGGEKETSATQRSSVPSSTEKNAVSMTSSVLSSHSPGSGSSTTQGQDVTLAPATEPASGSAATWGQDVTSVPVTRPALGSTTPPAHDVTSAPDNKPAPGSTAPPAHGVTSAPDTRPAPGSTAPQAHGVTSAPDTRPAPGSTAPPAHGVTSAPDTRPAPGSTAPPAHGVTSAPDTRPAPGSTAPAAHGVTSAPDTRPAPGSTAPQAHGVTSAPDTRPAPGSTAPTAHGVTSAPDTRPAPGSTAPPAHGVTSAPDTRPAPGSTAPPAHGVTSAPESRPAPGSTAPAAHGVTSAPESRPAPGSTAPPAHGVTSAPDTRPAPGSTAPPAHGVTSAPDTRPAPGSTAPAAHGVTSAPDTRPAPGSTAPQAHGVTSAPDTRPAPGSTAPPAHGVTSAPDTRPAPGSTAPPAHGVTSAPDTRPAPGSTAPPAHGVTSAPESRPAPGSTAPAAHGVTSAPDTRPAPGSTAPPAHGVTSAPDTRPAPGSTAPPAHGVTSAPDTRPAPGSTAPPAHGVTSAPDTRPAPGSTAPPAHGVTSAPDTRPAPGSTAPPAHGVTSAPDTRPAPGSTAPPAHGVTSAPDTRPAPGSTAPAAHGVTSAPESRPAPGSTAPAAHGVTSAPESRPAPGSTAPPAHGVTSAPDTRPAPGSTAPPAHGVTSAPDTRPAPGSTAPPAHGVTSAPDTRPAPGSTAPPAHGVTSAPDTRPAPGSTAPPAHGVTSAPDTRPAPGSTAPPAHGVTSAPDTRPAPGSTAPPAHGVTSAPDTRPAPGSTAPPAHGVTSAPDTRPAPGSTPAPGSTAPPAHGVTSAPDTRPAPGSTAPPAHGVTSAPDNRPALGSTAPPVHNVTSASGSASGSASTLVHNGTSARATTTPASKSTPFSIPSHHSDTPTTLASHSTKTDASSTHHSTVPPLTSSNHSTSPQLSTGVSFFFLSFHISNLQFNSSLEDPSTDYYQELQRDISEMFLQIYKQGGFLGLSNIKFRPGSVVVQLTLAFREGTINVHDVETQFNQYKTEAASRYNLTISDVSVSDVPFPFSAQSGAGVPGWGIALLVLVCVLVALAIVYLIALAVCQCRRKNYGQLDIFPARDTYHPMSEYPTYHTHGRYVPPSSTDRSPYEKVSAGNGGSSLSYTNPAVAATSANL	PAPGSTAPAAHGVTSAPESR,PAPGSTAPPAHGVTSAPESR
MTPGTQSPFFLLLLLTVLTVVTGSGHASSTPGGEKETSATQRSSVPSSTEKNAVSMTSSVLSSHSPGSGSSTTQGQDVTLAPATEPASGSAATWGQDVTSVPVTRPALGSTTPPAHDVTSAPDNKPAPGSTAPPAHGVTSAPDTRPAPGSTAPQAHGVTSAPDTRPAPGSTAPPAHGVTSAPDTRPAPGSTAPPAHGVTSAPDTRPAPGSTAPAAHGVTSAPDTRPAPGSTAPQAHGVTSAPDTRPAPGSTAPTAHGVTSAPDTRPAPGSTAPPAHGVTSAPDTRPAPGSTAPPAHGVTSAPESRPAPGSTAPAAHGVTSAPESRPAPGSTAPPAHGVTSAPDTRPAPGSTAPPAHGVTSAPDTRPAPGSTAPAAHGVTSAPDTRPAPGSTAPQAHGVTSAPDTRPAPGSTAPPAHGVTSAPDTRPAPGSTAPPAHGVTSAPDTRPAPGSTAPPAHGVTSAPESRPAPGSTAPAAHGVTSAPESRPAPGSTAPAAHGVTSAPESRPAPGSTAPPAHGVTSAPDTRPAPGSTAPPAHGVTSAPDTRPAPGSTAPPAHGVTSAPDTRPAPGSTAPPAHGVTSAPDTRPAPGSTAPPAHGVTSAPDTRPAPGSTAPPAHGVTSAPDTRPAPGSTAPAAHGVTSAPESRPAPGSTAPAAHGVTSAPESRPAPGSTAPPAHGVTSAPDTRPAPGSTAPPAHGVTSAPDTRPAPGSTAPPAHGVTSAPDTRPAPGSTAPPAHGVTSAPDTRPAPGSTAPPSPRCHLGPGHQAGPGLHRPPQPTVSPRPRTPGRPRAPPPPQPTVSPRPRTPGRPRAPPHPQPTVSPRPRTPGRPRAPPRPRAPPPPQPTVSPRPRTPGRPRAPPPPQPMVSPRPRTTGPPWAPPPLQSTMSPRPQALHQAQLLLWCTTAPLPGLPQPQPARALHSQFPATTLILLPPLPAIAPRLMPVALTIARYLLSPPPITALLPSCLLGSLSFSCLFTFQTSSLIPLWKIPAPTTTKSCRETFLKCFCRFINKGVFWASPILSSGQDLWWYNLWPSEKVPSMSTTWRHSSISIKRKQPLDITRSQTSAVMCHFLSLPSLGLGCQAGASRCWCWSVFWLRWPLSISLPWLSVSAAERTTGSWTSFQPGIPTILASTPPTTPMGAMCPLAVPIVAPMRRFLQVMVAAASLTQTQQWQPLLPTC	PAPGSTAPAAHGVTSAPESR,PAPGSTAPPAHGVTSAPESR
MTPGTQSPFFLLLLLTVLTVVTGSGHASSTPGGEKETSATQRSSVPSSTEKNAVSMTSSVLSSHSPGSGSSTTQGQDVTLAPATEPASGSAATWGQDVTSVPVTRPALGSTTPPAHDVTSAPDNKPAPGSTAPPAHGVTSAPDTRPAPGSTAPQAHGVTSAPDTRPAPGSTAPPAHGVTSAPDTRPAPGSTAPPAHGVTSAPDTRPAPGSTAPAAHGVTSAPDTRPAPGSTAPQAHGVTSAPDTRPAPGSTAPPSPRCHLGPGHQAGPGLHRPPAHGVTSAPDTRPAPGSTAPPAHGVTSAPESRPAPGSTAPPAHGVTSAPDTRPAPGSTAPPAHGVTSAPDTRPAPGSTAPPAHGVTSAPDTRPAPGSTAPPAHGVTSAPDTRPAPGSTAPPAHGVTSAPDTRPAPGSTAPPAHGVTSAPDTRPAPGSTAPPAHGVTSAPDTRPAPGSTAPPAHGVTSAPDTRPAPGSTAPPAHGVTSAPESRPAPGSTAPAAHGVTSAPESRPAPGSTAPAAHGVTSAPDTRPAPGSTAPPAHGVTSAPDTRPAPGSTAPPAHGVTSAPDTRPAPGSTAPPAHGVTSAPDTRPAPGSTAPPAHGVTSAPDTRPAPGSTAPPAHGVTSAPESRPAPGSTAPAAHGVTSAPESRPAPGSTAPAAHGVTSAPESRPAPGSTAPPAHGVTSAPDTRPAPGSTAPPSPRCHLGPGHQAGPGLHRPPQPTVSPRPRTPGRPRAPPPPPAHGVTSAPDTRPAPGSTAPPAHGVTSAPDTRPAPGSTAPPAHGVTSAPESRPAPGSTAPAAHGVTSAPESRPAPGSTAPAAHGVTSAPDTRPAPGSTAPPAHGVTSAPDTRPAPGSTAPPAHGVTSAPDTRPAPGSTAPPAHGVTSAPDTRPAPGSTAPPAHGVTSAPDTRPAPGSTAPPAHGVTSAPDTRPAPRAPPPPQPTVSPRPRTPGRPRAPPPPQPTVSPRPRTPGRPRAPPPPQPTVSPRPRTPGRPRAPPPPQPTVSPRPRTPGRPRAPPPPPAHGVTSAPDTRPAPGSTAPPAHGVTSAPDTRRAPGSTPAPGSTAPPAHGVTSAPDTRPAPGSTAPPAHGVTSAPDNRPALGSTAPPVHNVTSASGSASGSASTLVHNGTSARATTTPASKSTPFSIPSHHSDTPTTLASHSTKTDASSTHHSTVPPLTSSNHSTSPQLSTGVSFFFLSFHISNLQFNSSLEDPSTDYYQELQRDISEMFLQIYKQGGFLGLSNIKFRPGSVVVQLTLAFREGTINVHDVETQFNQYKTEAASRYNLTISDVSVSDVPFPFSAQSGAGVPGWGIALLVLVCVLVALAIVYLIALAVCQCRRKNYGQLDIFPARDTYHPMSEYPTYHTHGRYVPPSSTDRSPYEKVSAGNGGSSLSYTNPAVAATSANL	PAPGSTAPAAHGVTSAPESR,PAPGSTAPPAHGVTSAPESR
MTPGTQSPFFLLLLLTVLTVVTGSGHASSTPGGEKETSATQRSSVPSSTEKNAVSMTSSVLSSHSPGSGSSTTQGQDVTLAPATEPASGSAATWGQDVTSVPVTRPALGSTTPPAHDVTSAPDNKPAPGSTAPPAHGVTSAPDTRPAPGSTAPQAHGVTSAPDTRPAPGSTAPPAHGVTSAPDTRPAPGSTAPPAHGVTSAPDTRPAPGSTAPAAHGVTSAPDTRPAPGSTAPQAHGVTSAPDTRPAPGSTAPTAHGVTSAPDTRPAPGSTAPPAHGVTSAPDTRPAPGSTAPPAHGVTSAPESRPAPGSTAPAAHGVTSAPESRPAPGSTAPPAHGVTSAPDTRPAPGSTAPPAHGVTSAPDTRPAPGSTAPAAHGVTSAPDTRPAPGSTAPQAHGVTSAPDTRPAPGSTAPPAHGVTSAPDTRPAPGSTAPPAHGVTSAPDTRPAPGSTAPPAHGVTSAPESRPAPGSTAPAAHGVTSAPESRPAPGSTAPAAHGVTSAPESRPAPGSTAPPAHGVTSAPDTRPAPGSTAPPAHGVTSAPDTRPAPGSTAPPAHGVTSAPDTRPAPGSTAPPAHGVTSAPDTRPAPGSTAPPAHGVTSAPDTRPAPGSTAPPAHGVTSAPDTRPAPGSTAPPAHGVTSAPDTRPAPGSTAPAAHGVTSAPESRPAPGSTAPAAHGVTSAPESRPAPGSTAPPAHGVTSAPDTRPAPGSTAPPAHGVTSAPDTRPAPGSTAPPAHGVTSAPDTRPAPGSTAPPAHGVTSAPDTRPAPGSTAPPAHGVTSAPDTRPAPGSTAPPAHGVTSAPDTRPAPGSTAPPAHGVTSAPDTRPAPGSTAPPAHGVTSAPDTRPAPGSTPAPGSTAPPAHGVTSAPDTRPAPGSTAPPAHGVTSAPDNRPALGSTAPPVHNVTSASGSASGSASTLVHNGTSARATTTPASKSTPFSIPSHHSDTPTTLASHSTKTDASSTHHSTVPPLTSSNHSTSPQLSTGVSFFFLSFHISNLQFNSSLEDPSTDYYQELQRDISEMFLQIYKQGGFLGLSNIKFRPGSVVVQLTLAFREGTINVHDVETQFNQYKTEAASRYNLTISDVSVSDVPFPFSAQSGAGVPGWGIALLVLVCVLVALAIVYLIALAVCQCRRKNYGQLDIFPARDTYHPMSEYPTYHTHGRYVPPSSTDRSPYEKVSAGNGGSSLSYTNPAVAATSANL	PAPGSTAPAAHGVTSAPESR,PAPGSTAPPAHGVTSAPESR
SHSPGSGSSTTQGQDVTLAPATEPASGSAATWGQDVTSVPVTRPALGSTTPPAHDVTSAPDNKPAPGSTAPPAHGVTSAPDTRPAPGSTAPQAHGVTSAPDTRPAPGSTAPPAHGVTSAPDTRPAPGSTAPPAHGVTSAPDTRPAPGSTAPAAHGVTSAPDTRPAPGSTAPQAHGVTSAPDTRPAPGSTAPPAHGVTSAPDTRPAPGSTAPPAHGVTSAPESRPAPGSTAPAAHGVTSAPESRPAPGSTAPPAHGVTSAPDTRPAPGSTAPPAHGVTSAPDTRPAPGSTAPAAHGVTSAPDTRPAPGSTAPQAHGVTSAPDTRPAPGSTAPPAHGVTSAPDTRPAPGSTAPPAHGVTSAPDTRPAPGSTAPPAHGVTSAPESRPAPGSTAPAAHGVTSAPESRPAPGSTAPAAHGVTSAPESRPAPGSTAPPAHGVTSAPDTRPAPGSTAPPAHGVTSAPDTRPAPGSTAPPAHGVTSAPDTRPAPGSTAPPAHGVTSAPDTRPAPGSTAPPAHGVTSAPDTRPAPGSTAPPAHGVTSAPDTRPAPGSTAPPAHGVTSAPDTRPAPGSTAPPAHGVTSAPDTRPAPGSTAPAAHGVTSAPESRPAPGSTAPAAHGVTSAPESRPAPGSTAPPAHGVTSAPESRPAPGSTAPPAHGVTSAPDTRPAPGSTAPPAHGVTSAPDTRPAPGSTAPPAHGVTSAPDTRPAPGSTAPPAHGVTSAPDTRPAPGSTAPPAHGVTSAPDTRPAPGSTAPPAHGVTSAPDTRPAPGSTAPPAHGVTSAPDTRPAPGSTPAPGSTAPPAHGVTSAPDTRPAPGSTAPPAHGVTSAPDNRPALGSTAPPVHNVTSASGSASGSASTLVHNGTSARATTTPASKSTPFSIPSHHSDTPTTLASHSTKTDASSTHHSTVPPLTSSNHSTSPQLSTGVSFFFLSFHISNLQFNSSLEDPSTDYYQELQRDISEMFLQIYKQGGFLGLSNIKFRPGSVVVQLTLAFREGTINVHDVETQFNQYKTEAASRYNLTISDVSVSDVPFPFSAQSGAGVPGWGIALLVLVCVLVALAIVYLIALAVCQCRRKNYGQLDIFPARDTYHPMSEYPTYHTHGRYVPPSSTDRSPYEKVSAGNGGSSLSYTNPAVAATSANL	PAPGSTAPAAHGVTSAPESR,PAPGSTAPPAHGVTSAPESR
MTPGTQSPFFLLLLLTVLTVVTGSGHASSTPGGEKETSATQRSSVPSSTEKNAVSMTSSVLSSHSPGSGSSTTQGQDVTLAPATEPASGSAATWGQDVTSVPVTRPALGSTTPPAHDVTSAPDNKPAPGSTAPPAHGVTSAPDTRPAPGSTAPQAHGVTSAPDTRPAPGSTAPPAHGVTSAPDTRPAPGSTAPPAHGVTSAPDTRPAPGSTAPAAHGVTSAPDTRPAPGSTAPQAHGVTSAPDTRPAPGSTAPPAHGVTSAPDTRPAPGSTAPPAHGVTSAPDTRPAPGSTAPPAHGVTSAPDTRPAPGSTAPPAHGVTSAPDTRPAPGSTAPPAHGVTSAPDTRPAPGSTAPPAHGVTSAPDTRPAPGSTAPPAHGVTSAPESRPAPGSTAPAAHGVTSAPESRPAPGSTAPAAHGVTSAPESRPAPGSTAPPAHGVTSAPDTRPAPGSTAPPAHGVTSAPDTRPAPGSTAPPAHGVTSAPDTRPAPGSTAPPAHGVTSAPDTRPAPGSTAPPAHGVTSAPESRPAPGSTAPPAHGVTSAPDTRPAPGSTAPPAHGVTSAPDTRPAPGSTAPPAHGVTSAPDTRPAPGSTAPPAHGVTSAPDTRPAPGSTAPPAHGVTSAPDTRPAPGSTAPPAHGVTSAPDTRPAPGSTAPPAHGVTSAPDTRPAPGSTAPPAHGVTSAPDTRPAPGSTAPAAHGVTSAPESRPAPGSTAPAAHGVTSAPESRPAPGSTAPPAHGVTSAPDTRPAPGSTAPPAHGVTSAPDTRPAPGSTAPPAHGVTSAPDTRPAPGSTAPPAHGVTSAPDTRPAPGSTAPPAHGVTSAPDTRPAPGSTAPPAHGVTSAPDTRPAPGSTAPPAHGVTSAPDTRPAPGSTAPPAHGVTSAPDTRPAPGSTAPPAHGVTSAPDTRRAPGSTPAPGSTAPPAHGVTSAPDTRPAPGSTAPPAHGVTSAPDNRPALGSTAPPVHNVTSASGSASGSASTLVHNGTSARATTTPASKSTPFSIPSHHSDTPTTLASHSTKTDASSTHHSTVPPLTSSNHSTSPQLSTGVSFFFLSFHISNLQFNSSLEDPSTDYYQELQRDISEMFLQIYKQGGFLGLSNIKFRPGSVVVQLTLAFREGTINVHDVETQFNQYKTEAASRYNLTISDVSVSDVPFPFSAQSGAGVPGWGIALLVLVCVLVALAIVYLIALAVCQCRRKNYGQLDIFPARDTYHPMSEYPTYHTHGRYVPPSSTDRSPYEKVSAGNGGSSLSYTNPAVAATSANL	PAPGSTAPAAHGVTSAPESR,PAPGSTAPPAHGVTSAPESR
ASSTPGGEKETSATQRSSVPSSTEKNAVSMTSSVLSSHSPGSGSSTTQGQDVTLAPATEPASGSAATWGQDVTSVPVTRPALGSTTPPAHDVTSAPDNKPAPGSTAPPAHGVTSAPDTRPAPGSTAPQAHGVTSAPDTRPAPGSTAPPAHGVTSAPDTRPAPGSTAPPAHGVTSAPDTRPAPGSTAPAAHGVTSAPDTRPAPGSTAPQAHGVTSAPDTRPAPGSTAPTAHGVTSAPDTRPAPGSTAPPAHGVTSAPDTRPAPGSTAPPAHGVTSAPESRPAPGSTAPAAHGVTSAPESRPAPGSTAPPAHGVTSAPDTRPAPGSTAPPAHGVTSAPDTRPAPGSTAPAAHGVTSAPDTRPAPGSTAPQAHGVTSAPDTRPAPGSTAPPAHGVTSAPDTRPAPGSTAPPAHGVTSAPDTRPAPGSTAPPAHGVTSAPESRPAPGSTAPAAHGVTSAPESRPAPGSTAPPAHGVTSAPDTRPAPGSTAPPAHGVTSAPDTRPAPGSTAPPAHGVTSAPDTRPAPGSTAPPAHGVTSAPDTRPAPGSTAPPAHGVTSAPDTRPAPGSTAPPAHGVTSAPDTRPAPGSTAPAAHGVTSAPESRPAPGSTAPAAHGVTSAPESRPAPGSTAPPAHGVTSAPDTRPAPGSTAPPAHGVTSAPDTRPAPGSTAPPAHGVTSAPDTRPAPGSTAPPAHGVTSAPDTRPAPGSTAPPAHGVTSAPDTRPAPGSTAPPAHGVTSAPDTRPAPGSTAPPAHGVTSAPDTRPAPGSTAPPAHGVTSAPDTRPAPGSTPAPGSTAPPAHGVTSAPDTRPAPGSTAPPAHGVTSAPDNRPALGSTAPPVHNVTSASGSASGSASTLVHNGTSARATTTPASKSTPFSIPSHHSDTPTTLASHSTKTDASSTHHSTVPPLTSSNHSTSPQLSTGVSFFFLSFHISNLQFNSSLEDPSTDYYQELQRDISEMFLQIYKQGGFLGLSNIKFRPGSVVVQLTLAFREGTINVHDVETQFNQYKTEAASRYNLTISDVSVSDVPFPFSAQSGAGVPGWGIALLVLVCVLVALAIVYLIALAVCQCRRKNYGQLDIFPARDTYHPMSEYPTYHTHGRYVPPSSTDRSPYEKVSAGNGGSSLSYTNPAVAATSANL	PAPGSTAPAAHGVTSAPESR,PAPGSTAPPAHGVTSAPESR
PGSGSSTTQGQDVTLAPATEPASGSAATWGQDVTSVPVTRPALGSTTPPAHDVTSAPDNKPAPGSTAPPAHGVTSAPDTRPAPGSTAPQAHGVTSAPDTRPAPGSTAPPAHGVTSAPDTRPAPGSTAPPAHGVTSAPDTRPAPGSTAPAAHGVTSAPDTRPAPGSTAPQAHGVTSAPDTRPAPGSTAPTAHGVTSAPDTRPAPGSTAPPAHGVTSAPDTRPAPGSTAPPAHGVTSAPESRPAPGSTAPAAHGVTSAPESRPAPGSTAPPAHGVTSAPDTRPAPGSTAPPAHGVTSAPDTRPAPGSTAPAAHGVTSAPDTRPAPGSTAPQAHGVTSAPDTRPAPGSTAPPAHGVTSAPDTRPAPGSTAPPAHGVTSAPDTRPAPGSTAPPAHGVTSAPESRPAPGSTAPAAHGVTSAPESRPAPGSTAPAAHGVTSAPESRPAPGSTAPPAHGVTSAPDTRPAPGSTAPPAHGVTSAPDTRPAPGSTAPPAHGVTSAPDTRPAPGSTAPPAHGVTSAPDTRPAPGSTAPPAHGVTSAPDTRPAPGSTAPPAHGVTSAPDTRPAPGSTAPPAHGVTSAPDTRPAPGSTAPPAHGVTSAPDTRPAPGSTAPAAHGVTSAPESRPAPGSTAPAAHGVTSAPESRPAPGSTAPPAHGVTSAPDTRPAPGSTAPPAHGVTSAPDTRPAPGSTAPPAHGVTSAPDTRPAPGSTAPPAHGVTSAPDTRPAPGSTAPPAHGVTSAPDTRPAPGSTAPPAHGVTSAPDTRPAPGSTAPPAHGVTSAPDTRPAPGSTAPPAHGVTSAPDTRPAPGSTPAPGSTAPPAHGVTSAPDTRPAPGSTAPPAHGVTSAPDNRPALGSTAPPVHNVTSASGSASGSASTLVHNGTSARATTTPASKSTPFSIPSHHSDTPTTLASHSTKTDASSTHHSTVPPLTSSNHSTSPQLSTGVSFFFLSFHISNLQFNSSLEDPSTDYYQELQRDISEMFLQIYKQGGFLGLSNIKFRPGSVVVQLTLAFREGTINVHDVETQFNQYKTEAASRYNLTISDVSVSDVPFPFSAQSGAGVPGWGIALLVLVCVLVALAIVYLIALAVCQCRRKNYGQLDIFPARDTYHPMSEYPTYHTHGRYVPPSSTDRSPYEKVSAGNGGSSLSYTNPAVAATSANL	PAPGSTAPAAHGVTSAPESR,PAPGSTAPPAHGVTSAPESR
MTPGTQSPFFLLLLLTVLTVVTGSGHASSTPGGEKETSATQRSSVPSSTEKNAVSMTSSVLSSHSPGSGSSTTQGQDVTLAPATEPASGSAATWGQDVTSVPVTRPALGSTTPPAHDVTSAPDNKPAPGSTAPPAHGVTSAPDTRPAPGSTAPQAHGVTSAPDTRPAPGSTAPPAHGVTSAPDTRPAPGSTAPPAHGVTSAPDTRPAPGSTAPAAHGVTSAPDTRPAPGSTAPQAHGVTSAPDTRPAPGSTAPPAHGVTSAPDTRPAPGSTAPPAHGVTSAPDTRPAPGSTAPPAHGVTSAPDTRPAPGSTAPPAHGVTSAPDTRPAPGSTAPPAHGVTSAPDTRPAPGSTAPPAHGVTSAPDTRPAPGSTAPPAHGVTSAPDTRPAPGSTAPPAHGVTSAPDTRPAPGSTAPPAHGVTSAPDTRPAPGSTAPPAHGVTSAPDTRPAPGSTAPPAHGVTSAPESRPAPGSTAPAAHGVTSAPESRPAPGSTAPAAHGVTSAPESRPAPGSTAPPAHGVTSAPDTRPAPGSTAPPAHGVTSAPDTRPAPGSTAPPAHGVTSAPDTRPAPGSTAPPAHGVTSAPDTRPAPGSTAPPAHGVTSAPDTRPAPGSTAPPAHGVTSAPDTRPAPGSTAPPAHGVTSAPDTRPAPGSTAPPAHGVTSAPDTRPAPGSTAPPAHGVTSAPDTRPAPGSTAPAAHGVTSAPESRPAPGSTAPAAHGVTSAPESRPAPGSTAPPAHGVTSAPDTRPAPGSTAPPAHGVTSAPDTRPAPGSTAPPAHGVTSAPDTRPAPGSTAPPAHGVTSAPDTRPAPGSTAPPAHGVTSAPDTRPAPGSTAPPAHGVTSAPDTRPAPGSTAPPAHGVTSAPDTRPAPGSTAPPAHGVTSAPDTRPAPGSTAPPAHGVTSAPDTRRAPGSTPAPGSTAPPAHGVTSAPDTRPAPGSTAPPAHGVTSAPDNRPALGSTAPPVHNVTSASGSASGSASTLVHNGTSARATTTPASKSTPFSIPSHHSDTPTTLASHSTKTDASSTHHSTVPPLTSSNHSTSPQLSTGVSFFFLSFHISNLQFNSSLEDPSTDYYQELQRDISEMFLQIYKQGGFLGLSNIKFRPGSVVVQLTLAFREGTINVHDVETQFNQYKTEAASRYNLTISDVSVSDVPFPFSAQSGAGVPGWGIALLVLVCVLVALAIVYLIALAVCQCRRKNYGQLDIFPARDTYHPMSEYPTYHTHGRYVPPSSTDRSPYEKVSAGNGGSSLSYTNPAVAATSANL	PAPGSTAPAAHGVTSAPESR,PAPGSTAPPAHGVTSAPESR
MTPGTQSPFFLLLLLTVLTVVTGSGHASSTPGGEKETSATQRSSVPSSTEKNAVSMTSSVLSSHSPGSGSSTTQGQDVTLAPATEPASGSAATWGQDVTSVPVTRPALGSTTPPAHDVTSAPDNKPAPGSTAPPAHGVTSAPDTRPAPGSTAPQAHGVTSAPDTRPAPGSTAPPAHGVTSAPDTRPAPGSTAPPAHGVTSAPDTRPAPGSTAPAAHGVTSAPDTRPAPGSTAPQAHGVTSAPDTRPAPGSTAPPAHGVTSAPDTRPAPGSTAPPAHGVTSAPDTRPAPGSTAPPAHGVTSAPESRPAPGSTAPPAHGVTSAPDTRPAPGSTAPPSPRCHLGPGHQAGPGLHRPPQPTVSPRPRTPGRPRAPPPPQPTVSPRPRTPGRPRAPPPPQPTVSPRPRTPGRPRAPPPPQPTVSPRPRTPGRPRAPPPPQPTVSPRPRTPGRPRAPPPPQPTVSPRPRTPGRPRAPPPPQPTVSPRPRTPGRPRAPPPPQPTVSPRPRTPGRPRAPPPPQPTVSPRPRTPGRPRAPPPPPAHGVTSAPDTRPAPGSTAPPAHGVTSAPDTRPAPGSTAPPAHGVTSAPESRPAPGSTAPAAHGVTSAPESRPAPGSTAPAAHGVTSAPESRPAPGSTAPPAHGVTSAPDTRPAPGSTAPPSPRCHLGPGHQAGPGLHRPPQPTVSPRPRTPGRPRAPPPPQPTVSPRPRRAGRPRAPPRPQPTVSPRPRRAGRPRAPPRPQPTVSPRPRRAGRPRAPPPPKPTVSPRPRTPGRPRAPPPPQPTVSPRPRTPGRPRAPPPPQPTVSPRPRTPGRPRAPPPPQPTVSPRPRTPGRPRAPPPPQPTVSPRPRTPGRPRAPPPPPAHGVTSAPDTRPAPGSTAPPAHGVTSAPDTRPAPRAPPPPQPTVSPRPRTPGRPRAPPPPQPTVSPRPRTPGRPRAPPPPQPTVSPRPRTPGRPRAPPPPPAHGVTSAPDTRPAPGSTAPPAHGVTSAPDTRPAPGSTAPPAHGVTSAPDTRRAPGSTRAPGSTAPPAHGVTSAPDTRPAPGSTAPPAHGVTSAPDNRPALGSTAPPVHNVTSASGSASGSASTLVHNGTSARATTTPASKSTPFSIPSHHSDTPTTLASHSTKTDASSTHHSTVPPLTSSNHSTSPQLSTGVSFFFLSFHISNLQFNSSLEDPSTDYYQELQRDISEMFLQIYKQGGFLGLSNIKFRPGSVVVQLTLAFREGTINVHDVETQFNQYKTEAASRYNLTISDVSVSDVPFPFSAQSGAGVPGWGIALLVLVCVLVALAIVYLIALAVCQCRRKNYGQLDIFPARDTYHPMSEYPTYHTHGRYVPPSSTDRSPYEKVSAGNGGSSLSYTNPAVAATSANL	PAPGSTAPAAHGVTSAPESR,PAPGSTAPPAHGVTSAPESR
MTPGTQSPFFLLLLLTVLTVVTGSGHASSTPGGEKETSATQRSSVPSSTEKNAVSMTSSVLSSHSPGSGSSTTQGQDVTLAPATEPASGSAATWGQDVTSVPVTRPALGSTTPPAHDVTSAPDNKPAPGSTAPPAHGVTSAPDTRPAPGSTAPQAHGVTSAPDTRPAPGSTAPPAHGVTSAPDTRPAPGSTAPPAHGVTSAPDTRPAPGSTAPAAHGVTSAPDTRPAPGSTAPQAHGVTSAPDTRPAPGSTAPTAHGVTSAPDTRPAPGSTAPPAHGVTSAPDTRPAPGSTAPPAHGVTSAPESRPAPGSTAPAAHGVTSAPESRPAPGSTAPPAHGVTSAPDTRPAPGSTAPPAHGVTSAPDTRPAPGSTAPAAHGVTSAPDTRPAPGSTAPQAHGVTSAPDTRPAPGSTAPPAHGVTSAPDTRPAPGSTAPPAHGVTSAPDTRPAPGSTAPPAHGVTSAPESRPAPGSTAPAAHGVTSAPESRPAPGSTAPAAHGVTSAPESRPAPGSTAPPAHGVTSAPDTRPAPGSTAPPAHGVTSAPDTRPAPGSTAPPAHGVTSAPDTRPAPGSTAPPAHGVTSAPDTRPAPGSTAPPAHGVTSAPDTRPAPGSTAPPAHGVTSAPDTRPAPGSTAPPAHGVTSAPDTRPAPGSTAPAAHGVTSAPESRPAPGSTAPAAHGVTSAPESRPAPGSTAPPAHGVTSAPDTRPAPGSTAPPAHGVTSAPDTRPAPGSTAPPAHGVTSAPDTRPAPGSTAPPAHGVTSAPDTRPAPGSTAPPAHGVTSAPDTRPAPGSTAPPAHGVTSAPDTRPAPGSTAPPAHGVTSAPDTRPAPGSTAPPAHGVTSAPDTRPAPGSTPAPGSTAPPAHGVTSAPDTRPAPGSTAPPAHGVTSAPDNRPALGSTAPPVHNVTSASGSASGSASTLVHNGTSARATTTPASKSTPFSIPSHHSDTPTTLASHSTKTDASSTHHSTVPPLTSSNHSTSPQLSTGVSFFFLSFHISNLQFNSSLEDPSTDYYQELQRDISEMFLQIYKQGGFLGLSNIKFRPGSVVVQLTLAFREGTINVHDMETQFNQYKTEAASRYNLTISDVSVSDVPFPFSAQSGAGVPGWGIALLVLVCVLVALAIVYLIALAVCQCRRKNYGQLDIFPARDTYHPMSEYPTYHTHGRYVPPSSTDRSPYEKVSAGNGGSSLSYTNPAVAATSANL	PAPGSTAPAAHGVTSAPESR,PAPGSTAPPAHGVTSAPESR
MTPGTQSPFFLLLLLTVLTVVTGSGHASSTPGGEKETSATQRSSVPSSTEKNAVSMTSSVLSSHSPGSGSSTTQGQDVTLAPATEPASGSAATWGQDVTSVPVTRPALGSTTPPAHDVTSAPDNKPAPGSTAPPAHGVTSAPDTRPAPGSTAPQAHGVTSAPDTRPAPGSTAPPAHGVTSAPDTRPAPGSTAPPAHGVTSAPDTRPAPGSTAPAAHGVTSAPDTRPAPGSTAPQAHGVTSAPDTRPAPGSTAPPAHGVTSAPDTRPAPGSTAAPAHGVTSAPDTRPAPGSTAPPAHGVTSAPESRPAPGSTAPAAHGVTSAPESRPAPGSTAPPAHGVTSAPDTRPAPGSTAPPAHGVTSAPDTRPAPGSTAPAAHGVTSAPDTRPAPGSTAPQAHGVTSAPDTRPAPGSTAPPAHGVTSAPDTRPAPGSTAPPAHGVTSAPDTRPAPGSTAPPAHGVTSAPESRPAPGSTAPAAHGVTSAPESRPAPGSTAPAAHGVTSAPDTRPAPGSTAPPAHGVTSAPDTRPAPGSTAPPAHGVTSAPDTRPAPGSTAPPTHGVTSAPDTRPAPGSTAPPAHGVTSAPDTRPAPGSTAPAAHGVTSAPDTRPAPGSTAPQAHGVTSAPDTRPAPGSTAPPAHGVTSAPDTRPAPGSTAPPAHGVTSAPDTRPAPGSTAPPAHGVTSAPESRPAPGSTAPAAHGVTSAPESRPAPGSTAPPAHGVTSAPDTRPAPGSTAPPAHGVTSAPDTRPAPGSTAPPAHGVTSAPDTRPAPGSTAPPAHGVTSAPDTRPAPGSTAPPAHGVTSAPDTRPAPGSTAPPAHGVTSAPDTRPAPGSTAPPAHGVTSAPDTRPAPGSTAPPAHGVTSAPDTRPAPGSTAPPAHGVTSAPDTRPAPGSTAPPAHGVTSAPDTRPAPGSTPAPGSTAPPAHGVTWAPDTRPAPGSTAPPAHGVTSAPDNRPALGSTAPPVHNVTSASGSASGSASTLVHNGTSARATTTPASKSTPFSIPSHHSDTPTTLASHSTKTDASSTHHSTVPPLTSSNHSTSPQLSTGVSFFFLSFHISNLQFNSSLEDPSTDYYQELQRDISEMFLQIYKQGGFLGLSNIKFRPGSVVVQLTLAFREGTINVHDVETQFNQYKTEAASRYNLTISDVSVSDVPFPFSAQSGAGVPGWGIALLVLVCVLVALAIVYLIALAVCQCRRKNYGQLDIFPARDTYHPMSEYPTYHTHGRYVPPSSTDRSPYEKVSAGNGGSSLSYTNPAVAATSANL	PAPGSTAPAAHGVTSAPESR,PAPGSTAPPAHGVTSAPESR
MTPGTQSPFFLLLLLTVLTVVTGSGHASSTPGGEKETSATQRSSVPSSTEKNAVSMTSSVLSSHSPGSGSSTTQGQDVTLAPATEPASGSAATWGQDVTSVPVTRPALGSTTPPAHDVTSAPDNKPAPGSTAPPAHGVTSAPDTRPAPGSTAPQAHGVTSAPDTRPAPGSTAPPAHGVTSAPDTRPAPGSTAPPAHGVTSAPDTRPAPGSTAPAAHGVTSAPDTRPAPGSTAPQAHGVTSAPDTRPAPGSTAPPAHGVTSAPDTRPAPGSTAPPAHGVTSAPDTRPAPGSTAPPAHGVTSAPESRPAPGSTAPPAHGVTSAPDTRPAPGSTAPPAHGVTSAPDTRPAPGSTAPPAHGVTSAPDTRPAPGSTAPPAHGVTSAPDTRPAPGSTAPPAHGVTSAPDTRPAPGSTAPPAHGVTSAPDTRPAPGSTAPPAHGVTSAPDTRPAPGSTAPPAHGVTSAPDTRPAPGSTAPPAHGVTSAPDTRPAPGSTAPPAHGVTSAPDTRPAPGSTAPPAHGVTSAPDTRPAPGSTAPAAHGVTSAPESRPAPGSTAPPAHGVTSAPDTRPAPGSTAPPAHGVTSAPDTRPAPGSTAPPAHGVTSAPDTRPAPGSTAPPAHGVTSAPDTRPAPGSTAPPAHGVTSAPDTRPAPGSTAPPAHGVTSAPESRPAPGSTAPAAHGVTSAPESRPAPGSTAPAAHGVTSAPESRPAPGSTAPPAHGVTSAPDTRPAPGSTAPPAHGVTSAPDTRPAPGSTAPPAHGVTSAPDTRPAPGSTAPPAHGVTSAPDTRPAPGSTAPPAHGVTSAPDTRPAPGSTAPPAHGVTSAPDTRPAPGSTAPPAHGVTSAPDTRPAPGSTAPPAHGVTSAPDTRPAPGSTAPPAHGVTSAPDTRPAPGSTAPPAHGVTSAPDTRPAPGSTAPPAHGVTSAPDTRRAPGSTPAPGSTAPPAHGVTSAPDTRPAPGSTAPPAHGVTSAPDNRPALGSTAPPVHNVTSASGSASGSASTLVHNGTSARATTTPASKSTPFSIPSHHSDTPTTLASHSTKTDASSTHHSTVPPLTSSNHSTSPQLSTGVSFFFLSFHISNLQFNSSLEDPSTDYYQELQRDISEMFLQIYKQGGFLGLSNIKFRPGSVVVQLTLAFREGTINVHDVETQFNQYKTEAASRYNLTISDVSVSDVPFPFSAQSGAGVPGWGIALLVLVCVLVALAIVYLIALAVCQCRRKNYGQLDIFPARDTYHPMSEYPTYHTHGRYVPPSSTDRSPYEKVSAGNGGSSLSYTNPAVAATSANL	PAPGSTAPAAHGVTSAPESR,PAPGSTAPPAHGVTSAPESR
MTPGTQSPFFLLLLLTVLTDPTLLLLTATTAPKPATVVTGSGHASSTPGGEKETSATQRSSVPSSTEKNAVSMTSSVLSSHSPGSGSSTTQGQDVTLAPATEPASGSAATWGQDVTSVPVTRPALGSTTPPAHDVTSAPDNKPAPGSTAPPAHGVTSAPDTRPAPGSTAPQAHGVTSAPDTRPAPGSTAPPAHGVTSAPDTRPAPGSTAPPAHGVTSAPDTRPAPGSTAPAAHGVTSAPDTRPAPGSTAPQAHGVTSAPDTRPAPGSTAPPAHGVTSAPDTRPAPGSTAAPAHGVTSAPDTRPAPGSTAPPAHGVTSAPESRPAPGSTAPAAHGVTSAPESRPAPGSTAPAAHGVTSAPESRPAPGSTAPPAHGVTSAPDTRPAPGSTAPPAHGVTSAPDTRPAPGSTAPAAHGVTSAPDTRPAPGSTAPQAHGVTSAPDTRPAPGSTAPPAHGVTSAPESRPAPGSTAPAAHGVTSAPESRPAPGSTAPAAHGVTSAPESRPAPGSTAPPAHGVTSAPDTRPAPGSTAPPAHGVTSAPDTRPAPGSTAPPAHGVTSAPDTRPAPGSTAPPAHGVTSAPDTRPAPGSTAPPAHGVTSAPDTRPAPGSTAPPAHGVTSAPDTRPAPGSTAPPAHGVTSAPDTRPAPGSTAPPAHGVTSAPDTRPAPGSTAPPAHGVTSAPDTRPAPGSTAPPAHGVTSAPESRPAPGSTAPAAHGVTSAPESRPAPGSTAPAAHGVTSAPESRPAPGSTAPPAHGVTSAPDTRPAPGSTAPPAHGVTSAPDTRPAPGSTAPPAHGVTSAPDTRPAPGSTAPPAHGVTSAPDTRPAPGSTAPPAHGVTSAPDTRPAPGSTAPPAHGVTSAPDTRPAPGSTAPPAHGVTSAPDTRPAPGSTAPPAHGVTSAPDTRPAPGSTPAPGSTAPPAHGVTSAPDTRPAPGSTAPPAHGVTSAPDNRPALGSTAPPVHNVTSASGSASGSASTLVHNGTSARATTTPASKSTPFSIPSHHSDTPTTLASHSTKTDASSTHHSTVPPLTSSNHSTSPQLSTGVSFFFLSFHISNLQFNSSLEDPSTDYYQELQRDISEMFLQIYKQGGFLGLSNIKFRPGSVVVQLTLAFREGTINVHDVETQFNQYKTEAASRYNLTISDVSVSDVPFPFSAQSGAGVPGWGIALLVLVCVLVALAIVYLIALAVCQCRRKNYGQLDIFPARDTYHPMSEYPTYHTHGRYVPPSSTDRSPYEKVSAGNGGSSLSYTNPAVAATSANL	PAPGSTAPAAHGVTSAPESR,PAPGSTAPPAHGVTSAPESR
SHSPGSGSSTTQGQDVTLAPATEPASGSAATWGQDVTSVPVTRPALGSTTPPAHDVTSAPDNKPAPGSTAPPAHGVTSAPDTRPAPGSTAPQAHGVTSAPDTRPAPGSTAPPAHGVTSAPDTRPAPGSTAPPAHGVTSAPDTRPAPGSTAPAAHGVTSAPDTRPAPGSTAPQAHGVTSAPDTRPAPGSTAPTAHGVTSAPDTRPAPGSTAPPAHGVTSAPDTRPAPGSTAPPAHGVTSAPESRPAPGSTAPAAHGVTSAPESRPAPGSTAPPAHGVTSAPDTRPAPGSTAPPAHGVTSAPDTRPAPGSTAPAAHGVTSAPDTRPAPGSTAPQAHGVTSAPDTRPAPGSTAPPAHGVTSAPDTRPAPGSTAPPAHGVTSAPDTRPAPGSTAPPAHGVTSAPESRPAPGSTAPAAHGVTSAPESRPAPGSTAPAAHGVTSAPESRPAPGSTAPPAHGVTSAPDTRPAPGSTAPPAHGVTSAPDTRPAPGSTAPPAHGVTSAPDTRPAPGSTAPPAHGVTSAPDTRPAPGSTAPPAHGVTSAPDTRPAPGSTAPPAHGVTSAPDTRPAPGSTAPPAHGVTSAPDTRPAPGSTAPPAHGVTSAPESRPAPGSTAPAAHGVTSAPESRPAPGSTAPPAHGVTSAPESRPAPGSTAPPAHGVTSAPDTRPAPGSTAPPAHGVTSAPDTRPAPGSTAPPAHGVTSAPDTRPAPGSTAPPAHGVTSAPDTRPAPGSTAPPAHGVTSAPDTRPAPGSTAPPAHGVTSAPDTRPAPGSTAPPAHGVTSAPDTRPAPGSTPAPGSTAPPAHGVTSAPDTRPAPGSTAPPAHGVTSAPDNRPALGSTAPPVHNVTSASGSASGSASTLVHNGTSARATTTPASKSTPFSIPSHHSDTPTTLASHSTKTDASSTHHSTVPPLTSSNHSTSPQLSTGVSFFFLSFHISNLQFNSSLEDPSTDYYQELQRDISEMFLQIYKQGGFLGLSNIKFRPGSVVVQLTLAFREGTINVHDVETQFNQYKTEAASRYNLTISDVSVSDVPFPFSAQSGAGVPGWGIALLVLVCVLVALAIVYLIALAVCQCRRKNYGQLDIFPARDTYHPMSEYPTYHTHGRYVPPSSTDRSPYEKVSAGNGGSSLSYTNPAVAATSANL	PAPGSTAPAAHGVTSAPESR,PAPGSTAPPAHGVTSAPESR
MTPGTQSPFFLLLLLTVLTVVTGSGHASSTPGGEKETSATQRSSVPSSTEKNAVSMTSSVLSSHSPGSGSSTTQGQDVTLAPATEPASGSAATWGQDVTSVPVTRPALGSTTPPAHDVTSAPDNKPAPGSTAPPAHGVTSAPDTRPAPGSTAPQAHGVTSAPDTRPAPGSTAPPAHGVTSAPDTRPAPGSTAPPAHGVTSAPDTRPAPGSTAPAAHGVTSAPDTRPAPGSTAPQAHGVTSAPDTRPAPGSTAPPAHGVTSAPDTRPAPGSTAPPAHGVTSAPDTRPAPGSTAPPAHGVTSAPESRPAPGSTAPAAHGVTSAPDTRPAPGSTAPPAHGVTSAPDTRPAPGSTAPPAHGVTSAPESRPAPGSTAPAAHGVTSAPESRPAPGSTAPAAHGVTSAPESRPAPGSTAPPAHGVTSAPDTRPAPGSTAPPAHGVTSAPDTRPAPGSTAPPAHGVTSAPDTRPAPGSTAPPAHGVTSAPDTRPAPGSTAPPAHGVTSAPESRPAPGSTAPPAHGVTSAPESRPAPGSTAPPAHGVTSAPDTRPAPGSTAPPAHGVTSAPDTRPAPGSTAPPAHGVTSAPDTRPAPGSTAPAAHGVTSAPESRPAPGSTAPAAHGVTSAPDTRPAPGSTAPPAHGVTSAPDTRPAPGSTAPPAHGVTSAPESRPAPGSTAPPAHGVTSAPESRPAPGSTAPAAHGVTSAPESRPAPGSTAPAAHGVTSAPDTRPAPGSTAPPAHGVTSAPDTRPAPGSTAPPAHGVTSAPDTRPAPGSTAPPAHGVTSAPDTRPAPGSTAPPTHGVTSAPDTRPAPGSTAPPAHGVTSAPDTRPAPGSTAPPAHGVTSAPDTRPAPGSTAPPAHGVTSAPDTRPAPGSTAPPAHGVTSAPDTRPAPGSTAPPAHGVTSAPDTRRAPGSTPAPGSTAPPAHGVTSAPDTRPAPGSTAPPAHGVTSAPDNRPALGSTAPPVHNVTSASGSASGSASTLVHNGTSARATTTPASKSTPFSIPSHHSDTPTTLASHSTKTDASSTHHSTVPPLTSSNHSTSPQLSTGVSFFFLSFHISNLQFNSSLEDPSTDYYQELQRDISEMFLQIYKQGGFLGLSNIKFRPGSVVVQLTLAFREGTINVHDVETQFNQYKTEAASRYNLTISDVSVSDVPFPFSAQSGAGVPGWGIALLVLVCVLVALAIVYLIALAVCQCRRKNYGQLDIFPARDTYHPMSEYPTYHTHGRYVPPSSTDRSPYEKVSAGNGGSSLSYTNPAVAATSANL	PAPGSTAPAAHGVTSAPESR,PAPGSTAPPAHGVTSAPESR
MTPGTQSPFFLLLLLTVLTVVTGSGHASSTPGGEKETSATQRSSVPSSTEKNAVSMTSSVLSSHSPGSGSSTTQGQDVTLAPATEPASGSAATWGQDVTSVPVTRPALGSTTPPAHDVTSAPDNKPAPGSTAPPAHGVTSAPDTRPAPGSTAPQAHGVTSAPDTRPAPGSTAPPAHGVTSAPDTRPAPGSTAPPAHGVTSAPDTRPAPGSTAPAAHGVTSAPDTRPAPGSTAPQAHGVTSAPDTRPAPGSTAPTAHGVTSAPDTRPAPGSTAPPAHGVTSAPDTRPAPGSTAPPAHGVTSAPESRPAPGSTAPAAHGVTSAPESRPAPGSTAPPAHGVTSAPDTRPAPGSTAPPAHGVTSAPDTRPAPGSTAPAAHGVTSAPDTRPAPGSTAPQAHGVTSAPDTRPAPGSTAPPAHGVTSAPDTRPAPGSTAPPAHGVTSAPDTRPAPGSTAPPAHGVTSAPESRPAPGSTAPAAHGVTSAPESRPAPGSTAPAAHGVTSAPESRPAPGSTAPPAHGVTSAPDTRPAPGSTAPPAHGVTSAPDTRPAPGSTAPPAHGVTSAPDTRPAPGSTAPPAHGVTSAPDTRPAPGSTAPPAHGVTSAPDTRPAPGSTAPPAHGVTSAPDTRPAPGSTAPAAHGVTSAPESRPAPGSTAPAAHGVTSAPESRPAPGSTAPPAHGVTSAPDTRPAPGSTAPPAHGVTSAPDTRPAPGSTAPPAHGVTSAPDTRPAPGSTAPPAHGVTSAPDTRPAPGSTAPPAHGVTSAPDTRPAPGSTAPPAHGVTSAPDTRPAPGSTAPPAHGVTSAPDTRPAPGSTAPPAHGVTSAPDTRPAPGSTAPPAHGVTSAPDTRPAPGSTAPPAHGVTSAPDNRPALGSTAPPVHNVTSASGSASGSASTLVHNGTSARATTTPASKSTPFSIPSHHSDTPTTLASHSTKTDASSTHHSTVPPLTSSNHSTSPQLSTGVSFFFLSFHISNLQFNSSLEDPSTDYYQELQRDISEMFLQIYKQGGFLGLSNIKFRPGSVVVQLTLAFREGTINVHDVETQFNQYKTEAASRYNLTISDVSVSDVPFPFSAQSGAGVPGWGIALLVLVCVLVALAIVYLIALAVCQCRRKNYGQLDIFPARDTYHPMSEYPTYHTHGRYVPPSSTDRSPYEKVSAGNGGSSLSYTNPAVAATSANL	PAPGSTAPAAHGVTSAPESR,PAPGSTAPPAHGVTSAPESR
MTPGTQSPFFLLLLLTVLTVVTGSGHASSTPGGEKETSATQRSSVPSSTEKNAVSMTSSVLSSHSPGSGSSTTQGQDVTLAPATEPASGSAATWGQDVTSVPVTRPALGSTTPPAHDVTSAPDNKPAPGSTAPPAHGVTSAPDTRPAPGSTAPQAHGVTSAPDTRPAPGSTAPPAHGVTSAPDTRPAPGSTAPPAHGVTSAPDTRPAPGSTAPAAHGVTSAPDTRPAPGSTAPQAHGVTSAPDTRPAPGSTAPPAHGVTSAPDTRPAPGSTAPPAHGVTSAPDTRPAPGSTAPPAHGVTSAPESRPAPGSTAPHAHGVTSAPESRPAPGSTAPPAHGVTSAPDTRPAPGSTAPPAHGVTSAPDTRPAPGSTAPAAHGVTSAPDTRPAPGSTAPQAHGVTSAPDTRPAPGSTAPPAHGVTSAPDTRPAPGSTAPPAHGVTSAPDTRPAPGSTAPPAHGVTSAPDTRPAPGSTAPPAHGVTSAPDTRPAPGSTAPPAHGVTSAPDTRPAPGSTAPPAHGVTSAPDTRPAPGSTAPPAHGVTSAPESRPAPGSTAPAAHGVTSAPESRPAPGSTAPAAHGVTSAPESRPAPGSTAPPAHGVTSAPDTRPAPGSTAPPAHGVTSAPDTRPAPGSTAPPAHGVTSAPDTRPAPGSTAPPAHGVTSAPDTRPAPGSTAPPAHGVTSAPDTRPAPGSTAPPAHGVTSAPDTRPAPGSTAPPAHGVTSAPDTRPAPGSTAPPAHGVTSAPDTRPAPGSTAPPAHGVTSAPDTRPAPGSTPAPGSTAPPAHGVTSAPDTRPAPGSTAPPAHGVTSAPDNRPALGSTAPPVHNVTSASGSASGSASTLVHNGTSARATTTPASKSTPFSIPSHHSDTPTTLASHSTKTDASSTHHSTVPPLTSSNHSTSPQLSTGVSFFFLSFHISNLQFNSSLEDPSTDYYQELQRDISEMFLQIYKQGGFLGLSNIKFRPGSVVVQLTLAFREGTINVHDVETQFNQYKTEAASRYNLTISDVSVSDVPFPFSAQSGAGVPGWGIALLVLVCVLVALAIVYLIALAVCQCRRKNYGQLDIFPARDTYHPMSEYPTYHTHGRYVPPSSTDRSPYEKVSAGNGGSSLSYTNPAVAATSANL	PAPGSTAPAAHGVTSAPESR,PAPGSTAPPAHGVTSAPESR
MTPGTQSPFFLLLLLTVLTVVTGSGHASSTPGGEKETSATQRSSVPSSTEKNAVSMTSSVLSSHSPGSGSSTTQGQDVTLAPATEPASGSAATWGQDVTSVPVTRPALGSTTPPAHDVTSAPDNKPAPGSTAPPAHGVTSAPDTRPAPGSTAPQAHGVTSAPDTRPAPGSTAPPAHGVTSAPDTRPAPGSTAPPAHGVTSAPDTRPAPGSTAPAAHGVTSAPDTRPAPGSTAPQAHGVTSAPDTRPAPGSTAPTAHGVTSAPDTRPAPGSTAPPAHGVTSAPDTRPAPGSTAPPESRPAPGSTAPPAHGVTSAPDTRPAPGSTAPPAHGVTSAPDTRPAPGSTAPAAHGVTSAPDTRPAPGSTAPQAHGVTSAPDTRPAPGSTAPPAHGVTSAPDTRPAPGSTAPPAHGVTSAPDTRPAPGSTAPPAHGVTSAPDTRPAPGSTAPPAHGVTSAPDTRPAPGSTAPPAHGVTSAPDTRPAPGSTAPPAHGVTSAPDTRPAPGSTAPPAHGVTSAPDTRPAPGSTAPPAHGVTSAPDTRPAPGSTAPPAHGVTSAPESRPAPGSTAPAAHGVTSAPESRPAPGSTAPPAHGVTSAPDTRPAPGSTAPPAHGVTSAPDTRPAPGSTAPPAHGVTSAPDTRPAPGSTAPPAHGVTSAPDTRPAPGSTAPPAHGVTSAPDTRPAPPPAHGVTSAPDTRPAPGSTAPPAHGVTSAPDTRPAPGSTAPPAHGVTSAPDTRPAPGSTPAPGSTAPPAHGVTSAPDTRPAPGSTAPPAHGVTSAPDNRPALGSTAPPVHNVTSASGSASGSASTLVHNGTSARATTTPASKSTPFSIPSHHSDTPTTLASHSTKTDASSTHHSTVPPLTSSNHSTSPQLSTGVSFFFLSFHISNLQFNSSLEDPSTDYYQELQRDISEMFLQIYKQGGFLGLSNIKFRPGSVVVQLTLAFREGTINVHDVETQFNQYKTEAASRYNLTISDVSVSDVPFPFSAQSGAGVPGWGIALLVLVCVLVALAIVYLIALAVCQCRRKNYGQLDIFPARDTYHPMSEYPTYHTHGRYVPPSSTDRSPYEKVSAGNGGSSLSYTNPAVAATSANL	PAPGSTAPAAHGVTSAPESR,PAPGSTAPPAHGVTSAPESR
MTPGTQSPFFLLLLLTVLTVVTGSGHASSTPGGEKETSATQRSSVPSSTEKNAVSMTSSVLSSHSPGSGSSTTQGQDVTLAPATEPASGSAATWGQDVTSVPVTRPALGSTTPPAHDVTSAPDNKPAPGSTAPPAHGVTSAPDTRPAPGSTAPQAHGVTSAPDTRPAPGSTAPPAHGVTSAPDTRPAPGSTAPPAHGVTSAPDTRPAPGSTAPAAHGVTSAPDTRPAPGSTAPQAHGVTSAPDTRPAPGSTAPPAHGVTSAPDTRPAPGSTAAPAHGVTSAPDTRPAPGSTAPPAHGVTSAPESRPAPGSTAPAAHGVTSAPESRPAPGSTAPAAHGVTSAPDTRPAPGSTAPPAHGVTSAPDTRPAPGSTAPAAHGVTSAPDTRPAPGSTAPQAHGVTSAPDTRPAPGSTAPPAHGVTSAPESRPAPGSTAPPAHGVTSAPDTRPAPGSTAPPAHGVTSAPESRPAPGSTAPAAHGVTSAPESRPAPGSTAPAAHGVTSAPESRPAPGSTAPPAHGVTSAPDTRPAPGSTAPPAHGVTSAPDTRPAPGSTAPPAHGVTSAPDTRPAPGSTAPPAHGVTSAPDTRPAPGSTAPPAHGVTSAPDTRPAPGSTAPPAHGVTSAPDTRPAPGSTAPPAHGVTSAPDTRPAPGSTAPPAHGVTSAPDTRPAPGSTAPPAHGVTSAPDTRPAPGSTAPAAHGVTSAPDTRPAPGSTAPQAHGVTSAPDTRPAPGSTAPPAHGVTSAPDTRPAPGSTAPPAHGVTSAPDTRPAPGSTAPPTHGVTSAPDTRPAPGSTAPPAHGVTSAPDTRPAPGSTAPPAHGVTSAPDTRPAPGSTAPPAHGVTSAPDTRPAPGSTAPPAHGVTSAPDTRPAPGSTAPPAHGVTSAPDTRPAPGSTAPPAHGVTSAPDTRPAPGSTPAPGSTASPAHGVTSAPDTRPAPGSTAPPAHGVTSAPDNRPALGSTAPPVHNVTSASGSASGSASTLVHNGTSARATTTPASKSTPFSIPSHHSDTPTTLASHSTKTDASSTHHSTVPPLTSSNHSTSPQLSTGVSFFFLSFHISNLQFNSSLEDPSTDYYQELQRDISEMFLQIYKQGGFLGLSNIKFRPGSVVVQLTLAFREGTINVHDVETQFNQYKTEAASRYNLTISDVSVSDVPFPFSAQSGAGVPGWGIALLVLVCVLVALAIVYLIALAVCQCRRKNYGQLDIFPARDTYHPMSEYPTYHTHGRYVPPSSTDRSPYEKVSAGNGGSSLSYTNPAVAATSANL	PAPGSTAPAAHGVTSAPESR,PAPGSTAPPAHGVTSAPESR
VTGSGHASSTPGGEKETSATQRSSVPSSTEKNAVSMTSSVLSSHSPGSGSSTTQGQDVTLAPATEPASGSAATWGQDVTSVPVTRPALGSTTPPAHDVTSAPDNKPAPGSTAPPAHGVTSAPDTRPAPGSTAPQAHGVTSAPDTRPAPGSTAPPAHGVTSAPDTRPAPGSTAPPAHGVTSAPDTRPAPGSTAPAAHGVTSAPDTRPAPGSTAPQAHGVTSAPDTRPAPGSTAPPAHGVTSAPDTRPAPGSTAPPAHGVTSAPDTRPAPGSTAPPAHGVTSAPESRPAPGSTAPAAHGVTSAPESRPAPGSTAPPAHGVTSAPDTRPAPGSTAPPAHGVTSAPDTRPAPGSTAPAAHGVTSAPDTRPAPGSTAPQAHGVTSAPDTRPAPGSTAPPAHGVTSAPDTRPAPGSTAPPAHGVTSAPDTRPAPGSTAPPAHGVTSAPESRPAPGSTAPAAHGVTSAPESRPAPGSTAPAAHGVTSAPESRPAPGSTAPPAHGVTSAPDTRPAPGSTAPPAHGVTSAPDTRPAPGSTAPPAHGVTSAPDTRPAPGSTAPPAHGVTSAPDTRPAPGSTAPPAHGVTSAPDTRPAPGSTAPPAHGVTSAPDTRPAPGSTAPAAHGVTSAPESRPAPGSTAPAAHGVTSAPESRPAPGSTAPPAHGVTSAPDTRPAPGSTAPPAHGVTSAPDTRPAPGSTAPPAHGVTSAPDTRPAPGSTAPPAHGVTSAPDTRPAPGSTAPPAHGVTSAPDTRPAPGSTAPPAHGVTSAPDTRPAPGSTAPPAHGVTSAPDTRPAPGSTAPPAHGVTSAPDTRPAPGSTPAPGSTAPPAHGVTSAPDTRPAPGSTAPPAHGVTSAPDNRPALGSTAPPVHNVTSASGSASGSASTLVHNGTSARATTTPASKSTPFSIPSHHSDTPTTLASHSTKTDASSTHHSTVPPLTSSNHSTSPQLSTGVSFFFLSFHISNLQFNSSLEDPSTDYYQELQRDISEMFLQIYKQGGFLGLSNIKFRPGSVVVQLTLAFREGTINVHDVETQFNQYKTEAASRYNLTISDVSVSDVPFPFSAQSGAGVPGWGIALLVLVCVLVALAIVYLIALAVCQCRRKNYGQLDIFPARDTYHPMSEYPTYHTHGRYVPPSSTDRSPYEKVSAGNGGSSLSYTNPAVAATSANL	PAPGSTAPAAHGVTSAPESR,PAPGSTAPPAHGVTSAPESR
VTGSGHASSTPGGEKETSATQRSSVPSSTEKNAVSMTSSVLSSHSPGSGSSTTQGQDVTLAPATEPASGSAATWGQDVTSVPVTRPALGSTTPPAHDVTSAPDNKPAPGSTAPPAHGVTSAPDTRPAPGSTAPQAHGVTSAPDTRPAPGSTAPPAHGVTSAPDTRPAPGSTAPPAHGVTSAPDTRPAPGSTAPAAHGVTSAPDTRPAPGSTAPQAHGVTSAPDTRPAPGSTAPTAHGVTSAPDTRPAPGSTAPPAHGVTSAPDTRPAPGSTAPPAHGVTSAPESRPAPGSTAPAAHGVTSAPESRPAPGSTAPPAHGVTSAPDTRPAPGSTAPPAHGVTSAPDTRPAPGSTAPAAHGVTSAPDTRPAPGSTAPQAHGVTSAPDTRPAPGSTAPPAHGVTSAPDTRPAPGSTAPPAHGVTSAPDTRPAPGSTAPPAHGVTSAPESRPAPGSTAPAAHGVTSAPESRPAPGSTAPAAHGVTSAPESRPAPGSTAPPAHGVTSAPDTRPAPGSTAPPAHGVTSAPDTRPAPGSTAPPAHGVTSAPDTRPAPGSTAPPAHGVTSAPDTRPAPGSTAPPAHGVTSAPDTRPAPGSTAPPAHGVTSAPDTRPAPGSTAPAAHGVTSAPESRPAPGSTAPAAHGVTSAPESRPAPGSTAPPAHGVTSAPDTRPAPGSTAPPAHGVTSAPDTRPAPGSTAPPAHGVTSAPDTRPAPGSTAPPAHGVTSAPDTRPAPGSTAPPAHGVTSAPDTRPAPGSTAPPAHGVTSAPDTRPAPGSTAPPAHGVTSAPDTRPAPGSTAPPAHGVTSAPDTRPAPGSTPAPGSTAPPAHGVTSAPDTRPAPGSTAPPAHGVTSAPDNRPALGSTAPPVHNVTSASGSASGSASTLVHNGTSARATTTPASKSTPFSIPSHHSDTPTTLASHSTKTDASSTHHSTVPPLTSSNHSTSPQLSTGVSFFFLSFHISNLQFNSSLEDPSTDYYQELQRDISEMFLQIYKQGGFLGLSNIKFRPGSVVVQLTLAFREGTINVHDVETQFNQYKTEAASRYNLTISDVSVSDVPFPFSAQSGAGVPGWGIALLVLVCVLVALAIVYLIALAVCQCRRKNYGQLDIFPARDTYHPMSEYPTYHTHGRYVPPSSTDRSPYEKVSAGNGGSSLSYTNPAVAATSANL	PAPGSTAPAAHGVTSAPESR,PAPGSTAPPAHGVTSAPESR
MTPGTQSPFFLLLLLTVLTVVTGSGHASSTPGGEKETSATQRSSVPSSTEKNAVSMTSSVLSSHSPGSGSSTTQGQDVTLAPATEPASGSAATWGQDVTSVPVTRPALGSTTPPAHDVTSAPDNKPAPGSTAPPAHGVTSAPDTRPAPGSTAPQAHGVTSAPDTRPAPGSTAPPAHGVTSAPDTRPAPGSTAPPAHGVTSAPDTRPAPGSTAPAAHGVTSAPDTRPAPGSTAPQAHGVTSAPDTRPAPGSTAPPAHGVTSAPDTRPAPGSTAPPAHGVTSAPDTRPAPGSTAPPAHGVTSAPDTRPAPGSTAPPAHGVTSAPDTRPAPGSTAPPAHGVTSAPDTRPAPGSTAPPAHGVTSAPESRPAPGSTAPAAHGVTSAPESRPAPGSTAPAAHGVTSAPDTRPAPGSTAPPAHGVTSAPDTRPAPGSTAPPAHGVTSAPDTRPAPGSTAPPAHGVTSAPDTRPAPGSTAPPAHGVTSAPDTRPAPGSTAPPAHGVTSAPDTRPAPGSTAPPAHGVTSAPDTRPAPGSTAPPAHGVTSAPDTRPAPGSTAPPAHGVTSAPDTRPAPGSTAPPAHGVTSAPDTRPAPGSTAPPAHGVTSAPDTRPAPGSTAPPAHGVTSAPDTRPAPGSTAPPAHGVTSAPDTRPAPGSTAPPAHGVTSAPDTRPAPGSTAPPAHGVTSAPDTRPAPGSTAPAAHGVTSAPESRPAPGSTAPAAHGVTSAPESRPAPGSTAPPAHGVTSAPDTRPAPGSTAPPAHGVTSAPDTRPAPGSTAPPAHGVTSAPDTRPAPGSTAPPAHGVTSAPDTRPAPGSTAPPAHGVTSAPDTRPAPGSTAPPAHGVTSAPDTRPAPGSTAPPAHGVTSAPDTRPAPGSTAPPAHGVTSAPDTRPAPGSTAPPAHGVTSAPDTRRAPGSTRAPGSTAPPAHGVTSAPDTRPAPGSTAPPAHGVTSAPDNRPALGSTAPPVHNVTSASGSASGSASTLVHNGTSARATTTPASKSTPFSIPSHHSDTPTTLASHSTKTDASSTHHSTVPPLTSSNHSTSPQLSTGVSFFFLSFHISNLQFNSSLEDPSTDYYQELQRDISEMFLQIYKQGGFLGLSNIKFRPGSVVVQLTLAFREGTINVHDVETQFNQYKTEAASRYNLTISDVSVSDVPFPFSAQSGAGVPGWGIALLVLVCVLVALAIVYLIALAVCQCRRKNYGQLDIFPARDTYHPMSEYPTYHTHGRYVPPSSTDRSPYEKVSAGNGGSSLSYTNPAVAATSANL	PAPGSTAPAAHGVTSAPESR,PAPGSTAPPAHGVTSAPESR
MVFRRFVEVGRVAYVSFGPHAGKLVAIVDVIDQNRALVDGPCTQVRRQAMPFKCMQLTDFILKFPHSAHQKYVRQAWQKADINTKWAATRWAKKIEARERKAKMTDFDRFKVMKAKKMRNRIIKNEVKKLQKAALLKASPKKAPGTKGTAAAAAAAAAAAAKVPAKKITAASKKAPAQKVPAQKATGQKAAPAPKAQKGQKAPAQKAPAPKASGKKA	GTAAAAAAAAAAAAK,KAPGTKGTAAAAAAAAAAAAK
AILKGVQCEVQLVESAGGLVQPGGSLRLSCAASGFTCSNAWMSWVRQAPGKGLEWVGCIKSKANGGTTDYAAPVKGRFTISRVDSKNTLYLQMNSLKTEDTAVYYCTTGGGV	SKANGGTTDYAAPVK,ANGGTTDYAAPVK
AILKGVQCEVQLVESAGGLVQPGGSLRLSCAASGFTCSNAWMSWVRQAPGKGLEWVGRIKSKANGGTTDYAAPVKGRFTISRVDSKNTLYLQMNSLKTEDTAVYYCTTGGGV	SKANGGTTDYAAPVK,ANGGTTDYAAPVK
