gene_symbol	peps	Count
PWP2	GNLNFTCNGNSVISPVGNR	1
Pwp2	GNLNFTCNGNSVISPVGNR	1
IGLV3-25	ITCSADALPK,ITCSGDALPKPYAYWYQQKPGQAPVLVIYK	2
DDX51	NVIEDLVPIEDIPDVHPDLQK	1
ADGRG5	GVPQAGGQHAR	1
MYO7A	GDFPTDCVYVMPTVTMPPR	1
DDX60	HGDVHFDHFHPCAALTTDHIER	1
SYNPO2	TEVPLAENQSGPDCAASLKEETGPSYQR,TEVPLAENQSGPDCAASLK,SYIEVSHGLGHVPQQNGFSGASETANIQR,YMVDSDTVQAHAAR,TQCTEFFLAPVKTEVPLAENQSGPDCAGSLKEETGPSYQR,TQCTEFFLAPVKTEVPLAENQSGPDCAASLK,TQCTEFFLAPVKTEVPLAENQSGPDCAASLKEETGPSYQR,QSRMEKYMVDSDTVQAHAAR,TEVPLAENQSGPDCAGSLK,TEVPLAENQSGPDCAGSLKEETGPSYQR,YVVDSDTVQAHASRAQSPTPSLPASWK	11
AKAP12	EGEDPQASAQDETPITSAK,VSVAIEEDLEPENGILELETK,EKTEAEPTHVNKEK,EGEDPQASAQDETPITSAKEESESTAVGQAHSDISK,AATEVSKELSECQVHMMAAAVADGTR,KDEGEGAAGAGDHQDPSLGAGEAASK,ADSQDAGQETEKEGEDPQASAQDETPITSAK,DEGEGAAGAGDHQDPSLGAGEAASKESEPK,KDEGEGAAGAGDHQDPSLGAGEAASKESEPK,TEETATEMLTSELQTQAHMIK,DEGEGAAGAGDHQDPSLGAGEAASK,ELSECQVHMMAAAVADGTR,TEAEPTHVNKEK	13
PCDHB3	VVAVDSDSGQNAWLSYQLLK	1
TTC4	GGFHEDQWEKEFEKVPLFMTR	1
STK31	MTLDLNDENDAGNLITFPK,KMTLDLNDENDAGNLITFPK,IPSVDHLLSIK	3
MTRR	GQEEISGALPVASPASLR	1
IGHV2-70	IDWDDDKYSTSLKTR,NQVVLTMTNMDPVDTGTYYCAR,IDWDDEKYYSTSLK,ALEWLARIDWDDDKYSTSLK	4
DMD	DQAANLMANHGDHCRK,DQAANLMANHGDHCR,AEEWLKLLLEYQK,KQAEVVDTEWEK,NQLEIYNQPNQEGPFDVQETEIAVQAK,QAEVVDTEWEKLNLHSADWQR	6
ZFPM1	AAPQNGGSSEPPAAPR	1
PCK1	MGTPVLEALGDGEFVK,EEGWLAEHMLVLGITNPEGEK,LAKEEGWLAEHMLVLGITNPEGEKK,NTIFTNVAETSDGGIYWEGIDEPLASGVTITSWK,EEGWLAEHMLILGITNPEGK,EEGWLAEHMLVLGITNPEGEKK	6
SRA1	SPPVGSGPASGVEPTSFPVESEAR	1
C17orf58	EGQIQGAVHTQCI,AAEVAPAVR	2
MLC1	LQGASWDTQSGPQER	1
DDX5	LLQLVEDRGAGR	1
CSRP1	TVYFAEEVQCEGDSFHK	1
LPCAT1	QALPAEAAILTLAPHSSYFDAIPVTMTMSSIVMK,TYGAQEDGSVGEGDLSCILK	2
NLRP2	VEGFLEEDKR	1
IGHG2	GFYPSDIAVEWESNGQPENNYKTTPPMLDSDGSFFLYSK,EPQVYTLTPSREEMTK,SRWQQGNIFSCSVMHEALHNHYTQK,DTLMISRTPEVTCVVVDVSHEDPEVQFNWYVDGMEVHNAK,TTPPMLDSDSSFFLYSKLTVDK,TTPPMLDSDSSFFLYSKLTVDKSR,WQQGNIFSCSVMHEALHNHYTQK,TPEVTCVVVDVSHEDPEVQFNWYVDGMEVHNAK	8
IGHG4	TYTCNIDHKPSNTKVDK,SRWQQGNIFSCSVMHEALHNHYTQK,TYTCNIDHKPSNTK,EPQVYTLPPSPEEMTK,GPSVFPLAPYSRSTSESTAALGCLVK,VVSVLTILHQDWLNGK,WQQGNIFSCSVMHEALHNHYTQK	7
IGHG3	GFYPSDIAMEWESSGQPENNYKTTPPVLDSDGSFFLYSK,DTLMISRTPEVTCVVVDVSHQDPEVQFK,GFYPSDIAVEWESSGQPENNYK,WQEGNIFSCSVMHEALHNR,TPEVTCVVVDVSHQDPEVQFKWYVDGVEVHNAK,PAQASPSSSSSSSAPELLGGPSVFLFPPKPK,GFYPSDIAMEWESSGQPENNYK,SRWQQGNIFSCSVMHEALHNHYTQK,TKPWEEQYNSTFRVVSVLTVLHQDWLNGK,NQVSLTCLVKGFYPSDIAMEWESSGQPENNYK,TPEVTCVVVDVSHQDPEVQFK,WQQGNIFSCSVMHEALHNHYTQK,CPGKPAQASPSSSSSSSAPELLGGPSVFLFPPKPK	13
TNKS1BP1	APVIRPGGTLGLSEAADSDAR,YESQEPLAGQESPLSLATR,YPARPPPSGSQGLLEEMLAASSSK,VPSSDEEVAEEPQSR,SSQFGIIGNDR,SSPCHSQLLEAQTPEASQASPCPAVTPSAR	6
CYP2A7	TLDPNSPQDFIDSFLIR	1
HADHA	MVGVPASLDMMLTGR	1
TRDN	AKEEIGAVSSK	1
KRT13	RDAEEWFHAK,DAEEWFHAK	2
CC2D1A	WLVIEPVPAAVPTQVAGPK,IREPLTAQQLEMTTER	2
ZMYM5	HEESEMHINNSVK	1
FLG	RQGSSVSQDSDSQGHSEDSER,RPGSSVSQDSDSEGHSEDSER,HTQTSSGGQAASSHEQARSSAGDRHGSHHQQSADSSR,TSRPRGSSVSQDSDSQGHSEDSER,ETRNEEQSGDGSRHSGSCHHEASTQADSSR,PRGSSVSQDSDSQGHSEDSER,HSAYQDGQDTIRGHPGSSR,TSRNRGSSFSQDSDSQGHSEDSER,HSAYQDGQDTIR,GSSVSQDSDSQGHSEDSERR,HGSHHQQSANSSRHSGIGHGQASSAVR,DSGHRGYSGSQATDSEGHSEDSDTQSVSAQGK,GYSGSQVTNSEGHSEDSDTQSVSAHGQAGPHQQSHK,NHLGSAWEESRDGSR,NSSRHSASQEGQDTIR,GSSGTQASDSEGHSEDSDTQSVSAHGQAGPHQQSHQQSTR,GYSGSQATDSEGHSEDSDTQSVSGHGQAGHHQQSHQESAR,GSSGSQASDSEGHSEDSDTQSVSAHGQAGPHQQSHQQSTR,GYSGSQATDSEGHSEDSDTQSVSAQGK,QGSHYEQSVDRSGHSGSHHSHTTSQGRSDASHGQSGSR,HTQTSSGGQAASSHEQARSSAGDR,QGSSVSQDSDSQGHSEDSERR,HTQNSSSGQAASSHEQARSSAGERHGSCHQLQSADSSR,HSASQEGQDTIRAHPGSSR,HSQSGQGQSAGPSTSRNQGSSVSQDSDSQGHSEDSER,HSVSQEGQDTIRGHPGSSR	26
OSBPL10	DLVHAIESLPGSGPLTALDQDLLLLK	1
EEF2K	YSSSGSAANSFHFK	1
GC	LKAKLPDATPK,LPDATPKELAK,AKLPDATPK,RSDFASNCCSINSPPLYCDSEIDAELKNIL,AKLPEATPTELAK,LPEATPTELAK,LKAKLPEATPTELAK,AKLPDATPKELAK,RSDFASNCCSINSPPLYCDSEIDAELK	9
CHID1	DHRPQMVWDSQVSEHFFEYK,DHRPQMVWDSQVSEHFFEYKK,MVWDSQVSEHFFEYK	3
SYNM	AIDCLEDEKATLTLAMADWLR,FRLGTSDATGSLQGDSMTETIAENIVTSILK,VVNVEIVEEPVSYVSGEKLEEFSVPFK,ENEWNLFSR,ELYIPLGESEVAGGASHSSGQR,SYHYTDSLLQRENEWNLFSR,STFQSVVSESPQEDSAGDTSGAEMTSGVSR,VELGVIGNSVHMEGLPGSSTSIR,VVNVKIVEEPVSYVSGEKPEEFSVPFK,EGFSGQIQFTAPLSDKVELGVIGNSVHMEGLPGSSTSIR,ALLEGESNPEIVIWAEHIENMPSEFR,LGTSDATGSLQGDSMTETIAENIVTSILK	12
XPC	AAASHLFPFEK,AAASHLFPFEKL,DPSLPVASSSSSSSK	3
ALDH5A1	RVYGDIIYTPAKDR,VYGDIIYTPAKDR,VYGDIIYTPAK,NFFEPTLLCNVTQDMLCTQEETFGPLAPVIK,RVYGDIIYTPAK	5
FN1	QAQQMVQPQAPVAVSQSKPGCYDNGKHYQINQQWER,QAQQMVQPQAPVAVSQSKPGCYDNGK,GATYNIIVEALKDQQR,GATYNIIVEALKDQQRHK,GATYNIIVEALK	5
MCEE	AAAFYKNILGAQVSEVVPLPEHGVSVVFVNLGNTK,MELLHPLGLDSPIAGFLQK,NILGAQVSEVVPLPEHGVSVVFVNLGNTK	3
HEXA	DFYVVEPLAFEGTPEQK,ISYGPDWKDFYVVEPLAFEGTPEQK,EDIPVDYMK	3
RALGAPA2	SSSTSNIPEPLCSDSSQGQK,VLYGPLEGCLAPSGR	2
PCMT1	ELVDDSINNVR,MVGCTGKVIGIDHIKELVDDSINNVR,ELVDDSINNVRKDDPTLLSSGR,VIGIDHIKELVDDSINNVR,ELVDDSINNVRK,VIGIDHIKELVDDSINNVRK	6
ERC1	LYIGHLTALCHDRDPLILR	1
SKIV2L	VFTTLVLCDKPLSQDPQNRGPATAEVPYPDDLVGFK,RPPGPASQSLWGNPTR,VFTTLVLCDKPLSQDPQNR	3
MYOM3	EDEGLYTVR,SMFGPSVEFTSVLKPVFAR,TYLGKDAGFHSEIFKR,GLVEVTIQNLSEEDKGSYTAQLQDGK,DAGFHSEIFK,DAGFHSEIFKR,VSCTYKEDEGLYTVR,QGPYFEQPLQWK,KQGPYFEQPLQWK	9
C2CD2	ALGEDQVAETSAMSDALKDILK	1
ALDH1L1	EGATLVCGGNQVPRPGFFFEPTVFTGVEDHMFIAK,EESFGPVMIVSR,LTFFNSTLNTSGPVPEGDALPIPGAHRPGVVTK,PGFFFEPTVFTGVEDHMFIAK,LRGDDEEGECSIDYMEMAVNKR,LMKYCQHGVK	6
IGHV3-64D	NSLYLQMNSLRAEDMALYYCAK,GLEWVSGISWNSGSIGYADSVK,AEDMALYYCAK	3
MAP4	TSDMAPSKETEMALAKDMALATK,TSDMAPSKETEMALAK,GISEDSHLESLQDVGQSAAPTFMISPETITGTGK,GISEDSHLESLQDVGQSAAPTFMISPETITGTGKK,VALSSQTEVALAR	5
ETFA	GISFDAAATSGGSASSEK	1
OBSL1	HQDSGALVGFSCPGVQDSAALTIQESPVHILSPQDK,LVSDLTPLTVHEGDDATFR	2
ALOX12	LVLPSGMEELR	1
MDN1	LVASELHTSLYSSMVGADR,ALRETLLAQPAAGQATIPEWCQGSAPSGLEGELLR,EKFTFAATRPSSVLVEQLAVCVSK,FTFAATRPSSVLVEQLAVCVSK,EDLIQIINHNLRPGLCLGR	5
GSTP1	CKYVSLIYTNYEAGKDDYVK,CKYVSLIYTNYEVGKDDYVK,EVGKDDYVK,CKYVSLIYTNYEAGK,YVSLIYTNYEVGKDDYVK,YVSLIYTNYEAGKDDYVK	6
ACIN1	EFKEEGEEMPR,ELLVPQHTVQLVGGLSPLSSPSDTK,ELLVPQHTVQLVGGLFPLSSPSDTK,EAPILKEFKEEGEEMPR	4
CYP27A1	DFAHMLLLK	1
SLC1A5	SELPLDPLPLPTEEGNPLLK,STEPELIQVKSELPLDPLPLPTEEGNPLLK	2
ICAM1	EVTVNVLSPR,VLEVDTQGTVVCSLDR,VTLNGVPAQPLGLR	3
MTMR6	YSEYTEEFSK,TIEGSSPADNRYSEYTEEFSK,TIEGSSPADNRYSEYTEEFSKSEPAVVSLEYGVAR,AVMDAAVFLAK	4
DNAJC11	NLDKNTMGYLQWR,NTMGYLQWR	2
TMEM263	MNQTDKNQQEIPSYLNNEPPEGSMKDHPQQQPGMLSR,NQQEIPSYLNNEPPEGSMK,NQQEIPSYLNNEPPEGSMKDHPQQQPGMLSR	3
UGT2B15	LEVYPTSLTKNDLEDSLLK,NDLEDSLLK,SSAIKLEVYPTSLTKNDLEDSLLK	3
EIF3J	LQEESDLELAKETFGVNNTVYGIDAMNPSSRDDFTEFGK,ETFGVNNTVYGIDAMNPSSRDDFTEFGK,ETFGVNNTVYGIDAMNPSSR	3
C6	SVLRPSQFGGQPCTEPLVAFQPCIPSKLCK,PSQFGGQPCTEPLVAFQPCIPSK,SVLRPSQFGGQPCTEPLVAFQPCIPSK	3
SI	TLFDTSIGPLVYSDQYLQISAR	1
GBA	NNLDAVALMHPDGSAVVVVLNR,VGLVASQKNNLDAVALMHPDGSAVVVVLNR	2
BPIFB1	DALVLTPASLWKPTSPVSQ,ALGFEAAESSLSK	2
MT1F	MDPNCSCASGVSCTCAGSCK	1
PDE11A	LLASTASSSSPASVMVAKEDRN,VNLPQYPPTAIDYK	2
HLA-B	FLRGHNQYAYDGKDYIALNEDLSSWTAADTAAQITQR,TYLEGTCVEWLR,GHNQFAYDGK,GYHQDAYDGKDYIALNEDLSSWTAADTAAQITQR,GHNQFAYDGKDYIALNEDLSSWTAADTAAQITQR,EEPRAPWIEQEGPEYWDRNTQICK,MSGCDVGPDGR,ADPPKTHVTHHPVSDHEATLR,FDSDAASPRTEPRAPWIEQEGPEYWDGETR,GYHQDAYDGK,GHNQLAYDGK,APWIEQEGPEYWDRNTQICK,AQTDREDLRTLLR,YFHTAMSRPGR,GYNQFAYDGKDYIALNEDLSSWTAADTAAQITQR,GHNQYAYDGKDYIALNEDLSSWTAADTAAQITQR,GHNQLAYDGKDYIALNEDLSSWTAADTAAQITQR	17
ARVCF	AGPLGLGPGDGCFTLPGHR,DVIPMDALGPDGYSTVDQR	2
PAPSS1	MVAGANFYIVGRDPAGMPHPQTGKDLYEPSHGAK,DPAGMPHPQTGK,DPAGMPHPQTGKDLYEPSHGAK	3
PKP2	AVSMLEADHMPPSR,SMGNLLEKENYLTVGLTVGQVRPLVPLQPVTQNR,ENYLTVGLTVGQVRPLVPLQPVTQNR	3
RDH13	DIRGETLNHHVK	1
SYNE1	CTAQWHNYQK,TWLAHIESELAKPIVYNSCNSEEIQR,TYLDLLCSMCDLSNASVKTTAKDIQQTEQTIEQR,VPTNLAVEEALSLQDGCR,STKGGSDSSLSEPGPGQSGR,GAVALSGDHSALESQIR,DSLFVLHELGEQLK,ALPSEDEEGQDDKDFYLRGAVALSGDHSALESQIR,DIQQTEQTIEQR,GAVALSDVMIPESPEAYVK,GAVALSGDHSALESQIRQLGK,TTAKDIQQTEQTIEQR,TGQTILPSLNEVNHSYLSEK,QADIVTFPEINLMNESTELHTQLAK	14
TRMT13	RFCGEHAGAMEEEDAR,FCGEHAGAMEEEDAR	2
POF1B	EELGHLQNDLTSLENDKMR,LVLSTFSNIREELGHLQNDLTSLENDK,EELGHLQNDLTSLENDK,LVLSTFSNIREELGHLQNDLTSLENDKMR	4
FAM207A	ASPLLAIGQTLAR,DALPELLGLEAGIR	2
RRBP1	QKLTAEFEEAQTSACLLQEELEK,EKLHSLTQAKEESEK,AEGAQNQDKKAEGAQNQGR,EHTLHLEAELEKHMAAASAECQNYAK,LHSLTQAKEESEK,LTAEFEEAQTSACLLQEELEK,LTAEFEEAQTSACLLQEELEKLR,EKLHSLTQAK,QKLTAEFEEAQTSACLLQEELEKLR,GELESSDQVREHTLHLEAELEK,LKGELESSDQVREHTLHLEAELEK,EHTLHLEAELEK	12
AHNAK2	LDGAQLQGDLSLADK,GEEVEGAGWMPGREPTTHAEAQGNEGDGEEGLQR,TTDLSIQLPSADLEVQAGQVDVK,TSAFPIVESVVHEGDLHDPSR,AKLDSAQLEGDLSLANKDVTAK,LEGDLSLANKDVTAKDSK,AEVTAPDVEVSLPSVEVDIEAPGAK,AKLDGAQLQGDLSLADK,AKLDGAQLQGDLSLADKAVTAK,VDLKGPQLDVK,LPEGHLPEVAGLK,LDSAQLEGDLSLANK,SIQASVDVSALK,VDIKGPQVDVK,TTDLSIPLPSADLVVQAGQVDMK,VDHKGPQIDIK,LSEGPVPEGAGLK,DSQESWFK,VEANVSLPSMQGDLK,MSLSSVEVDVQAPR,TTHLSIQSPSADLEVQAGQVNVK,VDIKGPQVDIK,LDSAQLEGDLSLANKDVTAK,EPTTHAEAQGNEGDGEEGLQR,TTDLSIQLPSADLEVQAGQVDVKLPEGHVPEGAGLK,MLSFGVSAPGK,AGTGLKGEEVEGAGWMPGREPTTHAEAQGNEGDGEEGLQR,AEVTAHEVAVSLPSVEVDIQAPGAK,FSFAAPSSEDDVFIPTVR,SIEASVDVSPPKVEADVSLPSMQGDLK,TSAFPIVESVVHEGDLHDPSRDGNLGLAVGEVGMDSK,AKLDSAQLEGDLSLANK,AKLDSAHLQGDLTLANKDVTTK	33
HLA-DRB5	PSAEYWNSQKDFLEDRR,GIYNQEENVRFDSDVGEYR,YFYNQEEYVR,HNYGAVESFTVQR,PSAEYWNSQKDFLEDR,CIYNQEESVR,AVTELGRPDAEYWNSQKDILEDER,PSAEYWNSQK,CIYNQEESVRFDSDVGEYR,GIYNQEENVR,AVTELGRPSAEYWNSQKDFLEDR,ALVDTYCR,FLDRYFYNQEEYVR	13
HLA-DRB1	YFYNQEEYVR,HFHNQEELLRFDSDVGEFR,HNYGAVESFTVQR,CIYNQEESVR,PSAEYWNSQK,HFHNQEELLR,CIYNQEESVRFDSDVGEYR,AVTELGRPDEEYWNSQKDFLEDR,FLDRYFYNQEEYVR	9
POTEE	LCFVALDFEQEMATVASSSSLEK,CPEALFQPCFLGMESCDIHETTFNSIMK,FRCPEALFQPCFLGMESCGIHDTTFNSIMK,SYELPDGQVITIGNEQFR,CPEALFQPCFLGMESCGIHDTTFNSIMK,CPQALFQPCFLGMESCGIHETTFNSIMK,FRCPEALFQPCFLGMESCDIHETTFNSIMK,CPEALFQPCFLGMESCGIQETTFNSIMK,FRCPEALFQPCFLGMESCGIQETTFNSIMK	9
KANK2	SQEVVETMCPVPAAATSNVHTVKK,SQEVVETMCPVPAAATSNVHTVK,AGYSPIMLTTLATLKTQDDIETVLQLFR	3
HLA-DPA1	FHYLTFVPSAEDVYDCR,EPVELGQPNTLICHIDR,ETVWHLEEFGR	3
LACTB	YAMAWGVVEKK,ENVAFEQEKEGQSNEKNDFTK,EGQSNEKNDFTK,YAMAWGVVEK,ENVAFEQEKEGQSNEK	5
NBN	ESCETSSNNNSMVSNTLAK	1
SORT1	FSTDEGQCWQTYMFTRDPIYFTGLASEPGAR	1
HAGH	MKVEVLPALTDNYMYLLIDDETKEAAIVDPVQPQK,CLATPCHTSGHICYFVSKPRGSEPPAVFTGDTLFVAGCGK,MKVEVLPALTDNYMYLLIDDETK,VEVLPALTDNYMYLLIDDETK	4
CCAR2	VMEKADSWVEKEEPAPSN,IQVSSENEAAPDAGAEPITADSDPAYSSK	2
PDPR	AVDVLSELSFAPMTPDHFPSLFCK,DSILLLEDVTWK,LYHQLEQETGIQTGYTR	3
INHBC	ANTAAGTTGGGSCCVPTAQRPLSLLYYDR	1
COQ3	DNLLETIPNHQPGKPLLGMK	1
GLRX3	HASSGSFLSSANEHLK,HASSGSFLSSANEHLKEDLNLR	2
DROSHA	SYGLLVVPEPAGCTPELPGEIIK	1
TFRC	LDSTDFTSTIK,LSEKLDSTDFTSTIK	2
LTBP4	SRGPGAPCQNVDECARSPPPCTYGR,SRGPGAPCQNVDECAR,CLCPPDFAGKFCQLHSSGARPPAPAIPGLTR,TSAGMFPGSQPQAPASPVLPARPPPPPLPR,FCQLHSSGARPPAPAIPGLTR	5
CLCN3	MDASSDPYLPYDGGGDNIPLRELHK,MDASSDPYLPYDGGGDNIPLRELHKR	2
ALDH1B1	LLNLLADLVER,LLNLLADLVERDR,EAGFPPGVVNIITGYGPTAGAAIAQHMDVDK	3
IGF2R	SVISFVCRPEAGPTNRPMLISLDK,GHQAFDVGQPRDGVK	2
NUP210	LPPGSEHCSGVR,FVCAPPSRLTLVPVYTSPQLDMSCPLLQQNK,NPLLDLAAYDQEGR	3
AP5B1	VGAGLGGLFTDK,ELESCKPGLLGGSLVLLR	2
MGAM	GELFWDDGETKDTVANK,YEVPVPLNIPSMPSSTPQGQLYDVLIKK,IYDPNKNRYEVPVPLNIPSMPSSTPQGQLYDVLIK,GELFWDDGETK,NRYEVPVPLNIPSMPSSTPQGQLYDVLIK,YEVPVPLNIPSMPSSTPQGQLYDVLIK	6
AK1	RIGQPTLLLYVDAGPQTMTQR,EVQQGEEFERRIGQPTLLLYVDAGPQTMTQR,IGQPTLLLYVDAGPQTMTQR	3
WASHC1	MQHSLAGQTYAVPLIQPDLR,MQHSLAGQTYAVPLIQPDLRREEAVQQMADALQYLQK,ATSQGGDLMSDLFNKLVMR,ATSQGGDLMSDLFNK,MTPVRMQHSLAGQTYAVPLIQPDLRR,ISQRVEQSRSQVQAIGEK,MQHSLAGQTYAVPLIQPDLRR	7
GSN	ATEVPVSWESFNNGDCFILDLGNNIHQWCGSDSNRYER,TPSAAYLWVGTGASEAEKMGAQELLR,AGALNSNDAFVLKTPSAAYLWVGTGASEAEKMGAQELLR,VEKFDLVPVPTNLYGDFFTGDSYVILK	4
TINAG	CSQHVCLVRPELIEQVNK,EIMQNGPVQAIMQVHEDFFHYK,EKFWLAANSWGK	3
PNP	LTQAQIFDYSEIPNFPR,HRPQVAIICGSGLGGLTDKLTQAQIFDYSEIPNFPR	2
LAMC3	QEGQYLRPGEDER,SVGGSEHSPQWSPNGVLLSPEDEEELTAPGK,SVGGSEHPPQWSPNGVLLSPEDEEELTAPGK,SVGGSEHPPQWSPNGVLLSPEDEEELTAPGKFLGDQR,LAQASHTCGSPPEDFCPHVGAAGAGAQCQR,TYGRHEGQYLRPGEDER,HEGQYLRPGEDER,LTSQMQATLQQASQQVLASEAR,EAFLEQMMGLEGAVK	9
SIRT3	ELYPGNYKPNITHYFLR	1
LARP1B	DHGPGTSSVSTSNASPSEGAPLAGSYGCTPHSFPK	1
VCAN	TYGQVSGEAIK	1
GAA	YEVPLETPR,NHNSLLSLPQEPYSFSKPAQQAMR,RYEVPLETPRVHSR,YEVPLETPRVHSR,RYEVPLETPR,APSPLYSVEFSEEPFGVIVHR,VHSRAPSPLYSVEFSEEPFGVIVHR,APSPLYSVEFSEEPFGVIVHRQLDGR,EPAIHSEGQWVTLPAPLDTINIHLR	9
AKAP9	ISSSSQTPQILVK,AVHNEGMQVLSLTESPYSDGEDHSIQQVSESWLEER,QHMAQMEEIK,DKPELEVVLTEDALKSLENQTYFR	4
OTC	DLLTLRNFTGEEIK,LLLTNDPLEAAHGGNVLITDTWISMGREEEKK,LLLTNDPLEAAHGGNVLITDTWISMGR,LLLTNDPLEAAHGGNVLITDTWISMGREEEK	4
CUTA	SVHLYEVAEVIALPVEQGNFPYLQWVR	1
RAC1	VDQVIILYSGDKNYDDYYPDLK,NYDDYYPDLK	2
MYO1D	RFQEALQTIFNR,FQEALQTIFNR	2
WDR41	TAHDSNVLHIAR	1
SPG7	VLQDNLDKLQALADALLEK	1
GPN2	ANGYCFGAQEQR	1
OLFML2A	QEVTEAVADNALQGTSWLEQLPPKVEGR	1
OBSCN	HTLTISQCCLEDVGQVAFMAGDCQTSTR,GRMHTLTLSGLRPEDSGLMVFK,RLVVQQAGQADAGEYSCEAGSQR,LHVSLMENYPGTLEALGEPIR,LHVSLMENCPGTLQALGEPIR,RLVVQQAGQADAGEYSCK,DAVASAWLTVLGLPDPPEDAEVVAR,LQQGPTCHLAVR,LVVQQAGQADAGEYSCK,RVEQEDAGDYTCDTGHTQSMASLSVR,HHHIDQLGDGTCSLLITGLGR,EQGTATMEVQLSHADVEGSWTR,QVAAGEDVCLELEVVAEAGEVIWHK,GPLGLFRPEPHGASPPGPQVR,GLVVHDVSPEDAGLYTCHMGSEETR,LVVQQAGQADAGEYSCEAGSQR	16
FAT1	IFVTIADSASPK,KPIEEKPSQPYSAR	2
DST	KPQYEQLTAAGQGILSRPGEDPSLHGIVK,LNVLESLIK,AAECSDFPVPSTEGTPIQGSK,LAQDLVVEASDSKGASDVLLQVETIAQEHSTLSQQVDEK,GASDVLLQVETIAQEHSTLSQQVDEK,KLEALIASNDNANK,TFGPASISHDNNNISSTSELGTDLANSK	7
SPATA5	LKLQQAVEWPLKHPESFIR,LQQAVEWPLKHPESFIR	2
KRT8	ASLEAAIADAEQHGELAIK,ASLEAAIADAEQHGELAIKDANAK	2
MMUT	EVAQQAVDADVHAVGVSTLAAGHK,SSRDQALAEHCLAALTECAASGDGNILALAVDASR,IKSSRDQALAEHCLAALTECAASGDGNILALAVDASR,IDSGSEVIVGVNKYQLEKEDTVEVLAIDNTSVR,MVSGAYRQEFGQSK,MVSGAYRQEFGQSKEITSAIK,DQALAEHCLAALTECAASGDGNILALAVDASR,YQLEKEDTVEVLAIDNTSVR,EVAQQAVDADVHAVGVSTLAAGHKTLVPELIK,EDTVEVLAIDNTSVR	10
SORBS3	HPSSPSALRSPADPTDLGGQTSPR,SPADPTDLGGQTSPR,TGFSFPAQEPR,RTGFSFPAQEPRPQTQNLGTPGPALSHSR,SPADPTDLGGQTSPRR,TGFSFPAQEPRPQTQNLGTPGPALSHSR	6
GOLGA5	IMQDQSEGNSLQNQALQTLQERLHEADATLKR,IMQDQSEGNSLQNQALQTLQER,SRIMQDQSEGNSLQNQALQTLQER	3
NID2	FAVTNQIGPVKEDSDPTPVNPCYDGSHMCDTTAR,GTYEVGLEDNIGSNTKVFTYNAANKETCEHNHR,SYPASDHTTPLSR,EDSDPTPVNPCYDGSHMCDTTAR,HLEESSTLDPHTK,GEADDLKSEGSYFSLTSTEQSVK,FAVTNQIGPVKEDSDPTLVNPCYDGSHMCDTTAR,VLRFAVTNQIGPVKEDSDPTPVNPCYDGSHMCDTTAR,CECQSGYEFADDR	9
STEAP4	SDIIIIAIHR,INQYPESNAEYLTHLVPGAHVVK,KSDIIIIAIHR	3
KIAA2012	HLHFYQELHK	1
COBL	EEVPALHPASHDIGK,ASLAPLQAEHSQPHEK,AREEVPALHPASHDIGK,RASLAPLQAEHSQPHEK,NGAQWPCVTPPNNHGEDLAVGAPPR,AVTASNDEDLLIAGEFR	6
ECM1	APYPNYDRDILTIDISR,DILTIDISR,RAPYPNYDRDILTIDISR,EGMPAPFGDQSHPEPESWNAAQHCQQDR	4
C7	LLEPHCFPLSLVPTEFCPSPPALKDGFVQDEGPMFPVGK,DGFVQDEGPMFPVGK,NVVYSCNEGYSLIGNPVAR,GGGAGFISGLTYLELDNPAGNKR	4
CBR4	AAAGDLGGDHLAFSCDVAKEHDVQNTFEEMEK,EHDVQNTFEEMEKHLGR,EHDVQNTFEEMEK	3
DOCK10	VSTFVVSTVNTQNPHVNAFFQECQK,VSTFVVSTVNTQNPHVNAFFQECQKR	2
PFAS	RNGQGDAPPTPPPTPVDLELEWVLGK,SPVLHFYVRPSGHEGAASGHTR,GAHVVAGTAGYCFGNLHIPGYNLPWEDLSFQYPGNFAR	3
PDE12	TAVEKLSWAEAGSQTAAGAMER,LSWAEAGSQTAAGAMER	2
SERPINA7	GKVVGLIQNLKPNTIMVLVNYIHFK,GWVDFFVPK,VVGLIQNLKPNTIMVLVNYIHFK	3
CTSB	HYGYNSYSVSNNEKDIMAEIYK,ASHQWMNTQGGHLALGVYQHVTGEMMGGHAIR,SRPSFHPVSDELVNYVNK,SRPSFHPVSDELVNCVNKR,PSFHPVSDELVNYVNKR,PSFHPVSDELVNYVNK,SRPSFHPVSDELVNYVNKR	7
TACC2	AQQEQAAHQATLR,HFQPSQAQPETSIFDVLK,IGTAEVEKPAGLLFQQPNLDSALQIAR,IGTTEVEKPAGLLFQQPDLDSALQIAR,QGTSGGVNTSSEQIATLTGFPDFR,TTEVEKPAGLLFQQPDLDSALQIAR,IFEKPVLGALTTPGEK,KTLPLTTAPEAGEVTPSDSGGQEDSPAKGHSVR	8
GKN2	QALDNMFSNK	1
NUDT6	FIAPAASLGFR,SVLSIQQQHTNPGAFGK	2
MYOM2	NWHEVNSSPSKPTILTVDGLMEGSLYEFK,LCFTVQGFPMPMVQWYK,FVVHGLTTGEQYLFR	3
HGD	CPGSLPEGQNNPQVCPYNLYAEQLSGSSFTCPR,PFESIDEGHVTHNWDEVDPDPNQLR,ILPSVSHKPFESIDEGHVTHNWDEVDPDPNQLR	3
MTRF1L	LLNEKEQELR,IHTSTMTVAILPQPTEINLVINPK	2
EXOC2	GSSFQSGRDNTWR	1
RBP2	DQNETWEMESNENFEGYMK	1
PIR	IEPHHTAVLGEGDSVQVENKNPKR,GILHAEMPFSEEPAHGLQLWVNLR,IEPHHTAVLGEGDSVQVENKNPK	3
MRPL45	TVMIPGPQLKPEEEYEEAQVEAQKPQLA	1
POTEF	CPKALFQPCFLGMESCGIHETTFNSIMK,CPEALFQPCFLGMESCDIHETTFNSIMK,FRCPEALFQPCFLGMESCGIHDTTFNSIMK,SYELPDGQVITIGNEQFR,CPEALFQPCFLGMESCGIHDTTFNSIMK,FRCPEALFQPCFLGMESCDIHETTFNSIMK,FRCPKALFQPCFLGMESCGIHETTFNSIMK	7
BTN3A2	STGWYPQPQIQWSNTK	1
ANXA13	GLGTDESILIEVLCTR,TALALLDHPSEYAAR	2
CTDP1	ELCAQPGQVVAPGVVLVR	1
RGN	NNCFNDGKVDPAGRYFAGTMAEETAPAVLER	1
CAT	NPQTHMKDPDMVWDFWSLRPESLHQVSFLFSDR	1
CFAP36	GLKIPGLEHASIEGPIANLSVLGTEELR,GLKIPGLEHASIEGPIANLSVLGTEELRQR,SETSSLPQKGLKIPGLEHASIEGPIANLSVLGTEELR	3
HCLS1	TTPIEAASSGAR,TLEGLQVEEEPVYK,KTTPIEAASSGAR,RSPEAPQPVLAMEEPAVPAPLPK,SPEAPQPVLAMEEPAVPAPLPK	5
ECI2	DFENSINQVK,LKAFAKLPPNVLR,ASQKDFENSINQVK,AFAKLPPNVLR	4
IMPACT	KKTEEEDVECEDDLILACQPESSVK,KTEEEDVECEDDLILACQPESSVK,SQMTEPGPEVK	3
ELP2	RTSDPALCPLIVSAAADSAVR,DGVLQQPMR,TSDPALCPLIVSAAADSAVR	3
CAMKK2	DRPLEADGQEVPLDSSGSQARPHLSGR	1
HMGXB4	VSGSSGELPLEDGVSHK	1
CD99	KLCFKENAEQGEVNMESHR,NAIAEPAVQR,ENGQLAGSLGPCIR,ENAEQGEVNMESHR,ENEQGEVDVESHR,KLCFKENAEQGEVDVESHR,LCFKENAEQGEVDVESHR,ENEQGEVNMESHR,ENAEQGEVDVESHR,LCFKENAEQGEVNMESHRNANAEPAVQR,LCFKENAEQGEVNMESHR,ENAEQGEVNMESHRNANAEPAVQR	12
SERPINF1	VGFEWNEDGAGTTPSPGLQPAHLTFPLDYHLNQPFIFVLR,SSMSPTTNVLLSPLSVATALSALSLGAEQR,SSMSPTTNVLLSPLSVATALSALSLGAEQRTESIIHR	3
CDA	QSAYCPYSHFPVGAALLTQEGR	1
MYO15B	QIMGTYLVR	1
DIS3	ELKNGNLEVGVHIADVSHFIRPGNALDQESAR,ENYLEATVWIHGDSEENKEIILQGLK	2
POTEI	CPETLFQPCFLGMESCGIHETTFNSIMK,CPQALFQPCFLGMESCGIHETTFNSIMK,LCFVALDFEQEMATVASSSSLEK	3
C8A	RECDNPAPQNGGASCLGR,YNPVVINFEMQPIHEVLR,RRECDNPAPQNGGASCLGR,LALDQYLMEFNACR,SLKYNPVVINFEMQPIHEVLR,QCDNPAPQNGGASCPGR,SLLQPNKFGGTICSGDIWDQASCSSSTTCVRK,ECDNPAPQNGGASCLGR,RRQCDNPAPQNGGASCPGR,RQCDNPAPQNGGASCPGR,QCDNPAPQNGGASCPGRK	11
CYP8B1	QGISNWLGNMLQFLR	1
MUC16	DSSAMAVDAICTHRPDPEDLGLDR,VDLLCTYLQPFSGPGLPIK	2
TTN	NSITLNWGKPIYDGGSEILGYVVEICK,PLPTTEWLR,QIYSHIGDPALEFQGQETR,LEADVHGKPLPTTEWLR,FVVTITVHPEPHVTWYK,LEADVHGKPLPTTEWLRGDK,LYVEPAAPLGAPTYIPTLEPVTRIR,AMNYDEEVDEAR,TSFRVPNLEEGK,TSFRVPNLEEGKSYFFR,EAPPAKVPEVQKR,LYVEPAAPPGAPTYIPTLEPVSR,MSGYPIPK,FCAMISGRPQPK,FCNRSDSGKYTLTVK,LLQGKDYIFR,MAVDISESEAVESGFDLR	17
HSPA4	SVMDTTQIAGLNCLR	1
ACSM5	HCLTGGEALNR,NNDVINSSSYR	2
LAMA2	NLHMAEAPANLEQPTSSFHVGTCFANAQR,NLHMAEAPANLEQPTSSFHVGTCFANAQRGTYFDGTGFAK,EGWECVFCGDECTGLLLSDLAR,QTGQAYYVILLNR,NIADADATVKNLEQEADRLIDK,TRGIFAVQVDENRR,GIFAVQVDENRR	7
C17orf80	DSVTGKESQGERPHLSLLIPR,KAEAQNHNCVPDVK,ESQGERPHLSLLIPR	3
TBX3	ITTTTSEEPCR	1
KRT18	STSFRGGMGSGGLATGIAAGLAGMGGIQNEKETMQSLNDR,STSFRGGMGSGGLATGIAAGLAGMGGIQNEK,GGMGSGGLATGIAAGLAGMGGIQNEK	3
METTL23	CGAQVILSDSSELPHCLEVCR	1
SLC16A1	AAESPDQKDTEGGPKEEESPV,DTEGGPKEEESPV	2
IGHV3-30	NTLYLQMHSLRTEDTAVYYCAR,LSCAASGFTFSNYAMHWVR,NTLYLQMHSLR,AEDTAMYYCAK	4
KIAA0040	ISAFFSSVWDTILTK	1
COL6A3	AIYHGSFSTKK,TRPEFYLNSYMNQQDVVNAVR,LHWERPEPPGPYFYDLTVTSAHDQSLVLK,VAVVQYSDRTRPEFYLNSYMNQQDVVNAVR,LLPSFVSSENAFYLSPHIR,NNLFMSSAGYR,AAGSDVNIDMAFILDSAETTTLFQFNEMKK,AIYHGSFSTK	8
UGT2B17	AFITHGGTNDIYEAIYHGIPMVGIPLFADQHDNIAHMK	1
FHL5	DDYPFCMDCYNHLYANK,DLCEEQFMSGDDYPFCVDCYNHLYANK	2
IQCG	EMNLEGTNLDKLPMDSTITK,QFFSHVIADTIK	2
CHST3	LSAELGLQQPAWLR	1
MYO18A	ISELTSELTDERNTGESASQLLDVETAER,QNPATQNVPR,AASSPKPPPPPPPPPAPPKPAVK,VQLTPVEEAHQQLER	4
COL18A1	IFSFNGKDVLR,AAMPIVNLKDELLFPSWEALFSGSEGPLKPGAR,IFSFNGKDVLRHPTWPQK	3
TCP11L1	NQITEVLDLDLIKQEAENGALDISR	1
SERPINB3	DLSMIVLLPNEINGLQKLEEKLTAEK,DLSMIVLLPNEINGLQKLEEK,GKNLSMIVLLPNEIDGLQK,DLSMIVLLPNEINGLQK,GKDLSMIVLLPNEINGLQKLEEK,NLSMIVLLPNEIDGLQKLEEK,GKDLSMIVLLPNEINGLQK,NLSMIVLLPNEIDGLQK	8
TRIM9	GATIGVLLDFNRK	1
LECT2	SQRPHQGVDVLCSAGSTVYAPFTGMIVGQEKPYQNK	1
PRUNE2	EIPELEEEKTIPTKEPEQIK,AGPDAVTHDNEWEMLSPQPVQK,EIPKLEEEK,QEEIISILEEK,EIPELEEEK,SLDFGDVPIDSDVHVSSTR,ISEKQEEIISILEEK,EDHDEALKNTWDLHPTSSK,ADGENPDILTHCEHDSNSQASDSPDICHDSEAKEETEK,AGPDAVTHDSEWEMLSPQPVQK	10
MYBBP1A	DPAEPMSPGEATQSGARPADR,KSEDGTPAEDGTPAATGGSQPPSLGR,ELLDFFWDIAKPEQETR,SEDGTPAEDGTPAATGGSQPPSLGR	4
AGRN	RAPVCGDDGVTYENDCVMGR,SGCTPCSCDPR	2
NDUFS2	MAPGEIKVDDAK	1
HFM1	FQFAFPSDKYEQDDLNLEGVGNNDLSHVAGK	1
DLG1	VNDCILQVNEVDVR,YQDEDTPPQEHISPQITNEVIGPELVHVSER	2
FARSB	FELTMPCSSLEINIGPFL	1
NDUFB9	QLQEETPSGGPLTEALPPARK,QLQEETPSGGPLTEALPPAR	2
KIF13B	TAMVATVSPAANNYDETLSTLR,IIWDLREEVEK	2
GSTM3	MAQWGNKPIC	1
LXN	QASMEDIPGRGHKYR	1
AFDN	GHAEQGDPGAPEQTGPQR	1
TF	SMGSKEDLIWELLNQAQEHFGKDK,KSVEEYANCHLAR,DCHLAQVPSHTVVARSMGSKEDLIWELLNQAQEHFGK,SVEEYANCHLAR,SMGGKEDLIWELLNQAQEHFGKGK,SMGSKEDLIWELLNQAQEHFGK	6
KIF16B	HSTLGTEIEEQR	1
SAA2	LTGHGAEDSLADQAANK,LTGHGAEDSLADQAANKWGR,ENIQRLTGHGAEDSLADQAANKWGR	3
HIVEP1	LIDSISNSHPLLPPELRPLGSQVQK,SNGPSAALVTASTPSALPTGEK	2
SH3BGR	AEEGGETEAQKEGSEDAGNLPEAQEK,EGSEDAGNLPEAQEK	2
IL1RL1	FLPAEVADSGIYTCIVR	1
NIPSNAP3A	YDNFAHRTEVQK	1
ADH1A	IDAASPLEKVCLVGCGFSTGYGSAVNVAK,VCLVGCGFSTGYGSAVNVAK	2
TG	RSLRVEVDLLIGSSQDDGLINR,QFEESQGRTSSKTAFYQALQNSLGGEDSDAR,KNTVPRPASPTEAGLTTELFSPVDLNQVIVNGNQSLSSQK,AVLMGGSALSPATVISHERAQQQAIALAK,QFEESQGRTSSK,CPTPCQLQAEQAFLR,PMSLGSWQSLALSSVVVDPSIR,RVSLAADRDGADVASIHLLTAR,QFEESQGR,LLALSGPFHYWGPVIDGHFLR,AKAVKQFEESQGR,MCSADYAGLLQTFQVFILDELTAR,KCPTPCQLQAEQAFLR,SLQVEVDLLIGSSQDDGLINR,DGADVASIHLLTAR,WCDADPCCTGFGFLNVSQLK,VSLAADRDGADVASIHLLTAR,SGPYVPQCDAFGSWEPVQCHAGTGHCWCVDEK,AVLMGGSALSPATVISHER,RSLQVEVDLLIGSSQDDGLINR,AVKQFEESQGR	21
TOPBP1	GYMLSEEPYIHANYQPVEIPVSHQPESK	1
MUC5AC	WFDVDFPSPGPQGGDK,SHPEVSIEHLGQVVQCSHEEGLVCR,GCPVTSASVTAPSTPSGR,AISPTQSTSSWQK,AKSHPEVSIEHLGQVVQCSHEEGLVCR,VPTASTTFAPTTR,SSTTSAVTTSTTSGPETTPR,EEGLVCQNQDQQGPFK,MDDPTEQCQDPVPEPPR,ICHRPEEITR,TTSAPTTSTTSVPTTSTISGPK,TCGLCGDFNGMPVVR,DVWGLEGCYPK,WFDVDFPSPGPQGGDKETYNNIIR	14
IGHD	EVNTSGFAPARPPPQPGSTTFWAWSVLR	1
MUC13	DSQMQNPYSSHSSMPRPDY	1
SNED1	SFPVWEGGVCHHVYK	1
SP100	TSLNEQTYTR	1
KLHDC7A	TAVGSNPDTPHFPR,AEAPQSCSCENPR	2
ACP5	EDYMLVAGHYPVWSIAEHGPTHCLVK	1
TPSAB1	IIRDDMLCAGNTR,IIRDDMLCAGNSQR,VNGTWLQAGVVSWDEGCAQPNRPGIYTR,IIRDDMLCAGNTRR,YWMHFCGGSLIHPQWVLTAAHCLGPDVK,DRYWMHFCGGSLIHPQWVLTAAHCLGPDVK,DDMLCAGNSQR,DSCKGDSGGPLVCK	8
NECTIN4	VEQPPPTRNPLDGSVLLR	1
UROC1	ACEIICQTMQENSTLVVTLPHKVEDER	1
IGLC2	AGVETTIPSK	1
PRG4	RPALNYPVYGEMTQVR,VTTPDMSTTQHNK	2
TNXB	LGELTMTDATPDSLSLSWMVPEGQFDHFLVQYRNGDGQPK,DITSDSLSLSWTVPEGQFDHFLVQYKNGDGQPK,LGELTMTDATPDSLSLSWMVPEGQFDHFLVQYR,VRLEVPPEADGTLLTDLMPGVEYVLTVTAER,CVDGHCVCNPGFTGEDCGSR,LGQMTVRDITSDSLSLSWTVPEGQFDHFLVQYKNGDGQPK,YEVTVVSVRGFEESEPLTGFLTTVPDGPTKLR,CVDGHCVCNPGFTGEDCGSRR,LGQMTVRDITSDSLSLSWTVPEGQFDHFLVQYK	9
FBP1	IYSLNEGYAKDFDPAVTEYIQRK,IYSLNEGYAKDFDPAVTEYIQR,GKIYSLNEGYAKDFDPAVTEYIQR	3
SMTN	VAVTQAAEVAVATMEPVAR,DPQVGHPAAQMEPEPAEPLAAAVEAANGAEQTR,LEKQGAAGPGGPR,MEPEPAEPLAAAVEAANGAEQTR,MEPEPAEPLAAAVEVANGAEQTR,LEKQGAAGSPGGPR	6
IFI16	LKTEPEEVFIEDSAQSDLK,LPQEQSQLPNPSEASTTFPESHLR,TSLSAPPNTSSTENPK,TSLSAPPNTSSTENPKTVAK,LKTEPEEVFIEDSAQSDLKEVMVLNATESFVYEPK,SMKLPQEQSQLPNPSEASTTFPESHLR	6
MYBPC3	HHLIINEAMLEDVGHYALCTSGGQALAELIVQEK	1
ADHFE1	LAPRPQSEEDLAALFEASMKLY,LAPRPQSEEDLAALFEASMK	2
SUGP2	DYDVDHPGEADSVLRGSSQVQAR	1
SEC23A	VPVTQATRGPQVQQPPPSNR,QLQEMLGLSKVPVTQATR,DLSAKQLQEMLGLSKVPVTQATR,QLQEMLGLSKVPVTQATRGPQVQQPPPSNR	4
SYNC	QQDVAQFADFQEVLTTR,AEQSPSVEENLSIEDLELLEGR	2
UBA1	RCPHPLTFDVNNPLHLDYVMTAANLFAQTYGLTGSQDR,EVLTEDKCLQHQNRYDGQVAVFGSDLQEK,IYDDDFFQNVDGVANALDNVDAR,CPHPLTFDVNNPLHLDYVMTAANLFAQTYGLTGSQDR	4
KCNMB1	DQNQQCSYIPGSLDNYQTAR	1
PCNX3	LPGPPPASPIPTEGPQTSRPPGPGLLSSEGPSGK	1
NOMO1	AGLTLKPQTFPLTVTDRPMMDVAFVQFLASVSGK,AGLTLKPQTFPLTVTNRPVMDVAFVQFLASVSGK,VLGQAASDNSGPEDAK,VLGQAASDNSGPEDAKR,SNFLTQDNGILTFSNLSPGQYYFKPMMK	5
IGHV3-48	DNAKNSLYLQINSLR,NSLYLQINSLR,NSLYLQMNSLRDEDTAVYYCAR	3
TGM3	EEYVQEDAGILFVGSTNR	1
C15orf39	MQDSSPVELLPFSPQPHSYPGPPLAAPKPVYR	1
ZNF24	QELPSALESHEVPGTLSMGVPQIFK	1
PGM5	NPSGHDQEPQAVLSPLIAIALK,LYAESYERNPSGHDQEPQAVLSPLIAIALK	2
CRYBG3	GFTGNTEGSMLK,SSPSSVTNSSYDGESDSQHHLSCEPVFQTNR	2
CYP2C8	GTTIMALLTSVLHDDREFPNPNIFDPGHFLDK	1
VPS11	DLHDQFQHQLR	1
IGLL1	SHRSYSCQVMHEGSTVEK	1
ERICH3	EKQQHMVQGESETADVSPNNMQV,FRPTTAANGLEPLLTK,QQHMVQGESETADVSPNNMQV	3
KDM3B	SEEPLKTDSSASNNNSELK,LIHVMLMDNSTPQSEGGTLK	2
ZNF326	SMDSYLNQSYGMNNHSGGGGGSRFGPYESYDSR,SMDSYLNQSYGMNNHSGGGGGSR	2
CAMKK1	IKNEPVVFPEGPEISEELK,NEPVVFPEGPEISEELKDLILK,IKNEPVVFPEGPEISEELKDLILK,NEPVVFPEGPEISEELK	4
AHNAK	AEDPEVDVNLPK,GPKVDIDAPDVDVHGTDWHLK,VKGDMDVSLPKVEGDMQVPDVDIK,ADLDVSGPKVDVDIPDVNIEGPDAK,ISVPDLDLNLKGPK,MPKFSMPGFKAEDPEVDVNLPK,VDVEYPDVNIEGPEGK,GPKVDIDVPDVGVQGPDWHLK,GPTVGGGLPGTGVQGLEGNLQMPGIK,GPKVDIDAPGVDVHGPDWHLK,VEGDLKGPEVDIRGPK,VKGDVDVSLPKVEGDVK,VDIDAPGVDVHGPDWHLK,VKGSLGATGEIKGPTVGGGLPGTGVQGLEGNLQMPGIK,GDVDVSLPKVEGDVK,GSLGATGEIKGPTVGGGLPGTGVQGLEGNLQMPGIK,VDIDAPDVDVHGTDWHLK,LEGPDVSLKVPGVDLPSVNLSMPK,VDIDAPDVDVHGTDWHLKMPK,VDIDVLDVGVQGPDWHLK,VEGDMQVPDVDIKGPK,FSMPGFKAEDPEVDVNLPK	22
TMEM43	NPSAMAVESFTATAPFVQIGR,EIGHNNPSAMAVESFTATAPFVQIGR,EIGHKNPSAMAVESFTATAPFVQIGR,NFDREIGHNNPSAMAVESFTATAPFVQIGR	4
MOCOS	GASASNPDCQLPHLFCYPAQSNFSGVR,NVTMAINVISIPVRPEDLWSAEER	2
R3HCC1	KQEEWGLTSTSVLK,IHLDTSSFMEELPGEK,IQWVDDTHALGIFPCR,KQEEWGLTSTSVLKR	4
LGALS8	FQVDLQNGSSVKPR,SGTPQLSLPFAAR,VAVNGVHSLQYK	3
CNTNAP5	VAEILTGSNLNDGLWHLVSINAR	1
C1R	LGEEDPQPQCQHLCHNYVGGYFCSCRPGYELQEDR,QGYQLLEGNQVLHSFTAVCQDDGTWHR,SGEEDPQPQCQHLCHNYVGGYFCSCRPGYELQK	3
FKBP15	LSEIQETSEQAQSKFK,LSEIQETSEQAQSK,CLSLQAQITALTK,LSEIQETSEQAQSKFKSEK,ERPESPMVPSEQVVEEAVTLPPQALTTSQDGHR,FGAAVLGNHTTR	6
RPL14	GTAAAAAAAAAAAAAK,GTAAAAAAAAAAAAK,GTAAAAAAAAAAAAKVPAK,KAPGTKGTAAAAAAAAAAAAK,KAPGTKGTAAAAAAAAAAAAAAAK,GTAAAAAAAAAAAAAAAK,GTAAAAAAAAAAAAKVPAKK,GTAAAAAAAAAAAK,GTAAAAAAAAAAAAAAAKVPAKK	9
API5	LQTLPDEVLTKEVEELILTESK	1
RAVER1	GSGLRGPLSRFYSGSPTSYFTSGLQAGLK	1
ODAD2	TSHENMLIPVVGTLQECASEENYQAAIK	1
ATG7	RDVEQLEQLIESHDVAFLLMDTR,DVEQLEQLIESHDVAFLLMDTR	2
WDR4	SQENKGEDAPLDQGSGAILASTFSNSGSYFALTDDSKR	1
TIMM44	ILDVDNVDLAMGK	1
IGKV1-27	LLIYAASALQSGVPSR,ASQGISNFLAWYQQKPGKVPK,LLISAASTLQSGVPSR,ASQGISNFLAWYQQKPGK	4
ENPP3	HLANTDVPIPTHYFVVLTNCK	1
ATG2B	GIVDGVILPTETR	1
CYB5R2	THPDQFDLWYTLDRPPIGWK,TLADHLGMIAGGTGITPMWQLIR	2
ZBED3	EAAVEQGERALER	1
IRF2BP2	SPPGAAAPAAAKPPPLSAK,DILLQQQQQQLGHGGPEAAPR	2
CHGB	SQREDEEEEEGENYQKGEQGEDSSEEK,DPADATEAHESSSR,GEQGEDSSEEKHLEEPGETQNAFLNER,THSREKSSQESGEEAGSQENHPQESK,LLRDPADATEAHESSSR,DPADATEAHESSSRGEAGAPGEEDIQGPTK,APRPQSEESLDEEDKR,ERADEPQWSLYPSNSQVSEEVK,ERADEPQWSLYPSNSQVSEEVKTR,EKSSQESGEEAGSQENHPQESK,ADEPQWSLYPSNSQVSEEVKTR,ASEEEPEYGEEIKGYPGVQGPEDLEWERYR,MAHGYGEESEEERGLEPGKGHHHR,ADEPQWSLYPSNSQVSEEVKTRHSEK,ADEPQWSLYPSNSQVSEEVK,LLRDPADATEAHESSSRGEAGAPGEEDIQGPTK,FQDEQYSSHHTAEKR,DPADATEAHESSSRGEAGAPGEEDIQGPTKADTEK,EKSSQESGEEAGSQENHPQESKGQPR,DHHSTHYRASEEEPEYGEEIKGYPGVQGPEDLEWER,GEQGEDSSEEKHLEEPGETQNAFLNERK,EDEEEEEGENYQKGEQGEDSSEEK,GYPGVQGPEDLEWER,EEARFQDEQYSSHHTAEKR,SSQESGEEAGSQENHPQESKGQPR,ASEEEPEYGEEIKGYPGVQGPEDLEWER,SSQESGEEAGSQENHPQESK,GYPGVQGPEDLEWERYRGR,PQSEESLDEEDKR,EDEEEEEGENYQKGEQGEDSSEEKHLEEPGETQNAFLNER,GYPGVQGPEDLEWERYR	31
NTS	MTLLNVCSIVNNLNSPAEETGEVHEEELVAR	1
GH1	AHRLHQLAYDTYQEFNPQTSLCFSESIPTPSNR,AHRLHQLAYDTYQEFNPQTSLCFSESIPTPSNREETQQK,LHQLAYDTYQEFNPQTSLCFSESIPTPSNREETQQK,AHRLHQLAYDTYQEFEEAYIPK,AHRLHQLAYDTYQEFEEAYIPKEQK,LHQLAYDTYQEFEEAYIPKEQK,LHQLAYDTYQEFEEAYIPK,LFDNAMLRAHRLHQLAYDTYQEFEEAYIPK,FDTNSRNDDALLKNYGLLYCFR,LHQLAYDTYQEFNPQTSLCFSESIPTPSNR	10
SPOUT1	TIRTEEAILISLAALQPGLTQAGAR,TEEAILISLAALQPGLTQAGAR	2
ACTN4	MAPYQGPEAVPGALDYK	1
ADAD2	PWRPLPAQAQSAWEPAPAPATYR	1
CPVL	QVGDFHQVIIR	1
IGKV1-17	ASQGISNYLAWFQQKPGKVPK,LIYASSSLQSGVPSR	2
PIH1D1	LLGLELSEAEAIGADSAR,VFINICHSPSIPPPADVTKEELLQMLEEDQAGFR,AESGPEKPHLNLWLEAPDLLLAEIDLPK	3
RABEPK	YQWDLDTCK	1
FAM171B	AELSRSDLSLIQQQQQQQQQQQQQQQQK,SDLSLIQQQQQQQQQQQQQQQQK,AELSRSDLSLIQQQQQQQQQQQQQQQK	3
LRRC8C	SNTIQSGPEGSLVNSQSLK	1
LRRFIP1	ALDSNSLENDDLSAPGREPGDFNPESR,SAVEAQNEVTENPKQEIAAESSENVDCLENPK,KALDSNSLENDDLSAPGREPGDFNPESR,HGIILNSEIATNGETSDTLNNVGYRGPTK	4
RPAP1	MLLRPKPGESEVDLLHFQSQFLAAGAAPAVQLVK	1
SLCO2A1	FVFSLQTIPR	1
SLC30A9	VPSFETAEGIGAELKAPLKQEPLQVR,VPSFETAEGIGAELKAPLK,VPSFETAEGIGAELK,VEKVPSFETAEGIGAELK,VEKVPSFETAEGIGAELKAPLK	5
PDIA4	MDATANNVPSDRYKVEGFPTIYFAPSGDK,EVSQPDWMPPPEVTLVLTK,MDATANNVPSDRYK,MDATANNVPSDR,VREVSQPDWMPPPEVTLVLTK	5
NUP188	HSLALGSATDDKDSMETDDCSR	1
IGLV2-14	LMIYDVSNRPSGVSNR,LMIYDVSNR	2
RRP7A	LLSTCGLIQSVELQEKPDLAESPK,LLSTCGLVQSIELQEKPDLAESPK	2
FARP2	VLQTAGMHLGAQTPVGVSTLEPGQTLLPR,HDEILTELEK	2
PON2	FEEGENSLLHLK,NTVEIFKFEEGENSLLHLK,HELLPSVNDITALGPAHFYATNDHYFSDPFLK	3
ODF3B	GTNGAPAYSIYGR,GTNGAPAYSIYGRPR	2
ARL15	SVQELKKYFELEPLAR	1
CST5	VINKDEYYSRPLQLMAAYQQIVGGVNYYFNVK	1
SEPTIN9	RLNEGSSAMANGVEEKEPEAPEM,RAEVLGHKTPELAPR,LNEGSSAMANGVEEK,LNEGSSAMANGVEEKEPEAPEM,AEVLGHKTPELAPR	5
MYO7B	TSVAIGGIIK,YLVNFIGQGPATYGPFCAER	2
ADGRG6	SGYFLSISDSQCLLNNALPVK	1
SUN1	QVTSSGVSYGGTVSLQDAVTR,QVTSSGVSYGGTVSLQDAVTRRPPVLDESWIR,TISAVGEQLLPTVK	3
RETREG2	DLGEGEEGELAPPEDLLGHPQALSR,LSSPLHFVNTHFNGAGSPQDGVK	2
FTCD	GVSMDECVLCAQAFGQR,RTVALQEGLRR,TVALQEGLR,TVALQEGLRR,VQGIGWYLDEKK	5
MICA	AQTLAMNVRNFLKEDAVK	1
CLC	GRPLVCFLNEPYLQVDFHTEMK	1
FGB	HGTDDGVVWMNWKGSWYSMKK,GSWYSMKK,QVKDNENVVHEYSSELEKHQLYIDETVNSNIPTNLR,HGTDDGVVWMNWKGSWYSMK	4
UQCRC2	ATAATAGAPPQPQDLEFTKLPNGLVIASLENYSPVSR,VKATAATAGAPPQPQDLEFTKLPNGLVIASLENYSPVSR	2
HEATR5A	LAQMVDDGAFTAGLAQVSFDK,LAQMVDDGAFTAGLAQVSFDKLK	2
PDZD2	LTTGDACVSTSCELASALSHLDASHLTEDLPK	1
EPS8L2	HSPTSEPTPLGDALPPVSSPHTHR	1
BIN2	DERFEQSANNFYQQQAEGHK,FEQSANNFYQQQAEGHK	2
CENPVL3	SVVIEEVGGGDPGEEAAK	1
RBP5	HWLEGELLYLELTAR,NMENYLQALNISLAVR,NMENYLQALNISLAVRK	3
LY75	EAYVSCQNQGADLLSINSAAELTYLKDKEGIAK,TPDWYNPER	2
CPZ	FPPEEALYTLWQHNK	1
LHB	STSDCGGPKDHPLTCDHPQLSGLFL,VLQAVLPPLPQVVCNYR,RSTSDCGGPKDHPLTCDHPQLSGLFL,VLQAVLPPLPQVVCNYRDVR,DHPLTCDHPQLSGLFL	5
LAMA5	WLFPTGGSVR,SPLGPHHETAQQLEVLEQQSTSLGQDAR,DCQVIPLPPGLPLTHAQDLTPATSPAGPR,CDCTPCGTEACDPR,CQAGFMSSR,LELEEAATPEGHAMR,DDPSTPCVSCPCPLSVPSNNFAEGCVLR,SKSTGDPWLDGSYLDGTGFAR,RASQSLDGTYQGGGVCIDCQHHTAGVNCER,ASQSLDGTYQGGGVCIDCQHHTAGVNCER,YELYSETQR,ALFSQISSAVSLRR,ALFSQISSAVSLR	13
GOLGA3	AASLELSEVKEELQAKEHLVQK,EHLVQKLQAEANDLQIR,LQAEANDLQIR,DVLQAAAAEHQDQGQEVSGEVR,TEDSNAGNSGGNVLAPDSTKGSLKQNR,SLADYRTEDSNAGNSGGNVLAPDSTK,TEDSNAGNSGGNVLAPDSTK	7
AGMAT	QIQEAYEK,IREESVMLR	2
MYH11	LQNEAESVTGMLNEAEGK,QTLEKENTDLAGELR,NKQTLEKENTDLAGELR,LAKDVASLSSQIQDTQELLQEETR,DVASLSSQIQDTQELLQEETRQKLNVSTK,ENTDLAGELR,DVASLSSQIQDTQELLQEETR	7
ALDH1A2	IVGSPFDPTTEQGPQIDKK,IVGSPFDPTTEQGPQIDK	2
PLEC	LAQGHTTVDELAWREDVRHYLQGR,HGYFDEEMNRVLADPSDDTK,TRYSELTTLTSQYIK,LAQGHTTVDELAWREDVR,HGYFDEEMNR,VDGADWGVDLPSVEAQLGSHR,AGVAAPATQVVQVTLQSVQR,LAQGHTTVDELAWR,SQVMDEAMALQLR,AVIGYRDPYTGQSVSLFQALKK,EQLQQEQALLEEIERHGEKVEECQR,LQAEEKAHAFVVQQK,AHAFVVQQK,MLLQGSGCLAGIYLEDTK,LQEAGILSAEELQQLAQGHTTVDELAR,EQLQQEQALLEEIER,HGYFDEEMNRVLADPSDDTKGFFDPNTHENLTYLQLLER,LKAGVAAPATQVVQVTLQSVQR,RQEQIQAMPLADSQAVREQLQQEQALLEEIER,FLEVQYLTGGLIEPDMPGR,VQSGSESVIQEYVDLRTR,KVPAQRLQEAGILSAEELQR,AHAFVVQQKEQELQQTLQQEQSVLDQLRGEAEAAR,VQSGSESVIQEYVDLRTRYSELTTLTSQYIK,GANVIAGVWLEEVGQK,FLEVQYLTGGLIEPDMPGRVPLDEALQR,MLLQGSGCLAGIYLEDTKEK	27
SALL1	LQNSEPSAPLAGLEK	1
CTSG	NVSPVALPR,NRNVSPVALPR	2
MXRA5	LIVQLTVLEPMEKPIFHDPISEK,VWQTVSPVESR	2
SIRPA	KGSPDTEFKSGAGTELSVR	1
IGHV1-69D	ASGGTFSSYTISWVR,VSCKASGGTFSSYVISWVR,QAPGQGLEWMGR	3
IGHV1-69	ASGGTFSSYTISWVR,QAPGQGLEWMGR	2
NSUN5	TCSNDVVDYFKR	1
SPEF2	LEPTLHLLGVQFDQNVAHGIITEKPGVATK,DLLNTNDYEEYK,KDEEDALPVLQEEIK,AAVSLAELPLPTPPPAPPPEPEKEK	4
POMT1	ITQGQPLEVAFGSQITLR	1
GPD2	TDPQTGKVHVSGAR	1
DMGDH	VGVTDLSPFGK,MIGLEHPLIPVQHQYVVTSTIPEVK	2
MPC1	DYLMSTHFWGPVANWGIPIAAINDMK,DYLMSTHFWGPVANWGIPIAAINDMKK	2
IL3RA	LEILTPPNMTAK	1
DCBLD2	TNSCSSAQAQYDTPK	1
EHF	VAGTAGQLLYSNLQHLK	1
LSP1	QQHEGAQGTLDSGEPPQCR,QQHEGAQGALDSGEPPLCR	2
HDGF	EAATLEVERPLPMEVEKNSTLSEPGSGR,NSTLSEPGSGRGPPQEEEEEEDEEEEATKEDAEAPGIR,NSTLSEPGSGR	3
WWOX	AKVETMTLDLALLR,VETMTLDLALLR	2
CAND2	VLAFLSLAEVGQVAGPGPQRELK,VLAFLSLAEVGQVAGPGPQR,SPHSSTGVKVLAFLSLAEVGQVAGPGPQR	3
EIF2S3	SCGSSTPDEFPTDIPGTKGNFR	1
ARHGEF28	SATSLESESDNNSCR,AFEQEARPEER,ELTVCSSSEEQK	3
GALNT2	SGGLSVEMCGPALSQQWK	1
IGHG1	SRWQQNVFSCSVMHEALHNHYTQK,SRWQQGNVFSCSVMHEGLHNHYTQK,WQQNVFSCSVMHEALHNHYTQK,LTVDKSRWQQNVFSCSVMHEALHNHYTQK,LTVDKSRWQQGNVFSCSVMHEGLHNHYTQK,WQQGNVFSCSVMHEGLHNHYTQK,GPSVFPLAPSSKSTSGGTAALCLVK	7
MAGEC1	TQSTFEGFPQSPLQIPVSR	1
C8B	YAYLLQPSQFHGEPCNFSDKEVEDCVTNRPCR,EVEDCVTNRPCR,ILGIFELGISSQSDR	3
APOA4	TLSLPELEQQQEQHQEQQQEQVQMLAPLES,TQVNTQAEQLRR,TQVNTQAEQLR	3
UMPS	FIQENVFVAANHNASPLSIKEAPKELSFGAR,RFIQENVFVAANHNASPLSIK,FIQENVFVAANHNASPLSIK,GSDVIIVGR,GGLSSPIYIDLR	5
SPTLC3	DNWNRPICSAPGPLFDVMER	1
CDH11	IAVEDADEPPMFLAPSYIHEVQENAAAGTVVGR,FPQSVYQISVSEAAVPGEEVGR,VTITLTDVNDNPPKFPQSVYQISVSEAAVPGEEVGR	3
PEBP4	HWLVTDIKGADLKEGK	1
COL15A1	WNHFAMIVQGEEVTLLVNCEEHSR,VIWHGSSPHGIR,DLMTDPSWPQK,SSQALAFESSAGIFVGNAGATGLER	4
WASH6P	ATSQGGDLMSDLFNKLVMR,ISQRVEQSRSQVQAIGEK,ATSQGGDLMSDLFNK	3
CFAP410	ELDAEGLEAVR	1
STK10	FFDMELENLER	1
NPHP4	VGEEEILIYINDHENKNEEAFCVK	1
SAMM50	FYLGGPTSVR,QVDVLIDTCQGDGALPNGLDVTFEVTELRR	2
HAAO	VMFVGGPNSR,VMFVGGPNTR,VMFVGGPNTRK	3
CD33	EGAIISGDSPVATNKLDQEVQEETQGR	1
NUBP1	LCASGAGATADTAIEEIK,LCASGAGATADTAIEEIKEK	2
ITGA5	SDFSWAAGQGYCQGGFSAKFTK	1
DPYD	FVNPFGLASATPATSTSMIR,TEQDETGKWNEDEEQMVHLK,EGGANGITATNTVSGLMGLK	3
USP24	NTFQLLHEILVIEDPIQAER	1
CCDC91	EAMKDAVLKVVEEER,LLEVLDTEK	2
ETFB	QAIDDDCNQTGQMTAGFLDWPQGTFASQVMLEGDKLKVER	1
SYTL4	RDTVNPLYDETLRYEIPESLLAQR,DTVNPLYDETLR,DTVNPLYDETLRYEIPESLLAQR,TSIKRDTVNPLYDETLR	4
PRCC	GPGLNLPPPIGGAGPPLGLSKPK,GPALLPPPPQMLAPAFPPLLLLPPPTGDPR	2
HSPG2	AAGGPGPEQEASFTVTVPPSEGSSYR,GSIYIGGAPDVATLTGGR,GMLEPVQRPDVVLVGAGYRLLSR,PHHFHLSASNPDGCVPCFCMGITQQCASSAYTR,SPLPWQYR,LENNMLMLPSVRPQDAGTYICTATNR,CSATGSPVPTIHWSK,TYGLMDSHTVLQISSAK,YELARGMLEPVQRPDVVLVGAGYR,LRSPLPWQYR,LENNMLMLPSVQPQDAGTYVCTATNR,LHHVFPADSGEYVCR,GMLEPVQRPDVVLVGAGYR,CTATNAAGTTQSHILLLVQALPQISMPQEVR,TYGLMDSHTVLQISSAKPSDAGTYVCLAQNALGTAQK,GNVYIGGAPDVATLTGGR,ASYAQQPTESR	17
LMOD1	QMPSGPTKPSEGPAK,QMPSGPTKPSEGPAKVEEEAAPSIFDEPLER	2
ENPP2	VNSMQTVFVGYGPTFK	1
SENP6	LSENMQNTSLCSGTVVHGR	1
PAICS	VELFFKDDANNDPQWCEEQLIAAK,DDANNDPQWCEEQLIAAK	2
ABCB1	NVHFNYPSRK,NVHFNYPSR	2
FBN2	SIHQPDPTAVEQISLESVDMDSPVNMK,IKGVTCEDVNECEVFPGICPNGR,GVTCEDVNECEVFPGICPNGR	3
OVGP1	TLTPVGHQSVSPGGTTMTPVHFQTETLR,TEITGATTVTSVGHQSMTPGEK,KEIPENSAVDQEA,TEITGATTMTSVGHQSMTPGEK,EIPENSAVDQEA	5
KRT20	QIEELRNQIKDAQLQNAR,NQIKDAQLQNAR,QIEELRNQIK	3
CEP170	LQSAGSAVPTSSSFK,TNGKPEEKNHEAGTSGCSIDAK,NHEAGTSGCSIDAK	3
CHGA	NKAPGEEEEEEEEATNTHPPASLPSQK,RGWRPSSWEDSLEAGLPLQVR,GWRPSSWEDSLEAGLPLQVR,SGELEQEEEWLSKEWEDSKR	4
ITIH4	LLGLPGPPDVPDHAAYHPFR,NPPVWVHASPEHVVVTR,LLGLPGPPDVPDHAAYHPFRR,LAILPASATPATSNPDPAVSR	4
JPH2	TKAEAAEQAALAANQESNIAR,DSLLSPGAWNGEPSGEGSR	2
TBC1D10A	AILDAEPGPRPALQPSPSIHLPLDAPLPGSK	1
RBFA	GLGGLVWQGQVAELTTQMQK,DKGLGGLVWQGQVAELTTQMQK	2
HEBP1	GEIYFCTGYDPPMKPYGR	1
ASMTL	HDPIPAADTFEDLSDVEGGGSEPTQR,FSSACDMGGCTGALAR,SVKHDPIPAADTFEDLSDVEGGGSEPTQR	3
RNF146	LLVSNANQTVPNRSDR	1
NANS	ALDRPYTSK	1
IGHV3OR16-13	EFGLSVFLVAILKGVQCEVQLVESGGGLVQPGGSLR,EFGLSVFLVAILKGVQCEVQLEESGGGLVQPGGSLR	2
LSR	NSSAGGQGSYVPLLR,SVDALDDLTPPSTAESGSRSPTSNGGRR	2
LYAR	EQNQRPLHPVANPHAEISTK	1
KRT82	ELDVDSIIAEIK	1
PRKDC	LLEEALLCLLPAELPAK,LLEEALLCLLPAELPAKR,KEEENASVTDSAELQAYPALVVEK	3
GLTPD2	VATGALGGPEAGVQCSDAYR	1
IGHV3-64	MMEFGLSWVFLVAIFKGVQCEVQLVESGGGLVQPGGSLR,MTEFGLSWVFLVAIFKGVQCEVQLVESGGGLVQPGGSLR	2
SMARCAD1	VFAEDQDMQYASQSEVPNGK,LDHGEESNESAESSNNWEK	2
CRIP1	CGKTLTSGGHAEHEGKPYCNHPCYVAMFGPK,PYCNHPCYVAMFGPK	2
PLIN4	DTVCSGVTGAAK,EDTGLLTTTHGPEEAPR,TTQNIATGTKNTLGSGVTGAANVAK,SVLTGTKDTVSTGLTGAVNLAK,NTLGSGVTGAVNVAK,NTLGSGVTGAANVAK,EAVSSGVTGAMDMAK,TVLTGTKDTVCSGVTSAMNVAK,GLATDVATFTQGAAPGREDTGLLTTTHGPEEAPR,DTVCSGVTSAMNVAK,GAMQTGLNTTQNIATGTKDAVCSGVTGAMNLAR,TTQNIATGTKNTFGSGVTGAANVAK,DAVCSGVTGAMNLAR,TVLTGTKDTVCSGVTGAAK	14
UBP1	LYDETLTYLNQGQSYEIR	1
PPIL3	TYRPLNEVHIK	1
CPPED1	TLDAFPAEKESEWKGPFYFILGADPQFGLIK,KLADKFIHAGVR,TLDAFPAEK,TLDAFPAEKESEWK	4
TRIP11	DKEFHSNQELER,EEMEQLFHDDQGSVTR,REEMEQLFHDDQGSVTR	3
RAB6C	DSAAAVVVYDITDVNSFQQTTK	1
HSD17B7	MDLDEDTAEKFYQKLLELEEHIR,LLELEEHIR	2
ATP5PO	SLNDITAR	1
GLI4	IHTGEKPYECADCGK	1
CROCC2	SSQALVASLR,AEVSPEPLR,PQATQALESQEWTHQQR,LHGARPQATQALESQEWTHQQR,SSELMDVATVQDVLR,AHLWELEQAR	6
EVPL	NPPQQPLHVDSICDWDSGEVQLLR,LVDNTEPHAWVVQGPGGETK	2
KNOP1	NHQEGDALPGHSKPSR	1
COMT	MVDFAGMK,ILNHVLQHAEPGNSQSVLEAIDTYCEQKEWAMNVGDK,MVDFAGMKDK	3
CD226	SPISTGQPTNQSMDDTREDIYVNYPTFSR	1
EEA1	QEEEKQILKQDFETLSQETK,QILKQDFETLSQETK	2
CENPV	SGASGASAAPAASAAAALAPSATRTR,SGASGASAAPAASAAAALAPSATR,RSGASGASAAPAASAAAALAPSATR	3
PALM	EIEVLERGDSAPAAAK,LEKEIEVLERGDSAPAAAK,GDSAPAAAKENAAAPSPVR,EIEVLERGDSAPAAAKENAAAPSPVR	4
FCGBP	NENRGNPAVSYVR,YQKEEFCGLLSSPTRPLSSCHK,KFDFQGTCNYVLATTGCLGVSTQGLTPFTVTTKNENR,ALASYVAACQAAGVVIKDWR,EEFCGLLSSPTRPLSSCHK,LRLPAAYAASLCGLCGNYNQDPADDLK,VTYDLVYYVR,KFDFQGTCNYVLATTGCLGVSTQGLTPFTVTTK,LRVSAAYAASLCGLCGNYNQDPADDLK,ALASYVAACQAAGVVIK,KFDFQGTCNYVLVTTGCPGVSTQGLTPFTVTTK,GCVLDVCMGGGDHDILCK	12
UHRF1BP1	SDASSDQGPASPQK	1
IGHA2	DLCGCYSVSSVLPGCAQSWNHGETFTCTAAHPELK,SAVQGPPDRDLCGCYSVSSVLPGCAEPWNHGK,DASGVTFTWTPSSGKSAVQGPPDR,YLTWASRQEHSQGTTTFAVTSILR,SAVQGPPDR,YLTWASQQEPSQGTTTYAVTSILR,EKYLTWASQQEPSQGTTTYAVTSILR,SAVQGPPDRDLCGCYSVSSVLSGCAEPWNHGK	8
HIBCH	KGCAGVITLNRPK,SLFAMPETAIGLFPDVGGGYFLPR	2
EEF1D	AFVEWSQALLLAPEGSRR,RANGEAPSALPYCYFLQK,AFVEWSQALLLAPEGSR,SGLGPVDLALLGLSAER	4
ARHGEF16	YFHPYIAYCSNEVYQQR,AQVLVEDISDILEEHAEKYFHPYIAYCSNEVYQQR	2
SBF2	VLGFPLCVSLNISPGFR,SQNSPEAAPTSSLESSSSIEQEKYLQALLNAVSVHQK	2
MTG1	VLTGTGNVNVIQPNYPAAARDFLQTFRR,VLTGTGNVNVIQPNYPAAAR	2
TMEM120B	QDVFFNMEAYLPK	1
VWF	IALLLMASQEPQR,VALLLMASQEPQR,HGAGVAMDGQDIQLPLLK	3
MYH14	KAPPRPGPVPEAAQPFLFTTR,IHEEAVQELR	2
SYNE2	QATSDVQESTQESATVEK,LHQQEKENPDSFLNHVLALTAQSPNIEHLNEVSLK,QATSDVQESTQESATVEKLEEDWEINKDSAVEMAMSK,EFVSFSDKPVDQIVVEEK,TYTTELEDLRQEASNLQTQENMTEEAYINLDKK,TNVLNHAYENLTR,IVPPVPPASSTPYKPPYGK,ENPDSFLNHVLALTAQSPNIEHLNEVSLKLPLSDVAVK,IQILNNWMEAQEER,DKVPSLTTYEGGDLNNTLEDLR,QLVASVSCAELEGQIAK,QEMECCLNNILK,LENHVNDLK,ENPDSFLNHVLALTAQSPNIEHLNEVSLK,EKQATSDVQESTQESATVEK,QATSDVQESTQESATVEKLEEDWEINK,LLEHVTQEQNELLK,QEELESTVAR,LNAEESDKLYK,FQQLANISMSGNNLAEILPPALQDIKELQHNVQK	20
BAG3	IDPQTGWPFFVDHDSR,AAPSTAPAEATLPKPGEAEAPPK,AAPSTAPAEATLPKPGEAEAPPKHPGVLK,GMPETTQPDKQR,QRGQVAAAAAAQPPASHGPER	5
PTPRG	HQSPIDILDQHAR,HISELYSNNQHGFSEDFEEVQR	2
HAUS3	EFYVYFLKDEDYLKDTVENLETQSK	1
LRRK2	TLINESLNFK,KNVSIEFPVIDR,KTLINESLNFK	3
BCL2L15	NVIAETIKGQTGAILQNTVESLSK,GQTGAILQNTVESLSK	2
ALDH16A1	LSCLSKNLNYDTFGLAVPSTLPAGPEIGPSPAPR,GATACDLVQR	2
PTGR1	TSELPPLKNGEVLLEALFLTVDPYMR	1
AKR1C3	QQCVKLNDGHFMPVLGFGTYAPPEVPR,MDSKQQCVK,RGDIFYTSK	3
DMAC2	CSHVDDWCLSR,LGAAVAPEGSQK,LGAAVAPEGSQKK	3
PDCD6IP	EPSAPSIPTPAYQSLPAGGHAPTPPTPAPR,DLQQSIAREPSAPSIPTPAYQSLPAGGHAPTPPTPAPR,TMQGSEVVSVLK	3
EHBP1L1	HAGPVPVQVPLR	1
CALHM6	STEGDTVIPVLGFVDSSGIK	1
ADA2	IKFPTVVAGFDLVGHEDTGHSLR	1
MAP1A	DKALEQKNTALEQK,DTALEQKDKTLEPK,YSAQADITDDSLDR,AEGEREEEGRAEAPDESSHSSK,EEMGHLMQAENTSHHTAPMSVPEPHAATASPPTDGTTR	5
PML	AQTLGAVVPPGDSVR,VVIQPEALFSIYSK	2
SNX19	IQDALCALEGSQALEPK,ETIMLMTPGSFLSER	2
PALLD	FGHGQTPAAFLSALLPSQPPPAAVNALGLPKGVTPAGFPK,FGHGQTPAAFLSALLPSQPPPAAVNALGLPK	2
KTN1	LQALANEQAAAAHQLEK,QTEDSLASERNR,AEVQKLQALANEQAAAAHQLEK,DIQNMNFLLKAEVQKLQALANEQAAAAHQLEK	4
MAPT	EEVDEDRDVDESSPR	1
NMI	EHLPDEFIKDEQNKGLIDEITK,EHLPDEFIKDEQNK	2
NUDCD1	IMNLTVMLDTALGKPQEVFR,LMHLTSEELNPHPDK,SFTFVQAGQDLEENMDEDVSEK	3
SAA1	GPGGVWAAEAISDARENIQR,RGPGGVWAAEAISDAR,GPGGAWAAEVISDAR,GPGGVWAAEAISDAR,RGPGGAWAAEVISDAR,RGPGGVWAAEAISDARENIQR,GNYDAAKRGPGGVWAAEAISDAR	7
H1-6	SETVPAASASAGLAAMEK	1
ITIH5	PGGDGEGDPNHIER,LIDGEYKDYLASHPFDTGMTLGQGMSR,DVTGSPRPGGDGEGDPNHIER,VYIHHMSPTGGTDINGVLQR,AGKDVTGSPRPGGDGEGDPNHIER,DYLASHPFDTGMTLGQGMSR	6
COPRS	GAPPSPEAGFATADHSGQERETEKAMDR,GAPPSPEAGFATADHSGQERETEK	2
ANXA4	SELSGNFEQVIVGMMMPTVLYDVQELRR,ISQTYQQQYGRR,DLIDDLKSELSGNFEQVIMGMMTPTVLYDVQELRR,DLIDDLKSELSGNFEQVIVGMMMPTVLYDVQELRR	4
CYP4F11	FNQENIKER,RTLPTQGIDDFLK	2
FGA	VELQDWAGNEAYAEYHFR	1
APIP	ERIQPEDMFVYDINEK,IQPEDMFVYDINEK,IQPEDMFVYDINEKDISGPSPSKK,IQPEDMFVYDINEKDISGPSPSK	4
LONP1	VLFICTANITDTIPEPLRDR	1
ABI3	LSAASSASSLASAGSAEGVGGAPTPK	1
TASOR2	NAHVPIQTEGVNTADEPTTFKK	1
GOLGA1	RLEQNLSGEEHVQELLKEK,LEQNLSGEEHVQELLKEK,LEQNLSGEEHVQELLK,RLEQNLSGEEHVQELLK	4
SEMA4B	GYQSLSDSPPGAR	1
RNLS	FYDELLAYGVLRPLSSPVEGMVMK	1
SPATA7	AAVDCSVPVSMSTSIK	1
SPATA18	QNADQQDTEAMPDYKK,EQWNSLKQNADQQDTEAMPDYKK	2
JHY	EESLPEISLLELLQNR	1
SULT1A1	TPMTNYTTVR,SLPEETVDFMVQHTSFKEMK,KTPMTNYTTVR,ILEFVGHSLPEETVDFMVQHTSFK,SLPEETVDFMVQHTSFK	5
ZNF638	SVVSDVPEELDFLVPK	1
NUP153	KPAFNLSAFGTLSPSLGNSSVLK,ISLLITSSSLPTFNFSSPEITTSSPSPINSSQALTNK,WPENKEDHLVYANEESSNITDGR	3
SNCG	EDLRPSAPQQEGVASK,KEDLRPSAPQQEGVASK	2
PRODH2	EQELLSQELWQR	1
SVEP1	DIIISPHNCGK,EVTFHCHEGYVLHGAPK	2
AIMP1	QIAFPSGTPLHANSMVSENVIQSTAVTTVSSGTK	1
SEPTIN4	IREEIVHFGIK	1
GOT2	TCSFDFTGAVEDISK,FSRNVFLPKPTWGNHTPIFR,GMADRIIGMR,NVFLPKPTWGNHTPIFR	4
PCNT	SHTLELSEALR,NLYEKLQHETR,TEASTELAGTVAHELQGVHQGEFGSEKK,TQEACVHQDTQAHHALLRK,TEASTELAGTVAHELQGVHQGEFGSEK,AALQELESEHGK	6
IRF3	AYLQDLVEGMDFQGPGET	1
HEXD	LHVGCDEVYYLGEGEASRR	1
EPCAM	AKPEGALHNNDGLYDPDCDESGLFK,RAKPEGALHNNDGLYDPDCDESGLFK	2
GPX1	FQTIDIEPDIETLLSQGPSCA,LAAAAAAQSVYAFSARPLAGGEPVSLGSLR,LAAAAAQSVYAFSARPLAGGEPVSLGSLR,RFQTIDIEPDIETLLSQGPSCA	4
CORO7	QLQIFDPR,DKQLQIFDPR,LPDTALPTLQNGAAVTDLAWDPFNPHR,KPGRLPDTALPTLQNGAAVTDLAWDPFNPHR,LPDTALPTLQNGAAVTDLAWDPFNPHRLAVAGEDAR	5
CCL14	IMDYYETNSQCSEPGIVFITK	1
TMPO	AMQADISEAAQILSSDPSR	1
IGHV3-13	GLEWVSAIGTAGDTYYPGSVK	1
SCRN3	DEIQIYQSK,IVNLFPQCTKDEIQIYQSK	2
ALPP	DKLGPELPLAMDR,LGPELPLAMDR,DKLGPELPLAMDRFPYVALSK,LGPELPLAMDRFPYVALSK	4
MRPL23	NVVYPLYQLGGPQLR,TNFFIQLVRPSVAQPEDTVQFR	2
MYOM1	NLLASEEGITTPK,NGICTLLITEFSKK,ENMVYQFQVAVMNMAGLGAPSAVSECFK,YGMHTLEINACDFEDTAQYR,EISVDEKHDFKNGICTLLITEFSK	5
TNFRSF11A	NTECAPGLGAQYPLQLNK	1
SCN5A	DLGSEADFADDENSTAGESESHR	1
SORD	KVEGLLGCKPEVTIECTGAEASIQAGIYATR,VEGLLGCKPEVTIECTGAEASIQAGIYATR,SGGTLVLVGLGSEMTTVPLLHAAIR	3
WASHC4	LGITPEGQSYLDQFR,KLGITPEGQSYLDQFR	2
DDX31	SEYSSGMEADVAK	1
GSPT1	GPAAPPPPAGGAANNHGAGSGAGGR,CPAAPPPPAGGAANNHGAGSGAGGR	2
FABP1	TVVQLEGDNKLVTAFK,VKTVVQLEGDNKLVTAFK,TVVQLEGDNKLVTAFKNIK	3
DAPL1	IQTLDALNDTLEK,IQTPDALNDALEK	2
GBF1	GGSPSALWEITWER	1
MAST2	SGLITSQYFYELQENLEK	1
DMXL2	FGDTEADSPNAEEAAMQDHSTFK	1
PIGR	GVAGSSVAVLCPYNRK,YLCGAHSDGQLQEGSPIQAWQLFINEESTIPR	2
SPARCL1	KAENSSNEEEASSEGNMR,AEDEENEKETAVSTEDDSHHK,AEDEENEKETAVSTEDDSHHKAEK,TGLEATSNHKETEEK	4
DNAJB12	QYDQFGNDKSQAAR,KQYDQFGNDKSQAAR	2
SCAF1	AARPPPAASATPTAQPLPQPPAPR	1
RUNDC1	GCPHVLGYEGPGDPASDEGDGLPGDRPR	1
SPEN	VVAPVESHVPESDQAQGESPAANEGTTVQHPEAPQEEK,LGEPAGESVENQEVQSK,KVVAPVESHVPESDQAQGESPAANEGTTVQHPEAPQEEK	3
AGL	FPSLPILSPALMDVSYR,HLSLGSVQLCGVGKFPSLPILSPALMDVSYR	2
ERCC2	QMAQPFHREDQLGLSLLSLEQLESEETLQR,ETDAHLANPVLPNEVLQEAVPGSIR	2
SLC4A2	GADSFCTPEPESLGPETPGFPEQEEDELHR	1
WDFY4	MSVPGRPAGEEPLAQPPSPR,IPTIIGILACQLR,APEFLQTLAIAAFPLGSQK,STEGMDIVMDNLK	4
PTK2B	SLDPMVYMNDTSPLTPEK	1
SCRN2	QSGICMDSGGFR,DKQSGICMDSGGFR,SVFKPFIFGVGVAQAPQVLSPTFGAQDPVRTLPR,SVFKPFIFGVGVAQAPQVLSPTFGAQDPVR	4
DENND2B	TFEYEAEKNPK,RTFEYEAEKNPK,RTFEYEAEK,NTGTLGSLEEPAGGASVSAGSR	4
GOLGA4	DLHQEAETYR,QHEDQSMTGHLQEELEEK,LIKLEHAEAKQHEDQSK,EKIESLTEVHR	4
DTX3L	DKQVDLSVHAYASFIDAFQHASCQLMR	1
DNAJC10	LHPDKNPNNPNAHGNFLK,LHPDKNPNNPNAHGNFLKINR,AYQYHSYNGWNRDAYSLR,LALKLHPDKNPNNPNAHGNFLK,AYQYHSYNGWNR,EIYLEVIHNIPDFELLSANTLEDR	6
LNPK	ECEPPSAGAAVSAR,ECEPPSAGAAVSARPGQEIR,AKECEPPSAGAAVSARPGQEIR	3
MYPN	SPGGLSIQNEPLPPGPTEPTPPPFTFSIPR	1
ERAP1	QTWTDEGSVSEQMLR,TMMNTWTLQR,SELLLLACVHNYQPCVQR	3
CYP2C9	RSIEDCVQEEAR,YLDLLPTSLPHAVTCDIK,ERQESMDMNNPQDFIDCFLMK,VKERQESMDMNNPQDFIDCFLMK	4
ACTN2	KHEAFESDLAAHQDRVEQIAAIAQELNELDYHNAVNVNDR,VEQIAAIAQELNELDYHNAVNVNDR,HEAFESDLAAHQDRVEQIAAIAQELNELDYHNAVNVNDR	3
SULT2A1	NSSFQSMKENEMSNYSLLSVDYVVDK,GVSGDWKNHFTVTQAEDFDKLFQEK	2
ENPP1	DQGDCCINYSSVCQGEK,SLCACSDDCKDQGDCCINYSSVCQGEK	2
ZNF598	VGSEKPGTTLPQPPPTTCPPGALQAPEAPASR	1
PAK6	GSAVPVDGYISGLLNDIQK	1
HLA-DQB1	VCRHNYEVAYR,EEYVRFDSDVGVYR,HIYNREEYVRFDSDVGVYR,TEALNHHNLLICSVTDFYPSQIK,HNYEVGYR,HIYNREEYVR,PSAEYWNSQK,HIYNREEYAR,AVTPQGRPVAEYWNSQK,HNYEVAYR	10
SPTBN2	TPEVQGRVPTLERHYEELQAR,AYAGDKAEEIGHHMQAVAEAWAQLQGSSAAR,EANALAAGHPAQAAAINAR	3
PLEKHG1	FVDADFSDNVCSGNTSHSLNSPR	1
COMMD3	GFQMLADPGSFDSNAFTLLLR	1
C8G	GAVNVVVAETDYQSFAVLYLER	1
CUL3	QLTLQHHMGSADLNATFYGPIKK,QLTLQHHMGSADLNATFYGPIK	2
AP5Z1	APSCLEAFQDPQFQGLFQYLLRPK	1
VWA8	ILPPGEVPLKDLYPKDVTPPQTSGYIEVTDLQSK,AGTAFYIDQCAVHAATEGR,ETQDPTAQSLAASLSTGQLLR,MTENHVSQASVTIR,LRETQDPTAQSLAASLSTGQLLR	5
FAM120B	QEVPTCSDPEPR,QEVPMCTDSEPR,QEVPMCTGPEPR,EVPVYTYSEPR,REVPVYTYSEPR	5
HLA-C	GEPREPWVEQEGPEYWDR,YFSTSVSWPGR,YFSTSVSWPGRGEPR,EPWVEQEGPEYWDR,GHDQLAYDGKDYIALNEDLR,GHDQLAYDGKDYIALNEDLRSWTAADTAAQITQR,GYDQFAYDGK,GYDQFAYDGKDYIALNEDLR,YFYTAVSRPSR,MFGCDLGPDGR,SWTAADTAAQISQR	11
TAP2	QPNLPSPGTLAPTTLQGIVK	1
MMP24OS	HPPQPQPQPQPQPQPQPEPEPSPWGPLDDVR	1
DNAAF1	ESFEAKDELCPERPSGEEPPVEAK	1
RBM19	AETEKPANQKEPTTCHTTVK,NLPAGTLAAELQETFGHFGSLGR,NLPAGTLAAELQETFGR	3
PPP2R3A	SVDLDLLCGHYNNDGNSPSFGLLR,IETAFMDIEEQKANIYEMGK	2
WNK1	RTLSPEIITVTSAVGPVSMAAPTAITEAGTQPQK,TLSPEIITVTSAVGPVSMAAPTAITEAGTQPQKGVSQVK	2
SLC38A10	DLGPHAEGQLAPRDGVIGLNPLPDVQVNDLRGALDAQLR,DGVIGLNPLPDVQVNDLRGALDAQLR,SLEHSEGPVGRDPAGPPDGGPDTEPRAAQGK,DGVIGLNPLPDVQVNDLR,DGVIGLNPLPDVQVNDLRGALDAQLRQAAGGALQVVHSR	5
PLEKHA7	AIIYNSSTAGSQAEQSGMR,ESTEMENAWDEYLKLENDVEQLK	2
CAPN2	EAAEGLGSHER,DREAAEGLGSHER,RQDIQSDGFSIETCK,LAKDREAAEGLGSHER,QDIQSDGFSIETCK	5
TAPBPL	VAKNEVLWHPTLNLPLSPQGTVR,NEVLWHPTLNLPLSPQGTVR,AVDVVLDCFLVK	3
NAPRT	LTENPEKQTLPGSK,MKLTENPEK,MKLTENPEKQTLPGSK	3
KRT79	KQCQQLQTAIAEVEQR,QCQQLQTAIAEVEQR	2
ACAA2	GKQTVQVDEHARPQTTLEQLQK,QTVQVDEHARPQTTLEQLQK	2
KCNJ11	LAEDPAEPR	1
TUBB8B	LHFFMPGFAPLTSQGSQQYR	1
DYNC2H1	SEGLPSDDLSIENALVIIQSR,AYGATPSQYMTFLHVYSAISSSK	2
FSIP1	VDTASNLNSGKQDHSESSNTENR	1
RASA4B	HRELSGGTEAGTVPTSPGK,LVDIEEKDELDLRR,VTLQEWNDPLDHDLEAQLICR	3
RASA4	HRELSGGTEAGTVPTSPGK,LVDIEEKDELDLRR,VTLQEWNDPLDHDLEAQLICR	3
ASCC3	TSIECLPELIHACGGK,IISHFSQDDFTALVQMTEK	2
SELENBP1	GGPVQVLEDK	1
KARS1	KENVATTDTLESTTVGSSV	1
PAM16	LDEELKIQAKEDR	1
SDHAF1	APTGEPGGVGSQPDDGDSPR,APTGEPGGVGSQPDDGDSPRNPHDSTGAPETRPDGR	2
NRAP	GTAHYHSLPAQDNLVLKR,GTAHYHSLPAQDNLVLK,VYGLQSELQYK,MKGTAHYHSLPAQDNLVLKR,AYWTGYGEGNSWCPGALPDPEIVR,FSTVADTPELLR,GLQIGYCSVDDDPR,MKGTAHYHSLPAQDNLVLK,KVYGLQSELQYK	9
TBC1D1	AILQQLLLLR,GSESPRPNPPHAAPTGSQEPGR,EDAVHWQSICYVFK	3
SPRR1A	TKEPCQPKVPEPCHPK,IPEPCQPK	2
WDR45B	GLCVLCPNSNNSLLAFPGTHTGR	1
GTF3C3	SQDKDVSEGETSDGVR	1
UQCRC1	HLGGIPWTYAEDAVPTLTPCHFTGSEIR	1
EVPLL	YIEQLHER	1
TMX4	SEANDQGPPREDGVTR	1
FRAS1	VENLLFHVVSTPTNGQLVLSR,HQHVCSNLVTTDDLR,GQFVMEHHTLPDVK,AHFYLESTGLCEACHQSCFR,FRGQFVMEHHTLPDVK,KPEEGLQVEQLSGVGIPSGECLAQCR,TSNGQHFHLTSTFTMEDIYQNR,DYSGEYTIYLIPCTVQPTQPWADPGEKPLACTAHAPER,DSKPNVVSNNVFHIQWSLISFK	9
DSP	RGQSEADSDKNATILELR,EIMWINDCEEEELLYDWSDKNTNFAQK,GQSEADSDKNATILELR,QVMQQRSEDNAQHK	4
PRDM2	LTPPAGISATEIAK	1
DHRS4	MASSGMTHRDPLANKVALVTASTDGIGFAIAR	1
MUC5B	LSQTTTPTATMSTATPSSTPETVHTSTVLTTTATTTR,TTESPPSPGTTTLGHTR	2
IFITM1	MHKEEHEVAVLGAPPSTILPR,PLPLPQGLR	2
CDC42BPG	SNNIFQVGECR	1
MAN2B2	VTQEFLEYHVNR,DMYATHLASGMLGVR,DMYATHLASGMLGVRK	3
ZNF22	SFGQSSTLFQHQK	1
LRP1	QWECDGENDCHDQSDEAPKNPHCTSPEHK	1
BAIAP2	SMSRNPFAHVR	1
MPP7	ALFNYNPNEDK,ALFNYNPNEDKAIPCK,ALFNYNPNEDKAIPCKEAGLSFK	3
ARL2	EALELDSIR	1
NUDT19	EAFEEAGVLLLQPR	1
SERPINA1	PFVFLMIDQNTK,FNKPFVFLMIDQNTKSPLFMGK,FNKPFVFLMIDQNTK,AVLTINEKGTEAAGAMFLEAIPMSIPPEVK,AVHKAVLTINEKGTEAAGAMFLEAIPMSIPPEVK	5
PRH2	PQGPPQQGGHPPPPQGRPQGPPQQGGHPCPPR,PQGPPQQGGHPCPPR	2
H2AC15	KGNYAERVGAGEPVYLAAVLEYLTAEILELAGNAAR,GNYAERVGAGEPVYLAAVLEYLTAEILELAGNAAR	2
C1RL	VQNHCQEPYYQATAAGALTCATPGTWK,WILTAAHTVYPK	2
BSN	PRPESSQEPAALPK,QQGQAAGARGPHDGPSQPTGPR,PLLQAQGLTPSER,GPHDGPSQPTGPR	4
GIPC1	SAGGRPGSGPQLGSGR	1
PALMD	EKWLLDGISSGKQQEEMK	1
GPRIN2	AVATSPSLEAPAALHVFPEVTLGSSLEEAPSPVR,EVGAGGCCHALPATGILAFPK,SSSHPEPGPWAPLSPR,AVATSPSLEAPAALHVFPEVTLGSSLEEAPSPVRDVR	4
CRYZ	VLGTAGTEEGQK	1
SEC16B	NASPSGDEDSSDSPDSEETPR,FYIPHVPVSFGPGGQLVR	2
SOGA1	RGPGPGSAVACSAASSSRPDK	1
ICAM5	EGLPWPEQQR	1
FREM2	EGETQHVVEIEVIFDGVR,IIMATDLDSEDKSLVYIIR,IIMATDLDSEDK	3
PNPLA7	QVFYGEEEQLK	1
OLFML1	EADECIVSEDK,TLVYQHSPSTYIDLAVDEHGLWAIHSGPGTHSHLVLTK,EADECIVSEDKTLAEMLLQEAEEEK,EADECIVSEDKTLAEMLLQEAEEEKK	4
HIP1R	QEELGAMVDKEMAATSAAIEDAVR,QEELGAMVDK	2
TEKT3	MEHVGCTLTTTYAHPRPTPTNFLPAISTMASSYR	1
SPTB	VIQGQTDPEYLLLGQRLEGLDTGWDALGR,ETWLNENQR,WISAMEDQLQSDDPGK,WISAMEDQLQSDDPGKDLTSVNR,LEGLDTGWDALGR,LQTHADLNKWISAMEDQLQSDDPGKDLTSVNR,AAMRETWLNENQR	7
ARSB	TISEGNPSPR,ELIHISDWLPTLMK	2
MACF1	SRLETMNQCWESVLQK,GLNLEEITVSRPDSK,ETEGSIPPTETSVSAK,LETMNQCWESVLQK,ATDETDRDIIREPLTELR,TLLPEDTQKLDNFLGEVR	6
H1-2	SETAPAAPAAAPPAEKVPVKK	1
ASAH1	LTIYTTLIDVTK,VMQVVDEK,VMQVVDEKLPGLLGNFPGPFEEEMK,DAMWIGFLTR,WHELMLDKAPMLK,KDAMWIGFLTR	6
TXNDC11	YPEDLPITLPNLLR,DLSVKYPEDLPITLPNLLR	2
GFAP	QLQSLTCNLESLR,KTSLDTKSVSEGHLK,VIPIQAHQIVNGAPPAR,QLQSLTCNLESLRGTNESLER	4
USH1C	IVTDYTLAEADAALQK	1
NFU1	TMDFPTPAAAFCSPLAR	1
FGD5	ANNSMEQGENLQK	1
IDUA	LGGPGNSFHTPPRSPLSWGLLR,LGGPGNSFHTPPR	2
SOD3	RDDDGTLHAACQVQPSATLDAAQPR,DDDGTLHAACQVQPSATLDAAQPR	2
CLDN23	YYSDGQHRPSPAQHR	1
NRCAM	NEVHLEIKDATWIVKQPEYAVVQR	1
ATG16L1	SVSSFPVPQDNVDAHPGSGK,RSVSSFPVPQDNVDAHPGSGK	2
CHDH	LTEDPAERVLLLEAGPKDVR,DAYSYVVVGAGSAGCVLAGR,VLLLEAGPKDVR	3
USP36	LGSETCLPQHIR,TFVGEPQRLGSETCLPQHIR	2
AGXT2	IAPSMCITKPEVDFALEVFR,GAYHGCSPYTLGLTNVGIYK,EHLSPVVTAYFQKPLLLHQGHMEWLFDAEGNR,REVDFAVEVFR	4
ECH1	LTGSSAQEAASGVALGEAPDHSYESLRVTSAQK,LTGSSAQEAASGVALGEAPDHSYESLR,NHSVAESLNYVASWNMSMLQTQDLVK	3
CFH	SPPDISHGVVAHMSDSYQYGEEVTYK,SLGNIIMVCR	2
GBP3	DKNFNLPQLCIWK,NFNLPQLCIWK	2
EPPK1	LLEAQIATGGVIDPVHSHRVPVDVACR,EGQGEGETQEAAAAAAAR,EGQGEGETQEAAAAAAR,AITGYTDPYTGQQISLFQAMQK,GFFDPNTHENLTYVQLLQR,LTAIIEEAEEAPGAWPQLQDAWR,GMLQPGTALVLLEAQAATGFVIDPVR,FLNPNTLER,EGQGEGETQEATAAAR,EELLAEFGSGTLDLPVLTR,LAAELSATLEQAAATAR,STTQELMEDDCVKR,MSIYQAMWKGVLQPGTALVLLEAQAATGFVIDPVR,AEAEAGSPRPEPR,EGQGEGETQEAAAATRR,EGQGEGETQEAAAAAAAAAR,EELLAESGSGTLDLPALTR,LTAIIEEAEEAPGARPQLQDTWR,AVPVWDVLVSGYVSGAAR,QVVSAVTALVEAAER,RLTAIIEEAEEAPGARPQLQDTWR,CRPQEDTGWVLFPVNK,VIAETEER,VPVDVACR,EGQGEGETQEAAAAAAAAR,EGQGEGETQEAAAATR,MSIYQAMWKGMLQPGTALVLLEAQAATGFVIDPVR	27
DEPTOR	LMEHGIIQHVSSK,TVNNLILTGPR	2
IFI35	VQVQPLELPMVTTIQVSSQLSGR	1
ADPRS	LSAQLTHASSLGYNGAILQALAVHLALQGESSSK	1
FAM110C	TGDEGKAGNPETVPTTPGPAADPATPETPAPAAR	1
PSMD9	QSGGSSQAGAVTVSDVQELMR,QSGGSSQAGAVTVSDVQELMRR	2
MYH9	DLEAHVDSANK,DLEAHVDSANKNR,KLEMDLKDLEAHVDSANK,LEMDLKDLEAHVDSANK,DLEAHVDSANKNRDEAIK	5
PLCB3	LRPGALVGAADVEDTKEGEDEAK	1
CR1	SFFSLTEIIR,TPPDPVNGMVHVITDIHVGSR,SFFSLTEIVR,VCQPPPEILHGER	4
CKAP4	EAADTERLTLQALTEK,KPPPAPQQPPPPAPHPQQHPQQHPQNQAHGK	2
NUCB2	EFLEPDSWETLDEQQFFTEEELKEYENIIALQENELKK,KLQGIPPSGPAGELK,KEFLEPDSWETLDEQQFFTEEELKEYENIIALQENELK,KLQGIPPSGPAGELKFEPHI,LQGIPPSGPAGELK	5
PTPN12	IADGVNEINTENMISSIEPEKQDSPPPKPPR,KTVSLTPSPATQVETPDLVDHDNTSPLFR,TVSLTPSPATQVETPDLVDHDNTSPLFR	3
MTA1	QVYIPNYNKPNPNQISVNNIK,SYEQHNGVDGLANHGQTR,GTYLGLANHGQTR	3
GRIPAP1	EAGKFSAVSEGQGDPPGGPAPTVLAPMPLAEVELK	1
PPA2	NCNGGAINCTNVQISDSPFRCTQEEAR,NCNGGAINCTNVQISDSPFR,ALLMKNCNGGAINCTNVQISDSPFR	3
MMP11	ALPPDVHHLHAER	1
STX17	TVIPTDLER	1
RNF213	IMCTVDHQGQR,VLQEQHQLSSR,TTDNFDDILK,HILELQEVYDYLYQPSYR,EIAAVISPELER	5
PYGB	LKQEYFVVASTLQDIIR,WLLLCNPGLANTIVEK,RWLLLCNPGLANTIVEK,QEYFVVASTLQDIIR	4
EPG5	KHEAPQPPLVLHPTKPPVPVISSAVLLSQK,ETQNSKEDEQGLVCSSEVPQNVGLQSSCPAKHGFQTPR	2
NCAPD2	SIDPGLKEDTLEFLIK,GKPEIVGSNLDTLMSIGLDEKFPQDYR	2
LAMA3	VLAVPAENYDYQILHKK,VLAVPAENYDYQILHK,YVNPGNEAVSGHITIYPSWGAAQSK,KLQVTLEDGYIELSTSDSGGPIFK	4
THEMIS2	WLDLTVVEAK	1
PPT1	CPSPPMTNLISVGGQHQGVFGLPR,CPSPPMTNLISVGGQHQGVFGLPRCPGESSHICDFIRK	2
IGHM	EVMQGTDEHVVCK,ESDWLSQSMFTCR,YAATSQVLLPSKEVMQGTDEHVVCK	3
MAVS	NPDGGPLESSSDLAALSPLTSSGHQEK,GCELVDLADEVASVYESYQPR	2
FMO3	ESAVFDAVMVCSGHHVYPNLPKK,NNLPTAISDWLYMK,KSFPGLNHFK,GVFPPLLQK	4
ITPKB	QDSDALPSPELLPQDQDKPFLR,AVLSPGSVFSPGRSASFLFPPAESLSPEEPR	2
ODR4	GNTQATSHCFDVR	1
SERPINE2	TFVAANGKSYQVPMLAQLSVFR	1
CYP20A1	TLDPFETMLK,LTPVSAQFQDIEGK	2
KLC2	DMAGGAGSRSESDLEDVGPTAEWNGDGSGSLRR	1
HSD17B4	LSGDRNPLHIDPNFASLAGFDKPILHGLCTFGFSAR,TALDAFGRIDVVVNNAGILRDHSFAR,ICDFENASKPQSIQESSGSIIEVLSK	3
SEPTIN14	MGFTNVGPNNQPVSFQEIFEAK,MGFTNVGPNNQPVSFQEIFEAKR	2
STAU1	KVTFFEPGSGNENGTSNKEDEFR,VTFFEPGSGNENGTSNKEDEFR	2
CD163	GFGHIWLDSVSCQGHEPAVWQCK,GPDMLWQCPSSPWEK	2
LUZP1	VGDTITVAAWNHSASMEEEGEDCTLNVYR	1
SPRR3	VPVPGYTKVPEPCPSTVTPGPAQQK,VPEPDYTK,VPEPDYTKVPEPGSIK,VPEPDYTKVPEPGSIKVPDQGFIK,VPEPCPSTVTPGPAQQK	5
RWDD4	DNKEQFMENHNPINSATSLSNIISIETPNTAPSSK,EQFMENHNPINSATSLSNIISIETPNTAPSSK	2
EPS15	AELTSQELQISTYEEELAK,EKDPEMFCDPFTSATTTTNK	2
SEC16A	QSGPGAPNLDCFYQQVTK,LLPSAPQTLPDGPLVSPAR,ILENPVNVYNPSHSDSLASQQSVASHPR,SEPALAPADFVAPLAPLPIPSDLFVPTPVSSVRPQGR	4
TUSC1	LPGEGGDGTPAEAR	1
KHK	GGNASNSCTILSLLGAPCAFMGSMAPGHVADFLVADFRR,GGNASNSCTILSLLGAPCAFMGSMAPGHVADFVLDDLRR	2
PIEZO1	DPGLEPGPDSPGGSSPLR,VGPTDGTPESQVELRPR,ESDQHVVPTAPDTEADNCIVHELTGQSSLLR	3
ELN	ATQFGLVGAAGLGGLGVGGLGVPGVGGLGGIPPAAAAK,AAAGLGAGIPGLGVGVGVPGLGVGAGVPGLGVGAGVPGFR	2
SIGLEC9	DEAEFTCR	1
ARMCX4	GNPTTVPNSGVGPYTTDSARPQAVANSQGEVLPGAK,AEAGAGAEAGAGAGAEAGAEAR,AAAQPQAVASTHAEAMSNAKVK	3
TTC38	AEIKDGLEFMQHSETLWK,DGLEFMQHSETLWK,DHILLFNDAHFLMASLGAHDAQTTQELLTTLR	3
SRPRB	LADGGGAGGTFQPYLDTLR	1
DNAJC3	AEAYLIEQMYDEAIQDYETAQEHNENDQQIR,DRAEAYLIEQMYDEAIQDYETAQEHNENDQQIR	2
DHFR2	ELKEAPQGAHFLAR	1
PELO	EQFCDYMFQQAVK	1
C6orf47	RMDSLNWDQPISSTQESGR	1
TBCD	LLSMTLSPDLHTR	1
MAP7	ALREWEEAERAQR,ALREWEEAER,EWEEAERAQR	3
PARP4	KTSEDASEYYENYIEELKK,EFCTMVSTTELQK,KVSPWETSTSSFFPILAPAVGSYLTPTAR,KMELSQPEVSEDFEEDALGVLPAFTSNLER,GFGSYHPSAYSPFHFQPSAASLTANLR,WQQLNPDAPEALQAPAQVPSLFR,HITSNTTAAEFIMSATPTMGNTDFWK,TSEDASEYYENYIEELKK,QITLHALSLVGEK	9
CARMIL1	LGNDAVSQDSSSPALSSVER,KLGNDAVSQDSSSPALSSVER	2
IGKV3-11	ASQSVSYYLAWYQQKPGQAPR,FSGSGSGTDFTLTISSLEPEDFAIYYCQQR,ATLSCRASQSVSYYLAWYQQKPGQAPR,ASQSVSGYLAWYQQRPGQAPR,LLIYDASVR	5
IGHV1-58	ASGFTFTSSAMQWVR	1
MAST4	ASEGAMSDGPVPAEHRQGGGDFR,ASEGAMSDGPVPAEHR	2
CNKSR1	AVLKQVQLDSPLGLEIHTTSNCQHFVSQVDTQVPTDSR	1
ATP9B	NSYSQMQSQAGGNNTGSTPLR,DKQVNSQLYSK,NSYSQMQSQAGGNNTGSTPLRK	3
RPL13	NKSTESLQTNVQR,STESLQTNVQRLK,STESLQTNVQR	3
SLC44A2	NNKGVAEVLR,QFCVPGFKNNKGVAEVLR,GVAEVLRDGDCPAVLIPSKPLAR	3
MRI1	ENIIEERPGQELTDVNGVR	1
CPS1	QAFITAQNHGYALDNALPAGWK,QAFITAQNHGYALDNSLPAGWK,VLGTSVESIMASEDR	3
ACOT9	SLEICHPQQR	1
PRAM1	KFSQPELSEHPQK,FSQPELSEHPQK,APLPEFGAVSLKPPQPQFTDLPK	3
AOX1	VLGSERMMWFSPVTLK	1
SOWAHB	AADAACNGLPGSGSR	1
FNDC1	APEQQPPPPVATSQHHPGPQSR	1
C2orf88	EEVKEPPGTNIVILEYAHR	1
DLST	LKEAQNTCAMLTTYNEIDMSNIQEMR,LTVAPPLAEPGAGK	2
ARHGAP21	SQDLSLQEAETEQSDTLDNK,SQDLSLQEAETEQSDTLDNKEAVILR	2
PITRM1	EAYFSVGLQGIVEK,AFSSLNTLPEELRPYVPLFCSILTK,EAYFSVGLQGIVEKDIETVR,STHGLAILGPENPKIAKDPSWIIR,STHSLAILGPENPK,IAKDPSWIIR,LSVFSTIDAPVAPSDK	7
RSPH3	ELLLDGDYLQR,GSTYALQTGPLLGQPDSLELQR	2
DNAH2	LQPNLTDEEVLLLSMR,AYPSQKPLAAWTQDLAMR	2
EMILIN1	VLLNDGGYYDPK	1
ZNF592	NVDELSNLQSSADTSSSRPGSR,NVDELSNLQSSADTSSSRPGSRVPTEPPATSVAAR	2
THEM5	NLIPVGSLVVMDVEVDKIEDQK	1
PSMD13	MKDVPGFLQQSQSSGPGQPAVWHR,DVPGFLQQSQSSGPGQPAVWHR	2
EXOSC3	LHPLEIVFGMNGR	1
BTLA	MQEGSEVYSNPCLEENKPGIVYASLNHSVIGLNSR	1
MRPS34	DSQIYAVDYETLTRPFSGR,DSQIYAVDYETLTR	2
PPL	ENLQLETR,SLLDLENGRSSHVSKR,AQVDEVLQLR,AQVDEVLQLREELEALRR,NRPDSGVEQAWK,IEPDRAQVDEVLQLR	6
ABCB5	SQTAIVPQEPVLFNCSIAENIAYGDNSR	1
PGM2	ASYFICHDQDTIK,ASYFICHDQDTIKK	2
HOMER3	AAQLLDVR	1
HYAL2	LVPGHAPGEPQLRPVGELSWADLDHLQTHFR	1
HGFAC	VRQGHVEQCECLGGR,VANYVDWINDQIRPPR,QGHVEQCECLGGR,CFDETRYEYLEGCDR,YEYLEGCDR	5
NCOR1	REEGDPSPHSGVCKPK	1
AKAP13	ELKEQLQQK,EEGNDGQDLRR,GNTDSSLQSMGK,GGEKEEGNDGQDLRR,NAVLGLPVALQGK,IPSFFPSPEEPLSPSAPSIAK,RGNISHNTQDILIPNVLLSQEK,GGEKEEGNDGQDLR,SCEESADAPVDQNSVVIPAAAK,IVDAVIEQVEAAGALLTEGEACHMSLSSPELGPLTK	10
CTNNA3	VAHIVMGEMDSYEPGAYTEGVMR,NSLNVLDDNQFVDISKK,NSLNVLDDNQFVDISK	3
BCAT2	PVLIGNEPSLGVSQPR,LIEVDKDWVPDAAGTSLYVRPVLIGNEPSLGVSQPR	2
MT1H	CAPGCICKGASEKCSCCA	1
QPRT	YGLLVGGAVSHR,QAADFALK	2
DPEP1	VFQAVEQASNLTQAPEEEPIPLDQLGGSCR	1
PGM1	ICIDAMHGVVGPYVKK,LVVGQNGILSTPAVSCIIR,LVVGQNGILSTPAVSCIIRK,LKICIDAMHGVVGPYVK,IAAANGIGRLVVGQNGILSTPAVSCIIR,ICIDAMHGVVGPYVK	6
XDH	MTLLSPEEILLSIEIPYSR,ITYEELPAIITIEDAVKNNSFYGPELK	2
SERPINB5	GVALSNVVHK,GVALSNVVHKVCLEITEDGGDSIEVPGAR	2
EFHB	ISILANTLINPQPITTFQQK,GMDTINTTFGTAVIK	2
EIF4G1	EAALPPVSPPK	1
EPB41L3	METKTESSGIETEPTVHHLPLSTEKVVQETVLVQER,VVQETVLVQER,ERQEEQSAAIHISETLEQKPHFESSK,TESSGIETEPTVHHLPLSTEKVVQETVLVQERR,TESSGIETESTVHHLPLSTEK,VVQETVLVQERR	6
DNAAF5	LFSILSTALLR	1
PCK2	LCQPEGIHICNGTEAENTATLTLLEQQGLIRK,LCQPEGIHICNGTEAENTATLTLLEQQGLIR	2
ESYT1	QNGHDPPDPYVSLLLLPDKNR	1
RGMA	AAAGLPLVPR	1
TBL3	ALLPKNTAPDNGPILLQAQTTQR	1
CTTN	ASAGHAVSITQDDAGADDWETDPDFVNDVSEK	1
SCFD1	VLIYDRFGQDIISPLLSVR,FGQDIISPLLSVR	2
VNN2	EYWQVCTMLK,LLLSEVNSHPLSSLAYPTAVNWNAYATTIKPFPVQK	2
SDR39U1	WNETFQKEVLGSRLETTQLLAK,WNETFQKEVLGSR,EVLGSRLETTQLLAK,AIMLLEGQKVIPR	4
LSS	YVQSAQSQIHNTCWAMMGLMAVR,VVYALLNLYEHHHSAR,ILGVGPDDPDLVQAR	3
SDHA	TLNEADCATIPPAIR,KHTLSFVDVGTGK,HTLSFVDVGTGK,VTLEYRPVIDKTLNEADCATIPPAIR	4
IGKC	HKLYACEVTHQGLSSPVTK,VQWKVDNALQSGNSQESVTEQDSKDSTYSLSNTLTLSK,ADYEKHKLYACEVTHQGLSSPVTK,VDNALQSGNSQESVTEQDSKDSTYSLSNTLTLSK,LYACEVTHQGLSSPVTK	5
ITGB4	EGEDKPCSGHGECQCGHCVCYGEGR	1
LYPLAL1	ILIGGFSMGGCMAMHLAYR	1
C10orf90	VSQQCPNSIYYVDK	1
SUN2	FTYDQDSEPIQTFHFQAPTMATYQVVELR,SSLEERHGDANWGEDLR,SSLEERHGDANWGEDLRVR	3
HPX	GECQAEGVLFFQGDREWFWDLAMGTMK,EWFWDLATATMK	2
GLS2	LLQDYQDSYTPSETQAEAAAEALSK	1
RBMXL2	GGPDDDGGYAADFDLRPSR,GFAFVTFESPADAKAAVRDMNGK	2
ABO	DHVGVEILTPLFGTLHPSFYGSSR	1
C11orf16	ELPELEATAQLLPLEGPKEEK,ELPELEATAQLLPLEGPK,VPLGGLQSVSLTIWK	3
NEIL2	EAFGTEDGLQR	1
NDUFB6	WLKDEELSPREPVLPPQK	1
DSC2	GGHQTSESCQGAGHHHTLDSCR	1
TNS1	EATSDPSWTPEEEPLNLEGLVAHR,QGAACNVLFINSVDMESLTGPQAISK,HRTVGTNTPPSPGFGRR,RWIQPEPR,KQGSTTDNACHLFAELDPNQPASAIVSFVSK,MQGMEHLENGPSVSVDYNTSDPLIR,QGSTTDNACHLFAELDPNQPASAIVSFVSK,GLNSWQQQQQQQQQQQPRPPPR,WIQPEEDEGKVVVR,TVGTNTPPSPGFGR,WIQPEEDEGK	11
MTDH	KAEPSAWSQDTGDANTNGK	1
ALDH7A1	LVMDRPGNYVEPAIVTGLGHDASIAHTETFAPILYVFK,FQNEEEVFAWNNEVKQGLSSSIFTKDLGR,FQNEEEVFAWNNEVK	3
TARBP1	APGAEAAVEVLAAVGPCLRPGEDGPLLER,FGTNAYMPLLK	2
IGLV7-43	VLIYSTSNKHSWTPAR	1
BCAS1	GDGGITHSEEINGKDSSCHTSDSTEK,VEDQENEPEAETYK,MLDAQVQTDPVSIGPVGKPK	3
CDKN2AIP	ASEAEAPDKHGSSFVSLLK	1
CSMD1	LAFEEFQLER	1
EFHD1	REEAEESGPQLAPLGVPAPEPKPEPEPPAR,EEAEESGPQLAPLGVPAPEPKPEPEPPAR,LSEIDVALEGVR	3
PEX2	LLGIHSVFCKPQNIR	1
ZG16	SSSYSGEYGSGGGK,SGSLIDAIGLHWDVYPTSCSR	2
HPR	WKAPKSPVGVQPILNEHTFCAGMSK,NLFLNHSENATVKDIAPTLTLYVGKK	2
ECD	ESESVSKEEKEQNYDLTQVSESMK,EQNYDLTQVSESMK	2
CLEC18B	LETTNEVTDSDFETR	1
CLEC18A	LETTNEVTDSDFETR	1
HEATR1	QEIFHQFVSLSTSGGK,AGALMMPLVDQLENR,LVPDLLAIVQHK	3
PKHD1L1	IAYHSANANSHFSSPTQR	1
WDR37	EFENLYIENIELRR,EFENLYIENIELR	2
BBS9	TPAPLQHLNTLLDGTYK,DKTPAPLQHLNTLLDGTYK	2
MRTFA	GVAPPTLITNSTGTHLVLTVTNK	1
PIK3AP1	EWQLNQKR	1
CLCC1	HIGGPEREPPQALRPR	1
AOC3	TIHDAFCVFEQNQGLPLR,HGGPLPYYRRPVLFQEYLDIDQMIFNR,TIHDAFCVFEQNQGLPLRR	3
FAM114A1	GEGHENAAVQGAGAAAIGPPVQPQDANALEPPLNR	1
COBLL1	ELTDKEAER,SMSMDETDKSPCEAGR,ELTDKEAERDMLPSPEQTLSPLSK,DIGTAPFAPNLEEINNILESK	4
LTF	CLAENAGDVAFVKDVTVLQNTDGNNNDAWAK,GQFPNLCHLCAGTGENKCAFSSQEPYFSYSGAFK,CLAENAGDVAFVKDVTVLQNTDGNNNDAWAKDLK,DVTVLQNTDGNNNDAWAK,SVQWCTVSQPEATK	5
CCDC69	NEEALQVPR	1
VPS8	LSSSAIPHLYSEALK,GTSEPVLDPQQTQAFDQLCR,KGTSEPVLDPQQTQAFDQLCR	3
STOM	NSTIVFPLPIDTLQGIIGAK	1
STEAP2	SQFLEEGIGGTIPHVSPER,IILFLPCISQK,SLSETCLPNGINGIKDAR	3
ATXN1	AEQQQQQQQQQQQQQHQHQQQQQQQQQQQQQHLSR,AEQQQQQQQQQQQQHQHQQQQQQQQQQQQQQQHLSR,AEQQQQQQQQQQQQQQHQHQQQQQQQQQQQQQQQHLSR	3
SELP	GEFNVGSTCHFSCNNGFK,CPELFAPEQGSLDCSDTRGEFNVGSTCHFSCNNGFK,AVQCQHLEAPNEGTMDCVHPLTAFAYGSSCK	3
IRS1	VGNTVPFGAGAAVGGGGGSSSSSENVKR	1
SWAP70	EQALQEAMEQLEELELER,VLKEQALQEAMEQLEELELER,EQALQEAMEQLEELELERK,VLKEQALQEAMEQLEELELERK	4
TMEM214	HLSQSSLLLEHLLSSWQQIPK,MLAFGAKPDSTLHTYFPSFLSR	2
PTGFRN	AVEVATVVIQPTVLR,VPGFADDPTELACQVVDTK	2
HDHD3	QAYSAQSHSFPNYGLSHGLTSR	1
CD14	NTGIETPTGVCAALAAAGVQPHSLDLSHNSLR	1
CISD3	QPFCDGSHFFQCTGLSPLK,KQPFCDGSHFFQCTGLSPLK	2
PLD2	LTDLGDSSESAASQPPTPCPDSPATPDLSHNQFFWLGK,TPIYPYLLPK	2
VWA3B	EVAALTGGEFHFYNFGCKDPTPPEAVQNEDVTLLVK	1
IGHA1	SAVQGPPDRDLCGCYSVSSVLPGCAEPWNHGK,DASGVTFTWTPSSGKSAVQGPPDR,SAVQGPPDR	3
PZP	ASPAFLASQNTKGEESYCICGSER,GEESYCICGSER	2
OPLAH	YAGEFEHVFEASTAGITLQAPQLDINTVAAGGGSR	1
NOP56	IGAAIQEELGYNCQTGGVIAEVLR,LAALALASSENSSSTPEECEETSEKPK,EEPVSSGPEEAAGK,KFSKEEPVSSGPEEAAGK,FSKEEPVSSGPEEAAGK	5
IGLV1-47	VTISCSGSSSNIGSKYVYWYQQLPGTAPK	1
ARPC1B	DRTQIAICPNNHEVHIYENSGAK,TQIAICPNNHEVHIYENSGAK	2
POSTN	FIEGGDGHLSEDEEIK,LLQEDTPMR	2
FBLN1	AAQAQGQSCEYSLMVGYQCGQVFR	1
TXNRD2	RLPDGQLQVTWEDR,KVSVVDYVEPSPQGTR,VSVVDYVEPSPQGTRWGLGGTCVNVGCIPK,VSVVDYVEPSPQGTR,EATSVPHIYAIGDVVEGRPELTPTAIMAGR,QILLSADHIIIATGGRPR,QILLSADHIIIATGGR,KVSVVDYVEPSPQGTRWGLGGTCVNVGCIPK	8
BRIP1	YSTPPYLLEAASHLSPENFVEDEAK	1
NID1	SNGAYNIFANDRESIENLAK,AAECVHRGFPEISFQPSSAVVVTWESMAPYQGPSRDPDQK,GFPEISFQPSSAVVVTWESMAPYQGPSRDPDQK,CPDNTLGVDCIER,GFPEISFQPSSAVVVTWESMAPYQGPSRDPDQKGK	5
CLIP1	MSGDNPSQLTK,EENSGLLQELEELRKQAEK	2
UAP1L1	VSDGSLLYNAGNICNHFFTR,TLYQLQAQR	2
R3HDM2	HSDLAALYTIVAVFPSPLAAQNASLHLNNSVSR	1
IGLV6-57	SSGSIASNYVQWYQQRPGSSPTTVIYEDNQRPSGVPDR,PGSSPTTVIYEDNQRPSGVPDR,TVTISCTR	3
ADCK2	AQVPGHQPEATNLIPVAVK	1
MUC1	PAPGSTAPPAHGVTSAPESR,CHLGPGEQAGPGLHR,PAPGSTAPAAHGVTSAPESR,CHLGPGHQAGPGLHRPPSPR	4
LRG1	NALTGLPSGLFQASATLDTLVLK,TLDLGKNQLETLPPDLLR	2
PLEKHA1	HAFRPTNAAAATSHSTASR	1
TGM4	WTGTAPILQQYYNTK,DITYQYKYPEGSSEER,RDITYQYKYPEGSSEER	3
SENP8	DLIATLAK,RGEWKDLIATLAK	2
PRRC2A	GSEGKPSLTLPASAPAPEEALTTVTVAPAPR,AEPAAPSTPAPPPAVPK	2
COL6A2	DYDSLVQPGFFDR,VGVVQYSHEGTFEAIQLDDEHIDSLSSFKEAVK,SETGTRVGVVQYSHEGTFEAIQLDDEHIDSLSSFK,DYDSLAQPGFFDRFLR,NDYATMLPDSTEINQDTINR,EQGLRDIASTPHELYRNDYATMLPDSTEINQDTINR,DIASTPHELYRNDYATMLPDSTEINQDTINRIIK,NDYATMLPDSTEINQDTINRIIK,DIASTPHELYRNDYATMLPDSTEINQDTINR,AAVFHEKDYDSLAQPGFFDRFLR,VGVVQYSHEGTFEAIQLDDEHIDSLSSFK,SETGTRVGVVQYSHEGTFEAIQLDDEHIDSLSSFKEAVK	12
KDR	FLSTLTIDGITR	1
GREB1	LVSISNEPMDVPVGFLLVGVK	1
TST	LGISNHTHVVVYDGDHLGSFYAPR,HVPSASFFDIEECRDTASPYEMMLPSEAGFAEYVGR	2
PCSK5	ECMPEFFLHDDMCHQSCPR	1
HAL	NIITTELNSATDNPMVFANRGETISGGNFHGEYPAK,GETISGGNFHGEYPAK	2
RYK	ADMPNNATPITSYPTLR	1
TPO	AYLPFVPPRAPSACAPEPGIPGETR,ATEVPSLTALHTLWLR,APSACAPEPGIPGETR	3
SULT1A2	TPMTNYTTVR,KTPMTNYTTVR	2
HLA-DMB	VLLTCWDPEENKMAPCEFGVLNNLANVLSQHLNQK,MAPCEFGVLNNLANVLSQHLNQK	2
GOLIM4	QQQQQQQQVAR,LQGHLLRQQQQQQQQVAR,LAVQQVEEAQQLREHQKALHQQR	3
WRAP53	LQLWWCGGGPDSSIPDDHQGEK	1
MTTP	ENLEALQRPTLLHLTHGK,YTAIPIVGQVFQSQCK,AVDSKYTAIPIVGQVFQSQCK,PTLLHLTHGK,DVNVENVNQHR,MKDVNVENVNQHR,DVNVENVNQHRGEK	7
KANK4	ALSQHLPETGTATDQLLR,LLLAHPACNSSLTDK,NGNTALHYSVSHSNFSIAK	3
KANK3	ELELLHASLEHQR,SEGALQVLYGEVGSLDGTPQTR,QEEDMAVVQR	3
PTDSS1	TYSECEDGNYSPEISWHHR	1
PTPRU	LHPMLGDPSADYINANYIDGYHR	1
GALNS	GDTLMASTLGQHK	1
FLNB	VVASGPGLQHGK,AKVSIQNNKDGTYAVTYVPLTAGMYTLTMK,ADIEMPFDPSKVVASGPGLQHGK,VGEAGLLSVNCSEAGPGALGLEAVSDSGTKAEVSIQNNK,EAMQQADDWLGVPQVITPEEIIHLDVDEHSVMTYLSQFPK,AHIANPSGASTECFVTDNVDGTYQVEYTPFEK,TGLVEPVNMVDNGDGTHTVTYTPSQEGPYMVSVK,VGEAGLLSVNCSEAGPGALGLEAVSDSGTK,GLVEPVNMVDNGDGTHTVTYTPSQEGPYMVSVK	9
UQCC3	KNWMVGGEGGASGR,NWMVGGEGGASGR	2
SERPINB10	TYFGAEPQSVNFVEASDQIR,KMEFNLSNSEEIHSDFQTLISETLKPNDDYLLK,TYFGAEPQSVNFVEASDQIRK	3
ALG12	LHQLVPPQTDVLLHVDVAAAQTGVSR	1
INMT	DYLATYYSFNGSPSPEAEMLK	1
LOXL4	TLSDCPALEGSQNGCQHENAAAVR	1
PNPT1	REVGTSDKEILTSR,EVGTSDKEILTSR	2
SRP68	YANEVDSDAGAFK	1
ASCC2	TAYILQAVESAWEGVHR	1
STAB1	TRPGELMVGEDDAR,VCVAIDECELDVR	2
AP4M1	ILHLQPPQGELTVMR	1
ACSF3	YGMTEIGMALSGPLTTAMR,NKGAMIMYTSGTTGRPK	2
ADAR	NTNSVPETAPAAIPETRR,NTNSVPETAPAAIPETR,RNTNSVPETAPAAIPETR	3
TRARG1	AHPVQSEFPSAQESGSAAFLDLPEMEILLTK,TLSGPLDLEQNGQGLPFK	2
H4C6	RLSGLIYEETRGVLK,LSGLIYEETRGVLKVFLENVIR,GGVKRLSGLIYEETR,RLSGLIYEETR	4
GDPGP1	DLTAEGIQWPR	1
SLC6A17	AVEEELDTEDRPAWNSK	1
HPS4	DEAASTSSTYNFTYYDR,LPTGGDAPQEHGAALPPNVQIIPVFVTK,IQSLLMANLPQVATPHDR	3
RCC1L	GEVYSCGWGADGQTGLGHYDITSSPTK,IQPVPYRLQLDQKISSAACGYGFTLLSSK	2
PCSK1	RDELEEGAPSEAMLR,CAGEIAMQADNHKCGVGVAYNSK,SPSSSSVGGRRDELEEGAPSEAMLR,CAGEIAMQADNHK,DELEEGAPSEAMLR	5
ANPEP	QQQDYWLMDVR,LPNTLKPDSYQVTLRPYLTPNDR,QWMQNPNNNPIHPNLR	3
MUC2	HLAVLNGAMVSTPHYSPGLLIEK,ALSCQTLAAGYYHTECVSGCVCPNGLMDDGR,LHGHLYTPGQEITNDCK,CGCYVEDTHYPPGASVPTEEICK	4
NDUFC1	QHNEDILQYKR,QHNEDILQYK	2
NAXD	AYSPELIVHPVLDSPNAVHEVEEWLPR	1
CGN	TEEELKELQAER,TEEELKELQAEQQSQEVAGR	2
F13A1	VRGTQVVGSDMTVTVQFTNPLK,GTQVVGSDMTVTVQFTNPLK,GTQVVGSDMTVTVQFTNPLKETLR,AVPPNNSNAAEDDLPTVELQGLVPR,RAVPPNNSNAAEDDLPTVELQGLVPR,VRGTQVVGSDMTVTVQFTNPLKETLR	6
VPS33B	DMAYVFSGAYVPLSCR	1
NAALADL2	IANEPVLPFNALDIALEVQNNLKGDQPNTHQLLAMASR	1
INF2	ALEQQASTPPPPLLPGSSAEPPPPPPPPPLPSVGAK,ALEQQASTPPPPPPLLPGSSAEPPPPPPPPPLPSVGAK	2
ADH1B	MVAVGICR,IKMVAVGICR,SIHTVLTF	3
MCM4	FDLIFLMLDPQDEAYDRR	1
NACAD	EVPEAPPAACPEVSQAR,GLQAQEGTVSWAVEAAPQTSDR,GLQAQEGTVSWAVEAAPQTSDRGAYLSQR	3
TTLL12	KQQPNPGSELCYK,LEHEVFDAGEVFGIMQVEEVEEEEDEAAWEVRK,QQPNPGSELCYK	3
PJA2	QTEHSPEDAACGPGHICSER	1
MAN2B1	QLAAGWGPCEVLLSNALSR,NLDKLIQLVNAQQAK,LIQLVNAQQAK,HLELEWSVGPIPVGNTWGKEVISRFDTPLETK,NLCWDVLCVDQPVVEDPR	5
GSTO1	LEVLTNKK,EDYDGLKEEFRK,SQNKEDYDGLK,SQNKEDYDGLKEEFR,EDYDGLKEEFR	5
ZBP1	HLPSMAPGDSSTWGTLVDPWGPQDIHMER	1
TSC2	SMSGGHGLRVGVLDVPASQFLGSATSPGPR	1
NTN4	ALSPPHDTENPYSAK	1
FILIP1	FSKEHEEMNAK	1
CMPK1	NPDSHYGELIEK,KMDQTMAANAQK,KMDQTMAANAQKNK,KNPDSHYGELIEK	4
SVIL	TCAGESKDYALHAGDGSSDPEVLLNIENQR,DRLPFEEKLEVENVMK,DYALHAGDGSSDPEVLLNIENQR,DSPVLHICESK	4
PRX	AEGPEVAAGVR	1
LLGL2	LLVSCHSDGSYCQWPLSSEAQQPEPLR,TVEHGFPHQPSALGYSPSLHILAIGTR,VFLTDTDPNENLSAQGEDEWPPLRK	3
CALCOCO2	QNPGLAYGNPYSGIQESSSASPLSIKK,GASIPFQFRPENEEDILVVTTQEEVEEIEQHNK	2
KRT16	RVFQGLEIELQSQLSMK,VFQGLEIELQSQLSMK	2
PDLIM5	KILGEVINALK,PGVTSLTTAAAFKPVGSTGVIK,ISNSAAYSGSVAPANSALGQTQPSDQDTLVQRAEHIPAGK,SMPESLDSPTSGRPGVTSLTTAAAFK,ISNSAAYSGSVAPANSALGQTQPSDQDTLVQR,SMPESLDSPTSGRPGVTSLTTAAAFKPVGSTGVIK,ILGEVINALK,VTSTNNMAYNKAPRPFGSVFSPK	8
ACADS	SISAFLVPMPTPGLTLGK,SISAFLVPMPTPGLTLGKK,EAAMAKLAASEAATAIGHQAIQILGGMGYVTEMPAER	3
PCCA	MADALDNYVVR	1
AVIL	AEIGVIEGDKEAASPELMK	1
MEP1A	FYNSEGYGFGLTLYPNSR,QVIITILDQEPDVQNR,NDDLIIFVDFEDITHLSQTEVPSK	3
ANKLE2	APHGEEAHLPPVSDLTVEFDK,LSSFYYHEAGVTALSQDPQR,APHGEEAHLPPVSDLTVEFDKLNLQNIGR,FGNANVVNVLSSHHLIVK,ILKPAEGNPTDEAGFSEDRDFGYSVGLNPPEEEAVTSK	5
CEBPZ	ASLIEEDEPAEKENSSKK,ASLIEEDEPAEK,ASLIEEDEPAEKENSSK	3
LPO	ILGAFMQIITFR,KILGAFMQIITFR	2
DDT	SHSAHFFEFLTKELALGQNR,ELALGQNR,ELALGQNRILIR	3
ARHGAP9	EPPPTAPSAGWGPAGSRPESSVDLR	1
LSG1	QSNTTEFGHSSFDQAEISHSESEHLPAR	1
NHLRC2	VSTIAGIGIQGTDKEGGAK,DGIFSESTFNSPQGVTIMNNIIYVADTENHLIR,VSTIAGIGIQGTDK	3
GCKR	TNHIQALAHSTVGQTLPIPLK	1
PLCG2	FLIHEQQELWAQDLNK,DSSVFILGNTDRPDASAVYLR	2
SETD2	VDSETNIEASKLPTSEPEADAEIELK	1
ATXN3	EAYFEKQQQKQQQQQQQQQQQQQQQQQQQQQQQR,YIQQQKQQQQQQQQQQQQQQQQQR,MLEANDGSGMLDEDEEDLQR	3
PSG6	GQMTDLYHYITSYVVDGQIIYGPAYSGR	1
CNNM1	APTTQGTPQTPKDDPAITLLNNR	1
SPTA1	DFEYWLSEAETLLAMK,HQTFAHEVDGRSEQVHGVINLGNSLIER,TKLEDYANLK,TGQEMIEGGHCASDNVTTR,NALAVRGDCGDTLAATQSLVMKHEALENDFAVHETR,GDCGDTLAATQSLVMK,GDCGDTLAATQSLVMKHEALENDFAVHETR,DINKVADDLLFEGLLTPEGAQIRQELNAR,YLKHQTFAHEVDGRSEQVHGVINLGNSLIER,SEQVHGVINLGNSLIER,DTKGVSEETLK	11
C3	VLLDGVQNLRAEDLVGK,VLLDGVQNLR,KVLLDGVQNLRAEDLVGK,KVLLDGVQNLR	4
MFN1	LATEDDLVEMQGYKDK,LATEDDLVEMQGYK	2
KCTD18	ATVLVGTGAPGHPQASPGAASAENGGTHLPPAK	1
CAST	TEESKAAAPAPVSEAVSR,KAEPELDLR,AAAPAPVSEAVSR	3
FLNA	MSSHSRAGQSAAGAAPGGGVDTR,CAPGVGPAEADIDFDIIR,VHPGIQSGTTNKPNK,ALGALDSCAPGLCPDWDSWDASKPVTNAR	4
RAB11FIP1	AELQTESLTPVPNSGSSVLGSLFK,LHPVKPMNATATK	2
RINT1	SDINVTVLIGCK	1
MICALL2	TDQALVGSLVSSTCGVCGK,QALSALEEAGAPAPGRPSPATAPVPSSQPK	2
CDH17	STHNLQVAALDANGIIVEGPVPITIEVK,HTDFEEREYVVLIR	2
TNS3	NQDPNPPPQPEELTSSLHTFK,QQQMVVAHHYSFAPDGEAR,DKPLWPVILSPTMEEGHGLDLTYITER	3
GNB1L	ALAVWSLDGQQALQVR	1
SBSN	EGGQFGHDIHHTAGQAGK,FGQGAHHAVGQAGNEAGR,FGQGVHHAAAQAGNEAGR	3
APBB2	ELEQNQGNHHGTAEEK	1
TMCO6	SEDAGLELLACPVLR	1
TEP1	TLISITQAKPESESSFLCASSDGMLWNLAK,SDFVSESEEAACR,AAGQPGSELLVVTIGLDGATR	3
NPEPPS	AFFQSHPAPSAER	1
DIDO1	LAAETGEGEGEPLSR,RLAAETGEGEGEPLSR	2
MMAB	YAAMKEGNQEKIYK	1
NDUFA6	AGSGVRQVTSTASTFVKPIFSR,QVTSTASTFVKPIFSR	2
CMC2	KCLKNEYIENR,CLKNEYIENR	2
MRPL53	NFLQTVSSEK	1
COL1A1	SGDRGETGPAGPTGPVGPVGAR,GETGPAGPTGPVGPVGAR	2
RBMXL3	SYGGPCGTAPVWGTPPSYGGGCR	1
ATL3	ESGHSNWLADPEEPLTGFSWR	1
MAP2K2	ELEAIFGRPVVDR,KLEELELDEQQKR	2
KANK1	NCGVSVTEAMLGVMTEADKEIELQQQTIEALKEK,DAAVGTLVQMR,GMAEGHHAVNTEGLK,SCKDAAVGTLVQMR	4
TPSB2	IIVHPQFYTAQIGADIALLELEEPVK	1
IGHV3-43	EVQLVESGGVVVQPGGFLR,NSLYLQMNSLRTEDTTLYYCAK	2
FYCO1	ELQTCLQALELGAAEK,AQSLQKAAHQELNTLKFQLSAEIMDYQSR,ELQTCLQALELGAAEKEEDYHTALR,HLGDQMEVSLLAVR	4
NIPSNAP3B	EGVYELAVFQMKPGGPGLWGDAFER,LEKPPKEGVYELAVFQMEPGGPALWGDAFER	2
ARHGEF10L	EPAPADGAALEHSEEDGSIYEMADDPDVWVR	1
USE1	TGVAGSQPVSEKQSAAELDLVLQRHQNLQEK,QSAAELDLVLQR	2
DNAH5	SKLPAAIEQLIVPHLAK	1
SALL2	RGEESPGHFLVAATGTAAGGGGGLILASPK	1
PLXND1	YTLNEEWLLR,EDLGHLCVWSDGCR,GPLQPMAGTCPAPEIR	3
DNAJC13	ESPLLPVATELAFHTVNCSALNAEELR,SSKPSDMSVQVCGYISK	2
PES1	AGEGSYALDSESCMEK	1
ZC3HAV1	IADDADPKVALVNDSLSDVTSTTSSR,GYCNPGIQLCSVGSYTINFR	2
ENO3	AVENINSTLGPALLQK,KLSVADQEKVDK,AVENINSTLGPALLQKK,LSVADQEKVDKFMIELDGTENK,KLSVADQEK,LSVADQEKVDK	6
ACSS3	VDDVINVSGHR,VDDVINVSGHRISAGAIEESILSHGTVADCAVVGK	2
COL6A1	CPDYTCPITFSSPADITILLDGSASVGSHNFDTTKHFAK,KCPDYTCPITFSSPADITILLDGSASVGSHNFDTTKHFAK,CPDYTCPITFSSPADITILLDGSASVGSHNFDTTKHFAKR,RCPDYTCPITFSSPADITILLDGSASVGSHNFDTTK	4
TRAP1	MNTLQAIWMMDPKDVGEWQHEEFYR,DVGEWQHEEFYRYVAQAHDKPR,DVGEWQHEEFYR,AMVGHLNELLVK	4
WDR1	FTVGDHSR,LATGSDDNCAAFFEGPPFKFKFTVGDHSR,FKFTVGDHSR	3
DUS2	QAPDQDPGGPR	1
NISCH	RASNDQRPQEVPAEALAPAPVEVPAPAPAAASASGPAK,ASNDQRPQEVPAEALAPAPVEVPAPAPAAASASGPAK	2
RNF126	QLPCNHLFHNGCIVPWLEQHDSCPVCR	1
PRAG1	KFDEFQTGILLYELLHQPNPFEVR,DSAASHQTEPEAYER	2
WDR62	PGIPGSTASLLEPTSGALGLFQGSPAR,PGIPGGTASLLEPTSGALGLFQGSPAR	2
RTN3	AEPSEATQSHSISSSSFGAEPSAPGGGGSPGACPALGTK	1
LGALS2	ITGSIANGTDGFVINLGQGTDKLNLHFNPR,ITGSIANGTDGFVINLGQGTDK	2
LBR	FNLSQESSYIATQYSLRPR,NTQEKFNLSQESSYIATQYSLRPR	2
MMP3	YLENYYDLEK	1
SHROOM3	DSAYSSFSTSSSILEYPHPGISAR,GQEEMLLLFHHLTPR	2
PDLIM3	PFMIPGRSSEPTASVPPESDVYR	1
MIA3	RGLVQDETELEDENQEGMTVHSSVHSNNLNSMPAAEK,TSGLAGEPEGELSKEDHGNTEK,DSVEGDALVNGAR,GLVQDETELEDENQEGMTVHSSVHSNNLNSMPAAEK	4
NUP133	SSFYSLTSSNVSK,SSFYSLTSSNVSKWELDDSSEKHAYSWDINR	2
MTCL1	SCGFPVGEHSPHSR,IGGGLSPLPHLTESSSFLSTVTSVSR,NCLPEEEENHKGNLQR	3
HSPB6	LPPGVDPAAVTSALTPEGVLSIQAAPASAQAPPPAAAK	1
ACTBL2	VAPDEHPILLTEAPPNPK	1
CERS4	PAPTDGPQSR,NGAAGGPRPAPTDGPQSR,NGTAGGPRPAPTDGPR	3
MON2	EEAAQQQQAEEK	1
GHRL	LSGVLYQQHSQALGK	1
PLBD2	DGPVPPASR	1
CTSC	GTDECAIESVAVAATPIPK,VGTASENVYVNTAHLK,GTDECAIESVAVAATPIPKL,KVGTASENVYVNTAHLK	4
SRRM2	SSTGPEPPAPTLLLAER	1
AKAP5	DGDEVCESNVSNSITSGEK,KDGDEVCESNVSNSITSGEK	2
COL1A2	GHNGLQGLPGIAGHHGDQGAPGSMGPAGPR	1
TUBB1	LHFFMPGFAPLMAQGSQQYR	1
HYPK	KEDLELIMTEMEIPR,EDLELIMTEMEIPR	2
DDX20	LQTEAQEDDWYDCHRETR	1
ENPEP	SIAATDHEPTDAR,SIAATDHEPTDARK	2
CRNN	AHQTGQTVTGSGTQTQAGATQTVEQDSSHQTGR	1
SEC23B	GLCVSENELGVGGTSQWK,GAIQFVTHYQQSSTQR	2
ELP1	EQAQQAGLDDEVLHGQESDLFSETSSVVSGSEMSGK,VFLENVETFIK	2
NEK1	EANHSEGQEGSEETDMR	1
HYKK	ECINHGDLNNHNILIESSK	1
EPHX2	GGPEGATTWLMK	1
PARP10	LQGSELSLVPHYDVLEPEELAENTSGGDHPSTQGPR,ELEEEGPQEQPEEEATPGHEEEEPVAPSTVAPR	2
HPSE	TATREDFLNPDVLDIFISSVQK	1
GSTZ1	IDGITIHQSLAIIEYLEETRPTPR,QVPTLKIDGITIHQSLAIIEYLEETRPTPR	2
IVL	QLELPEQQEGQLK,NLEQEEKQLELPEQQEGQLK	2
LDHC	LLEDDENSQCK,QELFLSIPCVLGR	2
VAV2	MVAVQNYHGNPAPPGKPVLTFQTGDVLELLR	1
TJP2	EESYDFFK,TQNKEESYDFFKSYEYK,AEQIASVQNAQR,TQNKEESYDFFK,YQEEPPAPQPK	5
HP1BP3	GKASGSFVVVQK	1
SYNE3	ANLQEEEGSHEDFSQLLR	1
MSRB2	GQAGGGGPGTGPGLGEAGSLATCGLPLAK	1
ATP5MJ	NLWIPMKPYYTK,NVWIPMKPYYTK	2
ZNF615	QDCDMFDLHEKPLK	1
FNDC3A	TLSTDSIQYHLQMQDKNGRFVSLYR,TLSTDSIQYHLQMQDK,TLSTDSIQYHLQMQDKNGR,LRVYCISDGGESAVSESLLVQTPAVPPGPCLPPR	4
STAT2	IEEIMPNGDPLLAGHNTVDEVYVSR,IEEIMPNGDPLLAGHNTVDEVYVSRPSHFYTDGPLMPSDF	2
OPA1	ALPNSEDLVK,KALPNSEDLVK	2
SGSH	DPHETQNLATDPHFAQLLEMLR	1
WAPL	ISHVVIEDTVVSDK	1
CCDC124	VLQEGSVEAR,SHLEVPLEENVNRRVLQEGSVEAR	2
PSMD5	GISSQPFPEQHCAALK	1
KRT77	YQELQIMAGR	1
TOR1A	ITHVALDFWR	1
TKT	LGQSDPAPLQHQMEIYQK,GQGITGVEDKESWHGKPLPK	2
SLC2A9	ADVSQEVEEVLAESHVQR,ADISQEVEEVLAESR,ELGLVPLTDDTSHARPPGPGR	3
ARHGEF40	HKLENGLAALSPSSK,RIQQHLGEEASPR,IQQHLGEEASPR,LENGLAALSPSSK	4
TRMT1L	EKSNDILEEGEK,SNDILEEGEKNLGNIK,EKSNDILEEGEKNLGNIK	3
SORBS2	QIHMVHKPDDDTDMYNTPYTYSAGLYNPPYSAQSHPAAK	1
GPLD1	MYALISDAQPLLLSTFSGDRR,VYALTSDAQPLLLSTFSGDRR,MYALISDAQPLLLSTFSGDR,VYALISDAQPLLLSTFSGDRR,VYALISDAQPLLLSTFSGDR,VYALTSDAQPLLLSTFSGDR	6
IFITM2	MLKEEQEVAMLGAPHNPAPPMSTVIHIR,EEQEVAMLGAPHNPAPPTSTVIHIR,EEQEVAMLGAPHNPAPPMSTVIHIR,MLKEEQEVAMLGAPHNPAPPTSTVIHIR	4
BCS1L	DVQEFINNPKWYTDR,DVQEFINNPK	2
STX2	NTIDKITQYVEEVKK	1
ALAD	YGVNRLEEMLRPLVEEGLR	1
LRRC47	VVYPSKADLATAPPHVTIVR,ADLATAPPHVTIVR	2
H6PD	LFGSPLSDYYAYSPVQER,IFYFSVPPFAYEAIAR,ESLLVSAWSEELISK	3
DPP6	IQDKLPTVTAKEDEEED,LPTVTAKEDEEED	2
ALDH2	EAGFPPGVVNIVPGFGPMAGAAIASHEDVDK	1
BAZ2B	INENIAAASSTLFSSPVNLSTSGR	1
BOLA1	LVHAALAEELAGPVHALAIQAR	1
KLK3	LSEPAEITDAVK	1
AARS2	TLSVCISDGVFPGMSGPPLVLR,TLSVCISDGVFPGMSGPPLVLRR,VVSVGVPMAHALDPASQAALQTSVELCCGTHLLR	3
PREX1	SFVHPKPGAAGTVGAGLIPISSELCYR,GSLAEMAGLQVGR	2
GP6	AVQRPLPPLPPLPQTR	1
SLC4A4	LIVPSQFKPTSPNR,NMYSGGENVQMNGDTPHDGDHGGGGHGDCEELQR	2
PSMB4	SYNRFQTATVTEK	1
NME1	VMLGETNPADSKSGTIRGDFCIQVGR,MGRVMLGETNPADSKPGTIR	2
QSOX1	NNEEYLALIFEKGGSYLAR	1
AKR1A1	HIDCAAIYGSEPEIGEALK,HIDCAAIYGSEPEIGEALKEDVGPGK,HIDCAAIYGSEPEIGEALKEDVGPGKAVPR	3
APOL2	AQACNLDQSGTNVAK	1
IGKV4-1	VLIYWASTR,ATINCKSSQSVLYSSNSK,SSQSVLYR	3
VARS1	GALINVPSPFLGLPR	1
GTPBP3	SGAHVVVTGPPNAGK	1
LEMD2	GLVYPARPAQLR	1
DDRGK1	VSIAELAQASNSLITWGR,GRVSIAELAQASNSLITWGR	2
LMO7	YLDQIGNTTSSQRR,GATYSSEIPKEDSTTFAK,STQMESTCVSASLPR,STTELDDYSTNKNGNNKYLDQIGNTTSSQR,YNGDIEDIKR,YLDQIGNTTSSQR	6
SPEG	YSEDDVATYMVQLLQGLDYLHGR,SLNMAIDPDSLTYTVQHQVLGSDQWTALVTGLR,GTQDSSAVPSAAHQEAPVTSGPAR	3
CTU2	LFSVPSVFTPAIDTKAPEK,LFSVPSVFTPAIDTK	2
CCDC17	RDPPLLPPPVAPLLPPLPGFSEPQLPGTMTR,GRRDPPLLPPPVAPLLPPLPGFSEPQLPGTMTR	2
PPP1R13L	LQNAFWEHGANR	1
LHPP	LGFDISEQEVTAPAPAACQILKER,GVLLDISGVLYDSGAGGGK	2
QRICH1	EIQEAIAVASASTMH	1
HEXB	WHHEPAEFQAR,APSVSAKPGPALWPLPLSVK,PGPALWPLPLSVK,GILVDTSR	4
GFM1	GIIDLIEER	1
DNAI2	AEEEFFDIIFTELK,AEEEFFDIIFTELKK	2
CYBRD1	GSMPAYSGNNMDKSDSELNNEVAAR,SDSELNNEVAAR	2
GYS2	SDITVVVFFIMPAK	1
MAP1B	AAEAVVAAVGTGATTAAVMAAAGIAAIGPAKELEAER	1
AKR7A2	RLQCPQVDLFYLHTPDHGTPVEETLHACQR,LQCPQVDLFYLHTPDHGTPVEETLHACQR	2
MYO9B	KGEPGAEPGHFGVCVDSLTSDK,KGEPGAEPGHFGVCVDSLTSDKASVPIVLEK,TQAAVYLQAAWR	3
TUBA3E	QRECISIHVGQAGVQIGNACWELYCLEHGIQPDGQMPSDK,RNLDIESPTYTNLNRLIGQIVSSITASLR	2
HP	VRFTSPADVGK	1
PRODH	DAYDNVTLDMELAR,AAEIGYEDPINPTYEATNTMYHR,EQSAAGPAAVPGGGSATAVRPPVPAVDFGNAQEAYR,DAYDNVTLDVELAHR	4
CELA3B	LQQALLPVVDYEHCSR,LYTNGPLPDKLQQALLPVVDYEHCSR	2
ALCAM	SSNTYTLMDVR	1
POFUT1	VKVVSLKPEVAQVDLYILGQANHFIGNCVSSFTAFVK	1
MDM1	QAFMGEQEKLDVHEK,SQEAEQKDVIQER	2
RAB3B	LVDAICDKMSGSLDTDPSMLGSSKNTR,LVDAICDKMSGSLDTDPSMLGSSK	2
MCUR1	MQQEIAFQQVMSQIANVKK,MQQEIAFQQVMSQIANVK	2
MYH6	LEQQVDDLEGSLEQQK,LEDEEEMNSELTAK,VKLEQQVDDLEGSLEQQK,LEQQVDDLEGSLEQQKK,VKLEQQVDDLEGSLEQQKK	5
PLOD1	TLEKHADKEDLVILFTDSYDVLFASGPR,HADKEDLVILFTDSYDVLFASGPR	2
SMPD2	SFETTTGFDPHSGTPLSDHEALMATLFVR	1
FGFBP2	VSPEPNQQPEAGTPSLRPK	1
GHDC	LDHCLQEASPCYK,LDHCLQEASPHYK,DKLDHCLQEASPCYK	3
TUBG2	KEDVFKDNFDEMDR	1
IGKV1-39	VTITCRASHSISTYLNWYQQKPGK,LLIYAASNLQSGVPSR	2
PPP6R2	IQPFDDEEDEDIWEDSDTR	1
NIPA1	GTAAAAAAAAAAAAGEGAR	1
HMCN2	EGHPTSLSCECR,ADVWDAGHYTCEALNQAGR,IHPTATHHITNEGVPASLPCVASGVPAPTITWTK,NAAGSTSVAFLVEIHTVPTIR,NYHVEVLIPPSISKDDPLGEVGVK	5
PSG5	DRDGGMHSDPVSLNVLYGPDLPSIYPSFTYYR,DRDGGMHSDPVTLNVLYGPDLPSIYPSFTYYR,DGGMHSDPVTLNVLYGPDLPSIYPSFTYYR	3
LAMB1	MEMPSTPQQLQNLTEDTR,FGYYGDALRQDCR,CLAGYYGDPIIGSGDHCRPCPCPDGPNSGRQFAR,FGYYGDALRQDCRK,NCEQCKSFYYQHPER	5
MICAL3	ERQEDKDLEAAMLSK,QEDKDLEAAMLSK	2
SON	GISLSSGDQNLAPEIGMQEIALHSGEEPHAEEHLK,GINLSSGDQNLAPEIGIQEIALHSGEEPHAEEHLK	2
BTBD11	SCSGPASGSGSGPGPSSGPGAAPAADK	1
C2orf72	AVFPPEPGAGKPGGAAAEGAGPGAAR	1
FUT3	NALEAWAMPVVLGPSR	1
TRIM22	LIKENQEAEKLEDDIR,LTGSSVEMLQDVIDVMKR,ENQEAEKLEDDIR,ENQEAEKLEDDIRQER,RLTGSSVEMLQDVIDVMKR	5
PDHA1	GPILLELQTYR	1
PCSK9	SEEDGLVEAPEHGTTATFHR	1
WDR44	TPDIDVPKENITSDSLLTTSMASESTVK,ENITSDSLLTTSMASESTVK	2
XIAP	SLEVLVADLVNAQKDSMPDESSQTSLQK,DSMPDESSQTSLQK	2
CD177	GTTHCYDGYIHLSGGGLSTK	1
COL5A1	TVLEINTPKVEQVPIVDIMFNDFGEASQK,FGGGSDAGSKGPMVSAQESQAQAILQQAR	2
COQ4	ALLAAGSAAMALYNPYR	1
ASPSCR1	QGGPPGPTRPLTSSSAKLPK	1
IQGAP2	KYDYYYNTDSKESSWVTPESCFYK,LFEGENKHLSSMNNYLSETYQEFRK,TLETLLLRTANISDVDPAHAQHYQDVLYHAK,VLWLDEIQQAVDDANVDEDRAK,VLWLDEIQQAVDEANVDEDRAK,VAAVGYINEAIDEGNPLR,VLWLDEIQQAVDEANVDEDR,ESSWVTPESCFYK,RQTFIDNTDSVVK,LFEGENKHLSSMNNYLSETYQEFR,VLWLDEIQQAVDDANVDEDR,ESSWVTPESCFYKESWLTGK,QTFIDNTDSVVK	13
UGT2B7	NSWNFQFPHPLLPNVDFVGGLHCK,NSWNFQFPHPLLPNVDFVGGLHCKPAKPLPK	2
LRP4	NTIAVGVDPQEGK,QVLVGHVSHPFALTQQDR,VVLINNNLGWPNGLTVDK	3
SEMA5B	TCPADGSGSCDTDALVEDLLR	1
NCEH1	VVSPFPLCQPAGEPSR	1
DOCK5	SQVIAEKEPEPDLMSPTR	1
CASP4	YYNAKTEDKVR	1
PANK4	IAGMDPVVHSALR,SLDVLGWEER,SLDVLGWEERQLALVK	3
ANO1	ACPDSLGSPAPSHAYHR	1
ANAPC4	DITFVAEFLTEHFNEAPDLYNQK	1
NT5C3B	NSSVCENCGYFQQLEGK	1
MANSC4	QTTMINGMLPSTEAPSSTTHQDLVVNTNSTSYSK	1
THNSL1	HVWPEDCEQKVSEK,SWYSTHSIVGDK	2
CYP1B1	FLDKDGLISK,QLGSAPPGPFAWPLIGNAAAVGQAAHLSFAR	2
FAM166C	SHTPFSHGGHFPTIFSTNPNLLLMER	1
HMCN1	DGHLLNVDQNQNSYR,NSVSLTCEASGIPLPSTTWFK	2
AHCTF1	DDAQSVETVGKPK	1
IQGAP1	KFVHLLDQSDQDFQEELDLMQMREEVITLIR	1
XYLB	ASGFEFSQVLALSGAGQQHGSIYWK,LHQQLQDCFSISNCPVWMDSSTTAQCR	2
DMTN	LKSTEFSPSGSETGSPGLQNGEGQR	1
REPIN1	LPLPCPECGHR	1
IGHV3-53	NTLYLQINSLR,DNSKNTLYLQINSLR	2
FBXO2	CQQEGLVPEGGVEEERDHWQQFYFLSTR,VEELPGDSEVEFTHDESVK,VEELPGDSEVEFTHDESVKK	3
ZNF268	MHTTEKPYECSECGK	1
CWH43	EGHNYENNHNFHMNTPK	1
GLRX5	LGIHSTLLDEKK,LGIHSTLLDEK,KLGIHSTLLDEK,LGIHSTLLDEKKDQDSK	4
FIZ1	VSHGEGGGEEAAAAAR	1
CAP1	SALFAQINQGESITHALKHVSDDMK,SALFAQINQGESITHALK	2
ACAT2	RGLIEVKTDEFPR,AGHFDKEIVPVLVSTRR	2
LTN1	TSSSESSAVISAFFECLR	1
EMC1	NEVQKTSNSEDGSMGSFSEK,TSSSEDGSMGSFSEK,TSNSEDGSMGSFSEK	3
ATP6V1E2	HMMAFIEQEANEKAEEINAK,HMMAFIEQEANEKAEEINAKAEEEFNIEK,AEEINAKAEEEFNIEK,AEEINAKAEEEFNIEKGR	4
GCFC2	DIDLSCGSGSSK,VILEEHSACENEVSK	2
FBXO47	KIQMAVCSKPGSAR	1
AHI1	YSGTFPLPGIHQSQDALCTCPK	1
ATP7B	DAAPQTFSVLIGNR	1
CNTN5	GQPIDFEEQGGHFESIR	1
ASNS	DEPLHALYDNVEK,YHHCRDEPLHALYDNVEK,DEPLHALYDNVEKLFPGFEIETVKNNLR	3
PLA2G4F	GIPFPSIEVGPEDVEEAR	1
GLO1	ATLELTHNWGTEDDATQSYHNGNSDPR,KATLELTHNWGTEDDATQSYHNGNSDPR	2
SLIT3	QPAVGINSPLYLGGIPTSTGLSTLR,SLTSLVLYGNKITEIAK	2
MPRIP	VAVTSSSSSSSSSSIPSAEKVPTTK,AEHMETNAVGPSQSSDTR,SQVIEKFEALDIEKAEHMETNAVGPSQSSDTR,LPHQMVCNISLSSLDVASQPPAYVDSGSTR,VAVTSSSSSSSSSSIPSAEK	5
ASAH2	NSVQNQNHQTFLTVEK	1
ZC3HC1	TRSWDSSSPVDHPEPEAASPTTR,SWDSSSPVDHPEPEAASPTTR	2
KIAA0408	VLESSPNYPDLGQSEFIR	1
CTSD	YSQVVPAVTEGPIPEVLK	1
NUGGC	DVFGQEPHPVEDDLYKEPTR	1
PRDX3	NGGLGHMNIALLSDLTKQISQDYGVLLEGSGLALR	1
ZNF773	AEEAPEQSASVEVPSSNVQQHQK	1
WARS1	IGYLKPALLHSTFFPALQGAQTK	1
DSC3	VLNDGTVYTAR	1
LCLAT1	YPVDTLPTSK	1
IGHV3-38	NTLYLQMKSLRAEGTAVYYCAR,DNSKNTLYLQMK,SLRAEGTAVYYCAR,NTLYLQMK	4
PARP12	YMSPQDVTTMQTCNTK	1
NCAM2	AVDGFTFTEGDKSPDGR	1
CFDP1	SKVPPSTQVEKGEETEETSSSK	1
CASP7	ELEIMQILTR	1
MEAK7	VQVLAAQLLSEMKLQDGKR,SILDADPEAQALLEISGHLR,VQVLAAQLLSEMK	3
MYO18B	LCIDADKTITEVDEEHVHR	1
CLYBL	ILPSSLMLPK,AFGLQAVDLVYIDFR	2
DYSF	TANPQWNQNITLPAMFPSMCK,KVPSRPPPHYPGIK	2
IGKV1D-39	VTITCRASQSISGYLNWYQQRPGK,ASQSISGYLNWYQQRPGKAPK,ASQSISGYLNWYQQRPGK	3
PDCD4	DSGRGDSVSNSGSDALR,DSGRGDSVSNSGSDALRSGLTVPTSPK,NSSRDSGRGDSVSNSGSDALR	3
LDAH	QVPELPVIR	1
MGAT1	RVHLAPPPTWEGYDPSWN,VHLAPPPTWEGYDPSWN	2
C1orf116	GGPKETITQQGR,SMPIPIPK	2
CEL	LGAVYTEGGFVEGINK,LGAVYTEGGFVEGINKK,LGAVYTEGGFVEGINKKLGLLGDSVDIFK	3
NPEPL1	ASEDPLLNLVSPLGCEVDVEEGDVGRDSK	1
SERPINA10	NLELGLSQGSFAFIHK	1
TNC	YGDNNHSQGINWFHWK,AQALEVFCDMTSDGGGWIVFLR,GLCVDGQCVCEDGFTGPDCAELSCPNDCHGR,LIPGVEYLVSIITMK,GLCVDGQCVCEDGFTGPDCAELSCPNDCHGRGR,VPGDQTSTIIR,VTEYLVVYTPTHEGGLEMQFRVPGDQTSTIIR,VPGDQTSTIIRELEPGVEYFIR,TISATATTEPKPQLGMLIFSNITPK,DCSNRGLCVDGQCVCEDGFTGPDCAELSCPNDCHGR,DLTGLREATEYEIELYGISK,CVDGQCICHEGFTGLDCGQHSCPSDCNNLGQCISGR	12
LAMA1	ISDISVEVGR	1
IGHV4-4	QPAGKGLEWIGR,GLEWIGRIYTSGSTNYNPSLK,IYTSGSTNYNPSLK	3
IGHV4-31	QPAGKGLEWIGR,GLEWIGRIYTSGSTNYNPSLK,IYTSGSTNYNPSLK	3
IGHV4-59	IYTSGSTNYNPSLK,ANYNPSLK,QPAGKGLEWIGR,SRVTISVETSK,GLEWIGRIYTSGSTNYNPSLK	5
IGHV4-61	QPAGKGLEWIGR,GLEWIGRIYTSGSTNYNPSLK,IYTSGSTNYNPSLK	3
KRT78	FGEWSGGPGLSLCPPGGIQEVTINQNPLTPLK	1
CYP4F3	LVHDFTDDVIQER	1
APLP2	GSGVGEQNGGLIGAEEK	1
COQ5	AQQNLSWEEITK,AQQNLSWEEITKEYQNEEDSLGGSR	2
LAMC1	LQNIQNTIEETGNLAEQAR,CQPGFHSLTEAGCRPCSCDPSGSIDECNVETGR,ACNCNPYGTMK,PCSCDPSGSIDECNVETGR	4
PBLD	YFAPWVGVAEDPVTGSAHTVLSSYWSQHLGKK,EMHAFQCSR,AFCGNPAAVCLLENELDEDMHQK	3
IGHV3-33	DNAQNSLYLQMNSLR	1
PSPC1	TGSETPQAPVSGVGPVSGGPGGFGR	1
OGFR	TPSETPGPSPAGPTR,PAGPAGDEPAESPSETPGPRPAGPAGDEPAK,EGTPGSPSETPGPR	3
KRT6B	AGGSYGFGGAR	1
NPW	DVSRPAVAPAANRLGLPCLAPGPF	1
CCT6A	DGLRAVKNAVDDGCVVPGAGAVEVAMAEALIK,RVEDACILTCNVSLEYEKTEVNSGFFYK,VEDACILTCNVSLEYEK	3
TBC1D2B	GEEGGGGGEGAAQGAAAEPGAGPAR,GEEGGGGGEGAAQGAAAEPGAGPAREPAR	2
ADAMTSL4	EACDVGPCTTAWFHSDWSSK	1
LRIG1	AEAPYLLVSNGHLPK	1
ADH1C	FSLDALITNVLPFEK,KFSLDALITNVLPFEK	2
H2BC21	VLKQVHSDTGISSKAMGIMNSFVNDIFER,QVHSDTGISSKAMGIMNSFVNDIFER	2
DSG2	DMAGAQAAAVALNEEFLK,GQHEMSKMDGRWEEHR	2
SLC26A2	DYEAIGIQVLLAQCNPSVR,RDYEAIGIQVLLAQCNPSVR	2
PALM2AKAP2	RAQQEQLLLQQQLQQQQQQPPSQLCTAPASSHER,AQQEQLLLQQQLQQQQQQPPSQLCTAPASSHER	2
EVL	KEDESQMEDPSTSPSAGTR	1
COQ7	KFNELMVMFR,FNELMVMFR	2
IGLV3-21	PGQAPVLVIYDDSDRPSGIPER,SVHWYQQKPGQAPVLVIYYDSDRPSGIPER	2
PREP	SNFLVVCYLHDVK	1
NQO2	ATDKDITDTLSNPEVFNYGVETHEAYK,VLIVYAHQEPR	2
HLA-DQA1	QFRFDPQFALTNIAVTK,FDPQFALTNIAVTK	2
LYZ	NPGAVNACHLSCSALLQDNIADAVACAK,YWCNDGKNPGAVNACHLSCSALLQDNIADAVACAK	2
SERPINB12	SLQSWVEFNANHPFLFFIR	1
BOLA2B	DLEAEHVEVEDTTLSR	1
ADO	GASDRDAASGAEAPMQPGFPENLSK,DAASGAEAPMQPGFPENLSK	2
TMEM106B	LNNISIIGPLDMK	1
PEX5	LANSEGTSDAWVDQFTRPVNTSALDTEFER	1
TRAPPC8	ETFLQSMPASDHEFLNHYLACMLVASSSEAEPVEQFSK	1
ZFR	LQSTGNKAEDTKGTECVK	1
NFXL1	SETPSRYYCYCGKVEDPPLDLWLVPHSCGQVCER,VEDPPLDLWLVPHSCGQVCER	2
RYR2	GKGEHFPYER	1
PCM1	DASTSPPNRETIGSAQCK,SKDASTSPPNRETIGSAQCK,ALNVPPSLDCR	3
CLGN	LLSDTDDLILENFYDK,IPDPSAIKPEDWDESEPAQIEDSSVVKPAGWLDDEPK	2
GMPR	AFGAGADFVMLGGMFSGHTECAGEVIER	1
NIBAN1	RASAILPGVPGSETLSNEVFQESEEEKQPEVPSSLAK,ASAILPGVPGSETLSNEVFQESEEEKQPEVPSSLAK,ASAILPGVLGSETLSNEVFQESEEEKQPEVPSLLAK	3
FRA10AC1	MHGHGGYDSDFSDDEHCGESSK	1
DDX58	AAGFEEIEQDLTQRFEEK	1
TSTD2	HVATQHADEIYHQTDSILK	1
STON1	ACLGSLHELESEPVIQVTVGSAK	1
PLA2G7	LKGDIDSNAAIDLSNKASLAFLQK,LKGDIDSNAAIDLSNK	2
PITPNM3	LDEHQGEGTTPCTSSILQEK	1
TPM4	EENMGLHQTLDQTLNELNCI	1
F5	AHKPLSIHPQGIR,MRPWEDPPSDLLLLK,LLSLGAGEFR	3
FGL2	GKCEEAEECPYQVSLPPLTIQLPK	1
MRPL40	WSLYKQQEHKMER	1
ALDH1A1	HEPIGVCGQIIPWNFPLVMLFWK	1
IFIH1	ADESTYVLVAHSGSGVIER	1
ACOT11	DLLANCAIQDDLESR	1
PDE4DIP	MQLLQEESR	1
GSDMA	ELQDLELALEGALDKGHEVNLEALPK,QLNPQGDLTPLDSLIDFK,GHEVNLEALPK	3
FASTKD1	ITQQLTFLHFQR,WIQHDHVYLDNMTAK	2
CHD4	KEEEEEDDDDDDSKEPK	1
L1TD1	EADLTEEIEENLR	1
MYH7	NAYEECLEHLETFKR,NAYEECLEHLETFK	2
PRRG3	EAASSPQVVLGPSR	1
NIN	VSQMNSLEEELETIHLENEGLK	1
PPP1R9A	ELAGGNFTSPDASASSCGK	1
MTHFSD	DVTLQGEHQHLPEPGCQETVPLSVGR,RPPDTPGPETNSMEAAPGSPPGEGAPLAADVYVGNLPR,ETPVVTIVHNCQVVDIPEELVEEHDITVDYILTPTR	3
PLXNB2	LHVTLYDCSFGR,ITVLGSNLGVQAGDIQR	2
MINK1	NRVGASSKLDSSPVLSPGNK,SNSAWQLYLQR,LDSSPVLSPGNK	3
PCLO	IIEDDEKPVDLTAGR,IIEDDEKPVDLTAGRR	2
A2M	SFVHLKPMSHELPCGHTQTVQAHYILNGGTLLGLKK,EQVPHCICANGR,DLTGFPGPLNDQDDEDCINRHNVYINGITYTPVSSTNEK,DLTGFPGPLNDQDDEDCINR	4
CCDC186	DKLIAQDVTAK	1
COL14A1	TLTYFNYDQSGDFQTLTFEGPEIR,TLTYFNYDQSGDFQTLTFEGPEIRK	2
RILP	ELLTDHRVPSLLLEAMK	1
PDLIM7	GAPGAASEAGALPR	1
TRMU	HVVCSLSGGVDSAVAALLLR	1
MYLK	TLSEDELK,FSASAVETRPSIWGECPPK,GQGWPEEEDGEDVR,TLSEDELKEIPAEQMDFR	4
WDR92	LVATSLEGKFHVFDVR	1
MX1	INAFNQDITALMQGEETVGEEDIR	1
FCRL5	GSLPILYQFHHEDAALER,AATMPHSVISDSPR	2
RCOR2	HSARPGPQPPPTLIGAPLEPPAPSL	1
MRPL9	NLGVVVAPHTLKLPAEPITR	1
ZG16B	YFSTTEDYNHEITGLR	1
DHX57	TTQIPQFILDDSLSGPPEK,TTQIPQFILDDSLSGPPEKVANIICTQPR	2
CFAP251	DKLGLQILPVDGNPHK	1
CALD1	EAEGAPQMEAGK,EAEGAPQMEAGKR	2
TPR	TSTNNVEQYQAMVTSLEESLNK,TSTNNVEQYQAMVTSLEESLNKEK,LKTSTNNVEQYQAMVTSLEESLNKEK	3
SYN2	RPPPASAPAPQPAPQPAPTPSVGSSFFSSLSQAVK,QTAASAGLVDAPAAAPAAAR	2
CEACAM6	SDPVTLNVLYGPDGPTISPSK	1
RADIL	NGPSGLRGAAPEGDSAALAEESPPAPSSR	1
CRISP3	TPNSVVGHYTQVVWYSSYLVGCGNAYCPNQK	1
KLHDC4	TQTVEVPCPPPSPR	1
IGHV3-74	DNAKNTVYLQMNSLR,NTVYLQMNSLR	2
NHLRC1	AAPSALGALTCHHTFGGWGTLVNPTGLALCPK	1
ADD1	GCEENLDEAREQKEK,WLNSGRGDEASEEWQNGSSPK,GDEASEEWQNGSSPK,QKGCEENLDEAR,GCEENLDEAREQK	5
IGLV3-1	YACWYQQKPGQSPVLVIYQDTK,YACWYQQKPGQSPVLVIYQDR	2
IL7R	IDLTTIVKPEAPFDLSVIYR,KIDLTTIVKPEAPFDLSVIYR	2
ITGA6	DSMFGITVK	1
MATN2	RKDVCQAIDHGCEHICVNSDNSYTCECLEGFR,DVCQAIDHGCEHICVNSDNSYTCECLEGFR,MVQQPTESEPVTINIQDLLSCSNFAVQHR	3
SCRIB	LAEAPSPAPTPSPTPVEDLSPQTSTSPGRLPLSGK,EAGGPLPPSPLPHSSPPTAAVATTSITTATPR	2
F3	TVLEWEPKPVNQVYTVQISTK	1
MACROD2	GQNDEENIQETSQVK,GQNDEENIQETSQVKK	2
TOR1AIP1	TPQEWAPHTAR,LQQQHSEQPPLQPSPVTTR,TTRLQQQHSEQPPLQPSPVTTR,RTTRLQQQHSEQPPLQPSPVTTR,SSSQYIESFWQSSQSQNFTAHDKQR,LQQQHSEQPPLQPSPVTTRR	6
DDHD2	LMVHYQPVAGSDDWGSTPMEQGRPR	1
ANK2	TQTDSEAQESTATSDETK,TEGDSSATAIFPQTHK	2
ZC3H13	MDKDLGSVQGFEDTNKSER	1
NTAN1	KHPSPANTLFPGNK	1
IGHV3-20	NSLYLQMNSLRAEDTALYYCAR,AEDTALYYCAR	2
MIDEAS	GLEQNPAEHKPSVIVTR,TVDPTEAAQAGGLDEDGKGLEQNPAEHKPSVIVTR,EAAAAAAATHQQALR	3
MAP9	QAIDEYEK	1
ANKZF1	LAAQLGAPTSLIPDSAIVNTR,LLLEAGADPTVQDCR	2
PRR4	HPPPPPFQNQQRPPQR,FPSVSLQEASSFFRR	2
ASPDH	RENPAEPGAVTGSATVTAFWR,ENPAEPGAVTGSATVTAFWR	2
LRRC15	LYLSNNHISQLPPSIFMQLPQLNR,ELSLGIFGPMPNLR	2
SPICE1	LQPEESTETVDSSYVVGHVLNSR	1
ADD3	DDIHDVEDELAKR	1
LAD1	GPWALEEESLGREPEER,NLPSLAEQGASDPPTVASR	2
CLCN2	NLGESPTGSADSAGIALR	1
CTBP2	SSSFSHRSELLHGDLASLGAAAPPQTASPR,EQPDTRYGAEVPAYPLSQVFSNISERPIDPAPAR,LSPTHPLQAGVALTNPGPSNPLHPGPR,YGAEVPAYPLSQVFSNISERPIDPAPAR,SSSFSHRSELLHGDLASLGAAALQPQPAAPPQTASPR	5
CLEC4M	NWHNSVTACQEVR	1
ARHGAP28	INPQAEWVIKPQPSS	1
PDCD6	PGPGPAAGAALPDQSFLWNVFQR	1
SPAG7	GEEWNPQKAEEKR,RGEEWNPQKAEEK	2
CRELD2	EHGQCADVDECALAEK	1
B3GNT3	APSQHLSSFDPCFYR	1
TNIP1	LETTLSVCAEEPDHSQLFTHLGR	1
C3orf33	ENSALFCYLLVNK	1
FAM185A	WPGSETEVPPPGPAR	1
CP	MYYSAVDPTKDIFTGLIGPMKICK,MYYSAVDPTKDIFTGLIGPMK,MYYSAVDPTK,ADDKVYPGKQYTYMLLATEEQSPGEGDGNCVTR	4
ADAM12	ADEVVSASVR	1
FAM241A	EAAGTEWDPGASPR,GGDGGERDEDGDALAEREAAGTEWDPGASPR	2
UBAP2	GAQEKPQISAAQSTQPQK	1
HLTF	NNLYYNTITNFSEKDRPENVHGGILADDMGLGK,CSQQPSISDIKEK,NDIHEDNLLECPPEELAHDSEK	3
ERF	SGGSAGGLAEGAGVLAPPPPPPQIK	1
DPCD	HQLPLDDASLSFAHANCTLIISYQKPK	1
SORL1	TSVVIKWESPYDSPDQDLLYAIAVK,WESPYDSPDQDLLYAIAVK	2
PNPLA6	ETPGRPPDPTGAPLPGPTGDPVKPTSLETPSPPLLSR	1
ITGAV	GVSSPDHIFLPIPNWEHK,GVSSPDHIFLPIPNWEHKENPETEEDVGPVVQHIYELR	2
DPP3	KLIVQPNTHLEGSDVQLLEYEASAAGLIR,LEGSDVQLLEYK,LIVQPNTHLEGSDVQLLEYEASAAGLIR	3
IGLV2-18	LMIYDVSNRPSGVPDR,LMIYDVSNR	2
KRT7	SMQDVVEDFKNKYEDEINR,NKYEDEINRR,NKYEDEINR	3
VMAC	AELLQDICHR	1
PDLIM2	SRPPGCYTCADCGLNLK	1
ESD	KAFSEYLGTDQSKWK,AFSEYLGTDQSKWKAYDATHLVK,AFSEYLGTDQSK,AFSEYLGTDQSKWK,KAFSEYLGTDQSK	5
GGA2	NLLDLLSPQPAPCPLNYVSQK	1
MAD1L1	QRLHEDHSQLQAECER,LHEDHSQLQAECER	2
TAAR9	TDLSTTNLFSEEVETD	1
EHHADH	KNPDIPQLEPSDYLK,KNPDIPQLEPSDYLKK	2
COL12A1	GSETSHCFTGLSPDTDYGVTVFVQTPNLEGPEVSVK,KIGVLITDGKSQDNVEAPSK,NAFVNQSTADLHPNGLPPSYTIILLFR,SQDNVEAPSKK,IGVLITDGKSQDNVEAPSKK	5
RAB11FIP5	AAEPQGEPGGGGGGGGGGR,AAEPQGEPGGGGGGGGGGRGGSSVWLEPR	2
PIKFYVE	NSDPFAHSKDASSTSSGK	1
EML2	SHIYFWTLDGGSLSK,GRPVPMVIPDELAPTYSLDTR,SNGGNLLCAVDESNDHMFSVWDWAK	3
CSH1	YSFLHNSQTSFCFSDSIPTPSNMEETQQK	1
CCDC181	FKDQLVDLEVPPLEDTTTSK	1
GPX4	GKGLLGNAIKWNFTK	1
PGGHG	VSIACLAPGSGPITLLLR	1
DCAF8	VHDRSEEEEEEEEEQPR,SEEEEEEEEEQPR	2
PDE5A	ADNSVPGTPTR	1
CCDC157	QAGKLEQALR	1
ERCC6	SDPLKDDPHVSSNVTSNDR	1
YY1AP1	AENNLLALGLK	1
AGT	ADSQAQLLLSMVVGVFTAPGLHLK,TGCSLTGASVDSTLAFNTYVHFQGK	2
THRAP3	PSQAAGDNQGDEVKEQTFSGGTSQDTK,DSRPSQAAGDNQGDEVKEQTFSGGTSQDTK,SSSKDSRPSQAAGDNQGDEVK,DSRPSQAAGDNQGDEVK	4
TNR	TATSLDLEWDNSEAEVQEYKVVYSTLAGEQYHEVLVPK,VVYSTLAGEQYHEVLVPK	2
ITGAE	TCSLSYVAGAPQYK	1
RABEP1	DVQEQIAVLMQSR	1
TECPR1	DVSIIPESLGAEGSGHSIALWAVSDKGDVLCR	1
HEBP2	SFNGFSSAQKNQEQLLTLASILR	1
SCLY	MMGGKPQDIIFTSGGTESNNLVIHSVVK,VSGQTEVDDILAAVRPTTR	2
MYO5A	SAPEVTAPGAPAYCVLMEQLTSVSEELDVRKEEVLILR	1
DOCK9	FTWALSKPGTAAELR	1
ATAD3A	ATVEQEMELR,RATVEQEMELR	2
PECAM1	TTAEYQLLVEGVPSPR,ANKEQEGEYYCTAFNR	2
HBB	MVHLTPVEKSAVTALWGKVNVDEVGGEALGR,MVHLTPKEKSAVTALWGK	2
BNIP2	ASSGDIGSLDYQEFVVDIESR	1
IGHV2-70D	IDWGDDQFYSTSLK,ESGPALVKPTQTLTLTCTFSGFSVSTSGMR,NQVVLTMTNMDPVDTAAYYCAR,ESGPALVKPTQTLTLTCTFSGFSLNTSAMR	4
GTF3C1	GSTESFGAANISQAAR	1
PDLIM1	TAASGVEASSRPLDHAQPPSSLVIDKESEVYK,TAASGVEASSRPLDHAQPPSSLVIDK	2
MAP6	AGPAWMVR	1
TRIM63	NLLVENIINIYKQECSSRPLQK	1
IGHV2-26	ALEWLAHISSNDEK,ESGPVLVKPTETLTLTCTVSGFSVSNAR	2
ALDH9A1	GVLMANFLTQGQVCCNGTR	1
LIPC	LSPDDASFVDAIHTFTR	1
C4A	RGHVFLQTDQPIYNPGQR,GHVFLQTDQPIYNPGQR,TLDIPGNSDPNMIPDGDFNSYVR	3
C4B	RGHVFLQTDQPIYNPGQR,GHVFLQTDQPIYNPGQR,VVAQGSFEFPVGDAVSK	3
RABGGTA	AAYLDDLR	1
SPECC1	CPTSITQESSFGSPTGNQLSSDIDEYKK,LIYLEHSPNSEGAASHTGDSR	2
CAPSL	EEVEELFQR,GLNDYAVVMEKEEVEELFQR	2
GPR158	KEEVWDSFKV,ASASDSSATWSR	2
PCOLCE	DPVLPPESFVVLHRPNQDQILTNLSK	1
DYNC1H1	GNEIVLSAGSTLR	1
STING1	FLDKLPQQTADR,FLDKLPQQTGDR,LFCQTLEDILADAPESQNNCR	3
CORO1B	RNVLSDSRPAMALGSSHLGAPASTTTAADATPSGSLAR	1
CTSW	KVAGAISPIKDQK	1
AMY1C	NAVDGQPFTNWYDNGSNQVAFGR,QIRNMVNFRNAVDGQPFTNWYDNGSNQVAFGR,QIRNMVNFHNVVDGQPFTNWYDNGSNQVAFGR	3
MMRN2	VSALEQASEPPRPAEHLEPSHDAGREEAATTALAGLAR,AEAEDTSKDPVGR	2
MBD1	LLPSVWSESEDGAGSPAPYRR,LLPSVWSESEDGAGSPAPYR	2
RGPD3	DGQYFEPVVPLPDLVEVSSGQENEQVVFSHR,EMLNSVMQELENYSEGGPLYK	2
DCN	LGLSFNSISAVDNGSLANMPHLR	1
OXSR1	ILQRAPTISER	1
GOLGB1	DDCNRLQEQFDEQSKENENIGDQLR,LSSTDQQESCSSTPGLEEPLFK	2
IGKV1-8	ITQSPSSLSASTGDR,MTQSPSSLSASTGDRVTITCR,MTQSPSSLSASTGDR	3
MT1E	KSCCSCCPVDCAK,CTSCKKSCCSCCPVDCAK,SCCSCCPVDCAK	3
CYB5D1	YLTPAEVAQHNRPEDLWVSYLGR	1
DPP7	FFQQRLDHFNFQR,APDPGFQERFFQQRLDHFNFQR	2
RRS1	QMREENQEEAAKR	1
GRHL2	AENFTPVFMAPPVHYPR	1
CALU	IDVDKDGFVTEGELK,LGMIVDKIDVDKDGFVTEGELK	2
NAA25	GLETHIIALK,GLETHIIALKLEELILEDTSLSPEER	2
ARHGEF18	SAMSEIEGIQSLICRR,RLGSANGQAEDGGSSTGPPR	2
EPS8L1	GFSSGTVDALGVLTGAQLFSLQR,QQSAPEVAVNGHR,STTTGPEAAPKPSAK	3
TMEM177	SLLGKEGEKLYTPSGNIVPR	1
CTPS1	NVLGWQDANSTEFDATTSHPVVVDMPEHNPGQMGGTMR	1
MAGEA10	AEILESVIK	1
TLN1	LLSDLLPPSTGTFQEAQSR,RLLSDLLPPSTGTFQEAQSR	2
ZNF793	DPLSAVNAGNRLVRSHTSMYIEK	1
FRY	VAEQRPGSILYGTHGPLPPLYSVSLALLSSELAR,STGQLNMNPGTTSSNTATAER	2
RNF113B	YCLCEDENHEVGSEEEEIPFR	1
RGPD2	LAAVAQGLQQTSIPK	1
MAP1S	TLACVCALLVWHPAGPGEK,VLFPGCTPPAYLLDGLVR	2
KIF23	VRPLGFPDQECCIEVINNTIVQLHTPEGYR	1
IGKV1D-37	VTITCRVSQGISSYLNWYQQKPGK,VSQGISSYLNWYQQKPGK,VSQGISSYLNWYQQK,LLIYSASSLQSGVPSR	4
NOMO3	SKNLDNPIQTVSLGQSLFFHFPPLLR,SNFLTQDNGILTFSNLSPGQYYFKPMMK	2
NOMO2	SNFLTQDNGILTFSNLSPGQYYFKPMMK	1
SIGLEC14	DGEIPYYAEAVATNNPDRR	1
SIGLEC5	DGEIPYYAEAVATNNPDRR,KKPWPDSAGDQASPPGDAPPLEEQK	2
SDF2L1	NLHTHHFPSPLSNNQEVSAFGEDGEGDNLDLWTVR	1
PHACTR4	TFQVVPEIEFPPSLDIHQEIPQQEDQKK	1
USP8	DIQIGTTLR	1
PTX3	LTSALDQLLQATR	1
SIRT6	LVWQSSNVVFHTGAGISTASGIPDFR	1
ZCCHC4	YVSLENQHCEHCNSCTSKDGR,YVSLENQHCEHCNSCTSK	2
BHMT	EGLEAAQLK,LMKEGLEAAQLK	2
KRR1	SVSFEQAVQILQDDVACDIIK	1
MUC17	SSPTTSEGTSMPTSTPSEGSTR,NQKPYCISPCEPGFSVSK	2
CWF19L1	YVGNFGNSSGEVDTKK,YVGNFGNSSGEVDTK	2
CRB2	AEAPGSPAVVLPGR,GCATQPCHHGALCVPQGPDPNGFR	2
GBP1	VQLPTESLQELLDLHRDSER,VQLPTESLQELLDLHRDSEREAIEVFIR,KGTNQKDETFNLPR,VQLPTESLQELLDLHR,CSGLLQVIFSPLEEEVK,CSGLLQVIFSPLEEEVKAGIYSKPGGYR,LQDEELDPEFVQK,GVWMWCVPHPK	8
CARD10	GDCSVRDPEDTAMPGR	1
MLPH	LQGGAGPEPISEER,MALGIAAALGSNVIR,ASSESQIFELNKR,ASSESQGLGAGAR	4
SZT2	EIPLTPVDQAAFLSEVLQR	1
MCCC1	QYNIVGLPTNIDFLLNLSGHPEFEAGNVHTDFIPQHHK	1
RIF1	NYEEMMIGEAMAETGHDGETENEGITTK,NLVAQISALALQLDSEDLHNYSGSQLFEMHEK,AATMENAVLLETNTVEEK	3
TSEN15	GDSEPTPGCSGLGPDGVR	1
PHRF1	INIPGNMAHYSQLSSPGFCNTFRPVDDKEQR	1
ALG2	ERDPVPKPSVLFLHPDLGVGGAER	1
COMMD10	SLAPCKLETVGWQLNLQMAHSAQAK	1
ZHX3	VMIPLSSIPTYSAAMDSNSFLK	1
PSG4	NVLLLVHNLPQNLAGYIWYK,VSEGKNVLLLVHNLPQNLAGYIWYK	2
TJAP1	ELEIGQNCLELELGQSR	1
HDLBP	VHIEFTEGEDKITLEGPTEDVSVAQEQIEGMVK	1
INPP5D	DNTELPYHGK	1
DOCK4	GSVKSFTPSPVEYHSPGLISNSPVLSGSYSSGISSLSR	1
RNF130	SALGNLAGDNSLGLEPLR	1
PPP1R32	QPTGFSLNNPMYVR	1
SETX	AGSHTAQNSDVFVPESDRSDYNCTGGTEVLANSNR,AGSHTAQNSDVFVPESDRSDYNCTGGTEVLANSNRK	2
SBSPON	TESLTPHCALENRPLTR,QATSPHWSTHTEDAGYCMEFKTESLTPHCALENRPLTR	2
EARS2	SGMSLTQDMLNGELKK,SGMSLTQDMLNGELK	2
LYRM4	AQVLALYR	1
HTT	LRDGDSNSTLEEHSEGK,VGALHGILYVLECDLLDDTAK	2
DDC	EMVDYVANYMEGIEGR,GKEMVDYVANYMEGIEGR	2
NT5E	HADEMFWNHVSMCILNGGGIR	1
SDCBP2	NGLLTNHYVCEVDGQNVIR,GSSAACNGLLTNHYVCEVDGQNVIGLK	2
EIF2AK3	ESETQCQTENKYDSVSGEANDSSWNDIKNSGYLSR,KQWDLDVGSGCLVSSSLSKPEVFGNK,RMDPFSTKEHIEIIAPSPQR	3
CHCHD6	YEQEHSAIQDKLFQVAKR,YEQEHSAIQDKLFQVAK,YEQEHSAIQDK	3
SPINK5	NAAGHGSSGGGGGNTQDECAEYQEQMK,ATSYAELCNEYR,ENNPIQGPDGK	3
BDH2	QIDQFASEVERLDVLFNVAGFVHHGTVLDCEEK,KQIDQFASEVER,QIDQFASEVER,KKQIDQFASEVER	4
NELL2	TYFEGERDTVYSSSGVCVLYECKDQTMK	1
DLC1	STCNVVHDEFLDIPCTNR	1
ANXA11	GFGTDEQAIIDCLGSCSNK	1
CENPF	SEKEDLTNELQK	1
LRP11	AGGGPQEDCPGRGSGGYSAMPDAIIR	1
TRUB1	LLAEAGMPSPAWTK	1
SASH1	AQPLERDSAVDNALLLTQSKR,SEIEESLGFCSAVSTPEVER	2
KRT2	WELLQQMNVDTRPINLEPIFQGYIDSLKR,WELLQQMNVDTRPINLEPIFQGYIDSLK	2
GADD45GIP1	YGAASGVVPGSLWPSAEQLR	1
CYP2B6	IPPTYQICFLPR,HRETLDPSAPR	2
TRIM25	LQELTPSSGDPGEHDPASTHK	1
FMN1	SPDHSPTEQDDRTPGR,SPSVVLSEPSQESK,SNSKPADGPSDSKSPDHSPTEQDDR	3
DLAT	QTIPHYYLSINVNMGEVLLVR	1
ANXA8	ILVCLLQGSRDDVSSFVDPALALQDAQNLYAAGEK,DDVSSFVDPALALQDAQNLYAAGEK	2
ITGA8	KMPYTDQPAKLPEGSIAIK	1
APPL1	LIAASSRPNQASSEGQFVVLSSSQSEESDLGGGGK	1
MRPS22	TFKPALQELKPPTYK	1
PRSS2	ITNNMFCVGFLER	1
CGAS	GAPMDPNESPAAPEAALPK,ENHLSQFLEGEILSASK	2
CLEC1B	NYLQDENENR	1
EXOSC7	VLHASLQSVLHK,VLHASLQSVLHKEESLGPK	2
ENOSF1	TLVSCIDFR	1
IFIT2	VCSILASLHALADQYEEAEYYFQK,KAEALIQQEHADQAEIR	2
LMTK2	KTFDSEPLCLSDNLMHQDNFDPLNVQELSENFLFLQEK	1
ALDH1A3	LECGGSAVEDK	1
ARHGEF10	SNLSSSSGSLSLSHGSSSLEHR	1
ADPRHL1	LQNMSSGENKPSCICGGENVVENAHTEFPTVTENR	1
RIN3	RDFHFVYRPLDGGGGGGGSPPCLVVR,APGFPLVSSLRPTAR	2
ESF1	SLDPALSMLIK	1
GBP6	FPTDTLQELLDVHAACER,QKLQEQQQQMEAQVK,VKFPTDTLQELLDVHAACER,LQEQQQQMEAQVK,ASDYYSQQMAQR	5
C2CD4B	AESLVGGAPGPR	1
UGT1A8	GIGCHYLEEGAQCPAPLSYVPR	1
SUGP1	FIADGGPEVETIALQNNHENQAFSFLYEPNSQGYKYYR	1
EPRS1	LKTEKAPQDQVDIAVQELLQLK	1
RIOX2	IGRPVHEFMLQPGDLLYFPR,DHIVLTVLPDQDQSDETQEK,LQFKDHIVLTVLPDQDQSDETQEK	3
SLK	SEEEKDQQKQQMFENK,DQQKQQMFENKLIK,DVISNTSDVIGTYEAADVAQK,KEPEVIVVSQPTEPQPVLIPSININSDSGENKEEIGSLSK	4
PLA2G4C	IEPDEAPVVAVLGSGGGLR,SENYSLTDFWAYMVVSK,WEWGTPHNFLYK	3
SLC5A6	LLSLFPLSCQK	1
DDX60L	SDNPVVPSLFK	1
PLIN5	AQDTLAQLQETLELIDHMQCGVTPTAPARPGK	1
ATF7IP	NKADNNIDAIEETLETDDTTICSDRPPENEK,ADNNIDAIEETLETDDTTICSDRPPENEK	2
RAD51D	TQDEEEQAEALQR	1
TTC9	AASPAGALKPGR	1
EPHX1	FHFTPPLEDSCFHYGFNSNYLK,SAAREDDSICPFKVETSDEEIHDLHQR,IEGLDIHFIHVKPPQLPAGR,QVEILNRHPHFK,KQVEILNRHPHFK,TKIEGLDIHFIHVKPPQLPAGR	6
APOE	CLAVYQAGAR,LGADMEDVRGR	2
DHX37	TPLEDYSGECFQK	1
ANK1	LLLQYDAEIDNITLDHLTPLHVAAHCGHHR,EGQNVNMENLYTALQSIDRGEIVNMLEGSGR,EGQNVNMENLYTALQSIDR	3
AKR7A3	FMELGLSNYAAWEVAEICTLCK	1
GLCE	WDYHTTHINQLQLLSTIDESPIFK	1
NEK7	ALRPDMGYNTLANFGIEK	1
GCSH	AVPLPAAPCPPRPWQLGVGAVR	1
CPT1A	AGNTIHAILLYR	1
CD6	EDAGVVCSEHQSWR,QLGCGWAVQALPGLHFMPGR	2
COQ6	DLGSMSHLTGYETER	1
PEAR1	SYSYSYSNGPGPFYDK	1
PRR18	FSLNLTPEAVLVIQK	1
prr18	FSLNLTPEAVLVIQK	1
MOCS1	GLNEDELLDFAALTEGHPLDVR	1
NT5C	DKTVVLGDLLIDNKDTVR	1
CD200R1	ASQALQSEVDTDLHTL	1
SEH1L	VWDKSESGNWHCTASWK,MATCSSDQSVKVWDKSESGNWHCTASWK,SESGNWHCTASWK	3
CPT2	ALEDVFDALEGKSIKS,DGSTAIHFEHSWGDGVAVLR	2
HKDC1	MCINTEWGGFGDNGCIDDIR	1
MTREX	MYSHPLHNDPDLETVYTLCEK	1
NCF2	LYEPVVIPVGR,QKLYEPVVIPVGR	2
NPC1	DNGQAPFTITPVFSDFPVR,SCATEEQYKGTER	2
PRR16	VQANAPLIKPPAHTSAILTVLR	1
ACAA1	GCFQAEIVPVTTTVQDDK,GCFQAEIVPVTTTVQDDKGTKR,GCFQAEIVPVTTTVQDDKGTK	3
MX2	ATGPENNLYSQYEQK	1
PLCD1	TFAEAAGSGETLSVNQLVTFLQHQQR,EEAAGPALALSLIEHYEPSETAK	2
CEP70	IGELEDESLNR	1
TRAPPC10	RQESSSSLEMPSGVALEEGAHMLR,YLPHHSAHSSQLDADSWIENDSLSVDKHGDNQPDSSSLK	2
AIP	EQPGSPEWIQLDKQITPLLLNYCQCK,EQPGSPEWIQLDK,NLQMKEQPGSPEWIQLDKQITPLLLNYCQCK	3
ABCA7	KEEWQPGQQSR	1
PECR	KHGGSIVNIIVPTK	1
GGT5	VNVYHHLVETLKFAR,ETVPASHAPSLLDQCAQALPLATGAQWIGVPGELR	2
TEKT1	ENTIYINEVLCMQMR	1
BRD7	EREDSVDAEAHAFK	1
FMNL1	FSESTAMGASR	1
P3H1	RIIESYFR	1
GRHPR	NTMSLLAANNLLAGLRGELMPSELKL,TRNTMSLLAANNLLAGLRGELMPSELK	2
RSPH1	KPTSTDGPGQDAPGAESAGEPR	1
HNRNPH3	YIELFLNSTPGGGSGMGGSGMGAYGR	1
MLX	AHRDNPHEGEDQVSDQVK	1
IGKV2D-28	SSQSLLHSNGYNYLNWYLQK	1
TMA16	LQWFQNHLDPPK	1
COL10A1	YQTPTGIK	1
EML1	CSNEAVFAVDFHPTDTNIIVTCGK	1
TMEM231	ALYEVFSHPVER	1
EEF1AKNMT	MDVTQMEFPDASFQVVLDK	1
LIPT2	RLQAEPGIEAPSGTEAGALLLCEPVGPVYTAGLR	1
CLTCL1	ILQNLLILTAIKADR,ILQNLLILTAIK	2
TRIM5	LQGSVMELLQDVDGVIKR,GHHTFLTEEVAQEYQVK,LQGSVMELLQDVDGVIK	3
ABCC2	IIEYGSPEELLQIPGPFYFMAK	1
CCDC88B	EAPQGELVPEAR	1
SFT2D3	AEEPGDGPAEEWLGR	1
IGLV1-40	VTISCTGSSSNIGAGYDVHWYQQLPGRAPK,VTISCTGSSSNIGAGYDVHWYQQLPGR	2
FAM3D	SFDMYSGDVMHLVK	1
H3-5	RVTIMPEDIQLARR	1
ARHGAP45	FLVAKAEEEQAGSAPGAGGTATK,ECVLHDDLLEAR,LKECVLHDDLLEAR	3
TDRP	GGPPPAAAAQAQVQGASFR,GRVLLDEPPEEEDGLRGGPPPAAAAQAQVQGASFR	2
POLR2E	AQFGDKPSEGRPR	1
GART	GIQQHKEEAWVIGSVVAR	1
SGCG	LYLSVAGVSTTCQEHSHICL	1
MUC12	SPDATLSPATTTSSGVSK	1
SMG6	LKQQVSVSSTDSLDEDRIDEPDGLGPR,QQVSVSSTDSLDEDRIDEPDGLGPRR	2
ALDH18A1	LIDIFYPGDQQSVTFGIK	1
TACSTD2	AAGEVDIGDAAYYFER	1
ASS1	NPWSMDENLMHISYETGILENPKNQAPPGLYTK,NPWSMDENLMHISYETGILENPK	2
FGL1	QLLQENEVQFLDKGDENTVVDLGSKR,IKQLLQENEVQFLDKGDENTVVDLGSK,QLLQENEVQFLDKGDENTVVDLGSK	3
PMPCB	LCTSVTESDVAR	1
TRIM16	LQSHLLTDPVKDHNWR	1
RASGRP3	SQPTSPATPNKPVVPLEWALGVMPKPDPTVINK	1
PNN	SLSPGKENVSALDMEKESEEK,SLSPGKENVSALDMEK	2
PSMF1	QDALVCFLHWEVVTHGYCGLGVGDQPGPNDK,QDALVCFLHWEVVTHGYCGLGVGDQPGPNDKK	2
PDIA2	ELAEEFGVTEYPR	1
RFNG	LPPDTLLQQVTLSHGGPENPQNVVNVAGGFSLHQDPTR	1
CASKIN2	LSSVSGPSPEPPPLDGSPGPKEGATGPR,LSSVSGPSPEPPPLDGSPGPK,RLSSVSGPSPEPPPLDGSPGPK	3
TUBB8	KEAESCDCLQGFQLTHSLVGGTGSGMGTLLLSK,EAESCDCLQGFQLTHSLVGGTGSGMGTLLLSK	2
NCOA7	ERPQVSENLQK,KEDFIVQDLEVWAFE,ERPQVSENLQKTELSDGK,EPSDTSAAFESTAK	4
PBXIP1	GPDGVCLSGDRGPQGDK,LQGLEADCVRGPDGVCLSGDRGPQGDK	2
NARS2	ELTFGSSVEVQGQLIK,CPEDVELCHR	2
MSH6	AAAAPEASPSPGGDAAWSEAGPGPR	1
DOCK8	TLQLAVAINQEPPDPK,IQFMCGEDASNVMPVIFGK	2
TARS3	QATLESAELEAAQEGGAQPPPSQSQDKDMK,LRDEQLNSPYSCQAEGPCLTR,SRQATLESAELEAAQEGGAQPPPSQSQDKDMK	3
PMS2	GSQEHVDSQEKAPETDDSFSDVDCHSNQEDTGCK,EAVSSSQGPSDPTDR	2
NCOR2	RGKSQQQQQQQQQQQQQQQQQQPMPR,SILTSTTTVEHAPIWRPGTEQSSGSSGSSGGGGGSSSR,SQQQQQQQQQQQQQQQQQQPMPR	3
POLR1A	FLEENADPSASEIR,FLEENADPSASEIREELEQYTTEIVQNNLLGSQGAHVK	2
MRPL30	IKPLKLPQGLPTEENMSNTCLK,LPQGLPTEENMSNTCLK	2
C11orf96	GAPAQRPPSESPGAPPPGPADAGGAMAAK	1
CPN1	YGDPNHHLPLPDNWK	1
TRMT10C	NESTRPSEELELDKWK,NESTRPSEELELDK	2
TKFC	VAGALAEAGVGLEEIAKQVNVVTK,LIDAETTAGAWPNVAAVSITGR	2
LOXL1	HPFGFGQVPDNWREVAVGDSTGMALAR,EVAVGDSTGMALAR	2
IGKV6D-21	ASQNIGSSLHWYQQKPDQSPK	1
METTL7B	FVVAHGEDMR	1
ZYX	PQVQIHVQSQTQPVSLANTQPR	1
ECM2	QLGIPQTTVFTPVAR	1
TBC1D4	CVPAPGAGVSGGTSPSATQPNPAVFIFEHK,LLPADALANCDLLLR	2
ANXA3	DYPDFNPSVDAEAIQK	1
EBNA1BP2	GFSDKLDFLEGDQKPLAQHK	1
BTBD8	KQSSNDLFQVNSTSDDEIPR,QSSNDLFQVNSTSDDEIPR	2
TUBA4B	NLDIEHPTYTNLNRLISQIVSSITASLR	1
CYS1	RSPESLPAGPGAAALEGGTLR,SPESLPAGPGAAALEGGTLR	2
CFAP77	DSMFQNLLIVK	1
UCHL1	MQLKPMEINPEMLNKVLYR	1
C10orf71	DPEPGGATEKMKTQQLENGLSR,CMANKVMEDPGQGSSMAR	2
CSF1R	LSIPQQSDFHNNR	1
ZNF436	AHTGEKPYHCNKCGENFSR	1
EIF5B	VEGNTVHIEVK	1
LILRB4	QMASPPSPLSGEFLDTK	1
RAB35	ENINVEEMFNCITELVLR	1
WDR55	FELLSEPQFGDLTSVTLMK,AHGAPINSLLLVDENVLATGDDTGGIR	2
IGHV4-39	GLEWIGSIHYR,VTISVDTSKNQFSLR,LNSVTAADTALYYCAR	3
CHI3L1	THGFDGLDLAWLYPGRGDK	1
MMP9	MFPGVPLDTHDVFQYQEK,KLDSVFEEPLSK,KLDSVFEEPLSKK,LDSVFEEPLSK	4
MASP1	KNEINLESELKSEQVTE	1
MUC4	NDVVFQPISEEDVR	1
ITGAX	VDSAGFGDSVVQYANSR	1
CBR1	NFLRKEYGGLDVLVNNAGIAFK	1
ARSL	LAGSEVPQDR,LAGSEVPQDRVIDGQDLLPLLLGTAQHSDHEFLMHYCER	2
TRMO	SMVPAWVTEAPVATLEVR	1
AQP9	AEQSEDKPEKYELSVIM	1
IFI30	TDALQPPHEYVPWVTVNGEPLEDQTQLLTLVCQLYQGK	1
AMACR	TDKGQVIDANMVEGTAYLSSFLWK,TADGEFMAVGAIEPHFYELLIK,SSLWEAPR	3
PYGL	WIDTQVILALPYDTPVPGYMNNTVNTMR	1
IGLV1-51	LLIYENNKR,LLIYENNKRPSGIPDR	2
CLOCK	ELGIEESIPETAADK	1
SYK	LGTQGNVNFGGRPQLPGSHPASSPAQGNR,LGTQGNVNFGGRPQLPGSHPATWSAGGIISR	2
MACC1	LLNLPGYLQK	1
ECHDC3	NTLSLAMLK,NHPVPVIAMVNGLATAAGCQLVASCDIAVASDK,RNTLSLAMLK,NHPVPVIAMVNGLATAAGCQLVASCNIAVASDK,KRNTLSLAMLK	5
KRT24	QTMQSLNDR	1
SNX30	TRPLEFAAMGDYLDTFALK	1
GPSM1	DSLPIPVR	1
PON1	GIETGSEDMEILPNGLAFISSGLK,GIETGSEDMEILPNGLAFISSGLKYPGIK,HKLLPNLNDIVAVGPEHFYGTNDHYFLDPYLR,SLDFNTLVDNLSVDPETGDLWVGCHPNGMK,LLPNLNDIVAVGPEHFYGTNDHYFLDPYLR	5
TNRC6A	VLNSQSESSALTNQQPQK	1
GSDMB	ELHMEDSDKPLLSSLFNAAGVLVEAR	1
ACACB	HNQVESIFLSAIDMYGHEFCPENLK,TAQAIKDFNR	2
AVL9	SMSEDGGLQESNPSADDFVSASTADVSHTNLGTIR	1
DGKG	QAPAEDQVAASPLEPPVPR	1
NXPE4	HCYPLIGSMTYSVK	1
PSMD2	EWQELDDTEKVQR	1
GANC	EEISVEDEAVDKNIFR	1
AMDHD1	AGGHSLLLENAQQVVLVCAR	1
RBFOX2	MAEGAQPQQPPQLGPGAAAR,AEGAQPQQPPQLGPGAAAR	2
GNL3	NSLEFFTMLAQR	1
SLC7A6OS	LRSDAVESAAQKTSEDLER	1
EPN2	PAASIDPWGVPTGATAQSVPK	1
ADAP1	FHYLQVAFPGASDADLVPK	1
ITGAM	LACESASSTEVSGVLK,QNTGTWESNANVK	2
RPN2	VKISTEVDITNVDLSTVDKDQSIAPK,ISTEVDITNVDLSTVDKDQSIAPK,NPILWNVADLVIKFPEEEAPSTVLSQNLFTPK	3
TBC1D17	VVEKDNDVLLHWAPVEEAGDSTQIIFSK,VVEKDNDVLLHWAPVEEAGDSTQIIFSKK,DNDVLLHWAPVEEAGDSTQIIFSK	3
GMPPB	FVEKPQVFVSNKINAGMYILSPAVLR,INAGMYILSPAVLRR,INAGMYILSPAVLR	3
EEPD1	AVVAEKPSNQLQK,VGSHDLTLVNLHLAALTLLGSENSSK	2
SPAG1	MVIQEIENSEDEEGKDSGR	1
APOB	EVLKESQLPTVMDFRK,EVLKESQLPTVMDFR,NEVQIHSGSFQSQVELSNDQEK,WKNEVQIHSGSFQSQVELSNDQEK	4
IBA57	LLTQDEGPALVPGSR	1
NOX4	SNKPVTIISVISHPSDVMEIR	1
YLPM1	SQLLAPPPPSAPLGNK,SQLLAPPPPSAPLGNKTTVQQEPLESGAK	2
KIDINS220	SSESSPNHSLHNEVADDSHLEK	1
SYPL2	IQYEMPLCDEGSSSK	1
RAI14	YSESSSKLEEDKDK	1
SPINDOC	TPPPRPSPLQAGSDGCEEPK	1
SYTL2	TDFGDTEEEVKGPEK,VHPSQMEISETVEK	2
CEP120	KDGPHGSVLEEGLDDYLTHLIEER,DGPHGSVLEEGLDDYLTHLIEER	2
AGXT	QHREATAYLHGR,DIVSYVMDHFDIEIMGGLGPSTGK,PLSIPSQLLLGPGPSNLPPR	3
PCDHB9	VSDINDHSPVFR	1
DNAH10	DIVDSFIRGSVLEAR	1
COL6A5	LINLGGENIR	1
DSG1	DITTVMPQIPPDNANIIECIDNSGVYTNEYGGR	1
ATP10B	EAEASLDKRDELLMETAQHLENQLTLLGATGIEDR	1
NSUN2	AGEPNSPDAEEANSPDVTAGCDQAGVHPPR	1
PPP6R1	ELPSEQQEQWEAFVAGPLAETNKK	1
PGM2L1	DITTGYDSSQPNK,DITTGYDSSQPNKK,LIDALIEIFLQPSK	3
CENPC	TISPAESTALFQGR	1
MRPL10	IFPNQVLKPFLEDSK	1
CLCA1	DMVTQASLYLFEATGKR,DMVTQASLYLFEATGK	2
KTI12	EESGAAESPALVTPESEKSAK,EESGAAESPALVTPESEK,ELEREESGAAESPALVTPESEK	3
SGCD	EIQSQPGNALYFK	1
ZXDC	VNLASRPEQGPSGPAAAPGPGVAPAGAVTISSQDLLVR	1
NUP205	LLHLLVDDMPVKPYSDGEGGIEDENR	1
LRWD1	QPPLLLAALQAPTQILK	1
DPH5	NADISDVAFLVVGDPFGATTHSDLVLR	1
THBS2	VLNDNQFLWELIGGPPKTR	1
ZFYVE16	EQQNDTSSELQNR	1
SHROOM2	ANTSSAENILYTVGLWEAPR,CLFDSLQPER	2
ERO1B	ELEVCEQANK	1
CYP39A1	KVDFELAVQNIVYHTASIPK	1
MISP	SGTVATLQGTPDHGDPR,QATNHQELVEIPTRPLLTK	2
ELAC2	SSDSELNENEPHLPHGVSQR	1
GEMIN5	SSSSYHTWNTGTEGSFVER	1
PSG7	DLYHYVTSYVVDGQIIK	1
LCE3D	SPVQCLPPASSGCAPSSGVCGPSSEGGCFLNHHR	1
REPS1	SEDELRPEIDEHTQK,LKSEDELRPEIDEHTQK	2
LAMA4	LSDLQEALDQALNHVRDAEDMNRATAAR,LSDLQEALDQALNHVR,NGYLHVFYDFGFSSGPVHLEDTLKK,KNGAVWCICNENYAGPNCER,NGYLHVFYDFGFSSGPVHLEDTLK	5
GGA3	LHTLQEVNNNVR	1
SLC18A1	NNCLQGTGFLEEETTR	1
ILVBL	RPLMVLGSQALLTPTSANK,RPLMVLGSQALLTPTSANKLR	2
THUMPD1	NNQQVPDNTEELGQTK	1
IGLV3-22	DGERPSGIPER	1
HNF4G	SMIYKDILLLGNNYVIHR	1
VPS13C	WNYIASSECLPFWPENLSGK,LENVIVTDVDPK,GEPLHIVNSSNVTDEPLLK	3
IQCE	KAVLDEAVVVLQAAFR	1
AEBP1	TQWLEVDTR,VWPETPEEKAPAPAPEER,VWPETPEEK	3
NES	AWLSSQAAELERELEALR,SLKEESIEAVK,AWLSSQAAELER,AWLSSQAAELERELEALRVAHEEER	4
CCDC8	SQGTDNYREEAADNQR	1
CBR3	TMEEGAETPVYLALLPPDATEPQGQLVHDK,TMEEGAETPVYLALLPPDATEPQGQLVHDKVVQNW	2
TTR	YTIAALLSPYSYSTTAVITNPKE	1
IGHMBP2	LLESVQQHSLDAVLAR	1
COG1	ELLVSALQELQSSTSNSPSNK	1
NECTIN3	EVGNIQHSNGLNSR	1
OTULIN	YNTEEFITVYPTDPPKNWPVVTLIAEDDR,YNTEEFITVYPTDPPKNWPVVTLIAEDDRHYNIPVR	2
PCDHA6	AQNQDLNEDHDAKPRQPNPDWR	1
C4BPA	WNPSPPACEPNSCTNLPDIPHASWETYPR,WNPSPPACEPNSCTNLPDIPHASWETYPRPTK	2
WDR17	FGGGIGVPTKEER	1
VIL1	ANFLNSNDVFVIK,QVVVEGQEPAKFWMALGGK	2
ABCC6	TTSQAQTEVPLDDPDRAGWPAGK,VLEACALQPDVDSFPEGVHTSIGEQGMNLSGGQK,TTSQAQTEVPLDDPDR	3
FAM174B	FGSGAAGGSGSSNSSGDALVTR,AESVSAPRPEPER	2
DGAT1	ASSAAAPHTVSYPDNLNYR	1
DMRT3	IFPTQKPTVLELILKGCGGDLVSAVEVLLSSR	1
VWA5A	LIIYAQLTGK,VQSNCPLSPTKYLGEDKTSAQVSLAAGHK,DVPRPVLLGASAPLKIK	3
DCP1B	TSNTEQQTPLFQVISPQR,IPQPSQTLDPEPQHLSLTALFGK,CDPSTPVPASSAALNR	3
PLK3	AAAAPAPPAGPR	1
DENND4C	ESGMATAFIHALER	1
SLC27A3	ALAAAAADPEGPEAGCSLAWR	1
MRPS31	IQFDEGYDNYPGQEKMDDLKK,EAPETDTSPSLWNVEFAK	2
SYT8	GTTTTHLVQPDVDGLESSPGDAQQWGR	1
RTN4	KPAAGLSAAPVPTTPAAGAPLMDFGNDFVPPAPR	1
SSTR5	GSGAKDADATELRPDR	1
PRR15	SSEEAGFPGDPHEDK,SSEEAGFPGDPHEDKQ	2
NEFH	ETVIVEEQTEK,SEKETVIVEEQTEK	2
NLE1	HWVLSISWSPDGKK	1
CROT	WCQSMQDPSLNLR	1
APEX1	QCPLKVSYGIGEEEHDQEGR,NDKEAAGEGPALYEDPPDHK,EAAGEGPALYEDPPDHK,KNDKEAAGEGPALYEDPPDHK	4
TUT7	ISLKEENVCEENSPVDQSDFFYEFSK	1
SH2D4A	KKQDEEINQIEGER,QDEEINQIEGER,KQDEEINQIEGER	3
UTP25	FGVGDDDNFRDQGLTRPK	1
TMEM128	FLILPDAEAQLDREGDAGPETSTAVEKK,FLILPDAEAQLDR,FLILPDAEAQLDREGDAGPETSTAVEK	3
FNIP1	ELLGISDECR	1
POTEJ	CPQALFQPCFLGMESCGIHETTFNSIMK,SYGLPDGQVITIGNER,LCFVALDFEQEMATVASSSSLEK	3
srpk1a	LCFVALDFEQEMATVASSSSLEK	1
SSX2IP	SCISEHSSINVLNITAEEIKPNQVGGER	1
CHL1	THPVEVFEPGAEHIVR	1
ABCC3	NYSVHYRPGLDLVLR	1
SP140L	TFEDSEDSCR	1
LZTFL1	SLEENLATAKHNLLR	1
RGPD1	QTLPVTLR	1
YTHDC2	DGQELEPQVGEQLLQLWER	1
PRL	AINSCHTSFLATPEDKEQAQQMNQKDFLSLIVSILR	1
PLIN3	AQEALLQLSQALSLMETVK,QRAQEALLQLSQALSLMETVK,QRVQEALLQLSQALSLMETVK	3
THBS1	LCNNPAPQFGGKDCVGDVTENQICNK,IPEAGGDNSVFDIFELTGAAR	2
TYSND1	AGSEVLAAAGAVFLPGDSCR	1
IQUB	NNETLVQHGVKPQKIVQVEIFSTNPDLYPVR	1
SMC6	HALSYNQGQLK,TAQILNLQQHLSTLEK	2
PRRC2C	SVEDVRPHHTDANNQSACFEAPDQKTLSTPQEER,VDSDSSKPPETLTNPPGVCQEK,LNGQQTALASQYR	3
BOD1L1	DGIAVDHVVGLNAEK	1
PTGS1	ALGHGVDLGHIYGDNMER	1
FUCA2	VNGEAIYETYTWR	1
C4orf33	SYEALYPVPQHELQQGQKPDFR	1
H3-2	SAPATGGLKKPHR	1
INTU	ESQGSDGFEESGTLLK	1
GSTM1	LGLDFPNGMLGSLVAQLSFPGFPSIQLPYLIDGTHK,HSLCGETEEEKIR	2
TMCO4	TSSVQLHVAGLQPVLLQDR,VGAIEEFTFLPLTESR	2
ECHS1	IFEEDPAVGAIVLTGGDKAFAAGADIK	1
TAP1	SGAHSFISGLPQGYDTEVGEAGSQLSGGQR,SGAHSFISGLPQGYDTEVGEAGSQLSGGQQQAVALAR	2
QSOX2	VAALDCMEEENQAVCHDYDIHFYPTFR	1
MYH3	EKKALQEVHQQALDDLQAEEDK	1
ZNF579	GPEGGEGAECGGASEGGEGGQNGGDAAPARPPAGEPR,GPEGGEGAECGGASEGGEGQNGGNAAPARPPAGEPR	2
ISG15	VPLASQGLGPGSTVLLVVDKCDEPLNILVR,CDEPLNILVR	2
HLA-A	YFSTSVSR,AHSQIDRVDLGTLR,TDPPRTHMTHHAVSDHEATLR	3
AOC1	SSFGLQVLNVHFGGER	1
PSME4	NFDDAFLPVLKPHLEHLVADTHESTQR	1
PARVB	NAINSPMSPALADVHPEDTQLEENEER,AREVSDLQEEGKNAINSPMSPALADVHPEDTQLEENEER,EVSDLQEEGKNAINSPMSPALADVHPEDTQLEENEER	3
NPTX1	CESQSTLDPGADEAR	1
TP53BP1	VPETVSAATQTVK,SLVQESLSTNSSDLVAPSPDAFR	2
STIM1	VAPKPSQMSRAADEALNAMTSNGSHR	1
ACOX3	SVDFLDAYPGILNQKFEVSSVADCLDSAVALAAYK	1
EPB41L5	SIIMCRVSLLDGTDVSVDLPK	1
TSKU	LPELAPNGFRELPGLQVLDLSGNPK,ESAARGPTIL	2
ANKRD11	GSEEDDAQAQHPR	1
ZFP36L2	EPSGGGSTALLNK	1
ABCB10	LYNPASGTISLDGHDIR	1
INSL5	HLEGIPQAQQAETGNSFQLPHKR	1
TRIM33	TEPADMNESCK	1
FRK	SLQAEPWFFGAIR	1
BCL2L13	LQEQHLSSPQGVQLDR,ELQEALPEAPAPLLPHITATSLLGTRESDTEVITVEK	2
ACSBG1	CTLDPDTSDQTDNLTEQAVEFCQR	1
CCDC173	GGLRPSYQANDVTGVQLPFYNSQGSK	1
SLC25A33	NSTSFFGLMAAAAISK	1
TRIM32	IIDTAGLSEAVGLIMCR	1
GBP2	TLSGGIAVNGPR	1
CHMP3	AMQSLVKIPEIQATMRQLSK	1
APPL2	VCGAQNEMCLATQQLSK,VTASLPEAEELIAPGTPIQFDIVLPATEFLDQNRGSRR	2
GOLGA8N	NQTAEPLAPEPPAVPSEVELQHLR	1
TSC1	LMLLNTPGQLPQTLSSPSTR	1
IGKV3-7	ATLSCRASQSVSSSYLTWYQQKPGQAPR	1
CEACAM3	QIVGYAIGTQQATPGPAYSGR	1
CEACAM5	QIVGYAIGTQQATPGPAYSGR,NDVGPYECGIQNK	2
RBM45	VNMFPFVGEQQSEFSSFDKNDSR	1
WDR18	HVWSHHTLPITDLHCGFGGPLAR	1
ZNF586	VHTGERPYECTDCGK	1
CD27	SNKGESPVEPAEPCR,GESPVEPAEPCR	2
NRP1	SPGFPEKYPNSLECTYIVFAPK,YPNSLECTYIVFAPK	2
EGFL7	CINTAGSYWCQCWEGHSLSADGTLCVPK	1
IGKV2-30	SSQSLVHSDGNTYLNWFQQRPGQSPR	1
IGKV2D-30	SSQSLVHSDGNTYLNWFQQRPGQSPR	1
ADGRE1	KDGFSDPIIYTLENVQPK	1
GLYAT	ILSPSGGKPK	1
PNPLA2	APADPAPAPADPASPQHQPAGPAPLLSTPAPEAR,MRAPADPAPAPADPASPQHQPAGPAPLLSTPAPEAR	2
TRAF1	ALCCAGCLSENLR	1
PUDP	EVFPMAALMPGAEK,LKEVFPMAALMPGAEK	2
FKBP4	FEIGEGEKLDLPYGLER	1
CFAP69	AMVYLEDETVNKDLCEK	1
IGKV2D-29	PGQSPQLLIYEVSNR	1
SAMD15	EYYAIGSLR	1
apol1	SKLEDNIRR,EVKEFLGENISNFLSLAGNTYQLTR	2
APOL1	SKLEDNIRR,EVKEFLGENISNFLSLAGNTYQLTR	2
HORMAD1	DKDVEDEQEHYISDDLDIETK	1
GIMAP6	KEDLAGSSLEDYVR	1
SLC9A3	TQIPYSPGTFR	1
PSME2	EVPKCGFLPGNEK	1
PLCG1	AQREDELTFTK,EDELTFTK	2
RIBC2	GDLLSENPQQAASSLGPHR	1
TTI2	DLGDLIEATGFDR	1
JCAD	NANSQEDAEELKATTR,NANSQEDAEELK	2
SUMF2	DGEGPVREATVKPFAIDIFPVTNK,FLMGTNSPDSRDGEGPVR	2
LRRC1	LEELDLGNNEICNLPESIGALLHLK,RLEELDLGNNEICNLPESIGALLHLK	2
MSLN	QLLGFPCVEVSGLSTER	1
ZNF654	TFQAQCSFPECHELFEDLPLLYEHEAQHYLSK	1
CSPG4	DVNERPPQPQASVPLQLTR	1
PIDD1	GPSAAGGHPGPAASEPVLPPLPGPQR	1
ATP2B4	DALTQINIHYGGVQNLCSR	1
RB1CC1	LNSLPEHEDSEK	1
CCDC170	LIHSHQHHFVTCACLK,ASQDAVTTSQSQYSSFR	2
ACSL5	ADIAVVICDTPQK,KPVPPSPENLSVICFTSGTTGDPK	2
MAGEB10	DVSQSSLDGASNNPHGLQEAQSTSTSATAASHTR	1
DTX2	LSAASGYSDVTDSK	1
NAT9	LTASEPLTLEQEYAMQR	1
CPOX	YFEVEEADGHK,GIGGIFFDDLDSPSKEEVFCFVQSCAR	2
DBH	AFYYPEEAGLSFGGPGSSR	1
LSM14A	VSRPESEQLR	1
EFHC1	NDWGDHYHWK	1
ADAMDEC1	ECTSLCCEALTCK	1
MROH1	LASTLLDAITDKDPLVQEQVCSALCSLGEVRPVETLR	1
NSFL1C	ASSSILINESEPTTNIQIR	1
PATJ	SVIPGSAAYHNGHIQVNDK,GPGSDSSLFATYNVELVR,VLGLSIVGK,MHIGDELLEINNQILYGR	4
EIF3K	YGWSANESGQIFICSQEESIKPK	1
PRIM1	VNQFDPFTVPTISFICR	1
ITGA7	QGCGEDKICQSNLQLVHAR,ICQSNLQLVHAR	2
MRPL37	MILFAFGSAVAQAR,VFHFLVFQLNTTDLDSNEGVK	2
MAN2A1	FSPTLELQGEFSPLQSSLPCDIHLVNLR	1
IQSEC3	ELTAIVQNQQSLIHSQR	1
L3MBTL3	ADNKEDGEERDDEMENK	1
HSPBP1	VLSQPMPPTAGEAEQAANQQER,LPLALPPASQGCSSGGGGGGGGGSSAGGSGNSRPPR	2
TBC1D12	GVGAGGPEEGAPPATSAQR	1
DENND3	EDSQTAGANCGTLGK	1
ADH4	GLTVFPEELIIGR	1
IGKV3OR2-268	FSGSGSGTDFTLTISSLK	1
TRAF3IP2	VILNYPSPWDQEERPAQR	1
ZNF267	SHTGERPYECEECGK	1
EFNA1	ITHSPQAHVNPQEK	1
SPG11	SSVSEQFDHLSSHLYLR	1
CLU	ELNESLQVAERLTR,EILSVDCSTNHPSQAK,LRRELNESLQVAER,RELNESLQVAERLTR	4
VCPKMT	YLETPEFSGDGDHALSR	1
SFTPD	TAGFVKPFTEAQLLCTQAGGQLATPR,TTPSACTLVMCSSVESGLPGR	2
CPNE1	SDPLCILLQDVGGGSWAELGR	1
ARHGAP25	NSGEEEIDSLQSMVQELR	1
FAM83H	VNLHHVDFLR,SLENCLLDLR,FLELGPDGHQR	3
WDR33	GMQGAPPQGSMLGPPQELR	1
ORM2	EQLGEFYEALNCLCIPR	1
AHR	NLGIDFEDIK	1
HK3	MLPTYVGSSPHGTEQGDFVVLELGATGASLR	1
C5	IYSLNDDLKPAK,IYSLNDDLKPAKR	2
OLA1	CDPGALVIPFSGALELK	1
EPN3	TRNPFLTGLSAPSPTNPFGAGETGRPTLNQMR	1
PBX1	LMHSHAGVGMAGHPSLSQHLQDGAGGTEGEGGR	1
POLR1G	GTETFEPEDK,EKQQNATVEPETEVVGPELPDDLEPQAAPTSTK,QQNATVEPETEVVGPELPDDLEPQAAPTSTKK	3
SLC52A3	LREENDLGPAGMVDSSQGQGYLEEK	1
ITPR3	MDCVSGVSVPEVLEEDRELDSTER	1
ZNF154	LHTGEKPYECQECGK	1
CWF19L2	HSNQKPSETSTDEYQHVPEDPR	1
ASPA	DKNGEIAAIIHPNLQDQDWKPLHPGDPMFLTLDGK	1
EPB41L4A	TDLVPPLPVTHSSDAQGSGDATVHQR,IAQTQPAESNTISR	2
POLR3E	IKEEPVSEEGEENEEQEAEEEPMDTSPSGLHSK	1
CA3	GENQSPIELHTK,EWGYASHNGPDHWHELFPNAKGENQSPIELHTK	2
PPID	MSNWQGAIDSCLEALEIDPSNTK	1
DYNC2LI1	LRGVINQLAFGIDK	1
WNT6	GRAPPRPSGLPGTPGPR	1
F2	NPDSSTMGPWCYTTDPTVR	1
MYH1	NQHELEEAEERADIAESQVNK,RNQHELEEAEERADIAESQVNK	2
PAWR	KREDAITQQNTMQNEAVNLLDPGSSYLLQEPPR	1
PTPA	FGSLLPIHPVTLG	1
ZFYVE19	VLQQLTEEAALDEASGFNIPAEQASRPWTQPR	1
RPLP0	AFLADPSAFVAAATTAAPAAAAAPAKVEAK	1
TSPYL6	EAGPGPGPLNVGLHLNPLESIQLELDSVNAEADR	1
WDR36	VGVTALQQAPAVDVVAVGLMSGQVIIHNIK	1
GDF15	ARNGDDCPLGPGR	1
CEP192	NLFLKPGEEHEVIVSFTPK,AARPPPDQLASEEPWTVLPEHLILVAPSPCDMAK	2
PDXDC1	MQNIGEQGHMALLGHSLGAYISTLDK,MQNIGEQGHMALLGHSLGAYISTLDKEK	2
PGM3	VISTTNAERQAVTPPGLQEAINDLVKK,VISTTNAERQAVTPPGLQEAINDLVK,VISTTNAER	3
GALC	VVNVIGAHYPGTHSAK	1
DENND2A	FQNDHLSVLK	1
APOC3	HATKTTKDALSSVQESQVAQQAR	1
AP3B1	QLIVPNEK,FIRQLIVPNEK	2
STON2	LHECHFHGCVDEDVFHNSR	1
WDR93	LVNHLFDQSWEIIEER	1
SRP14	KTKAAAAAAAAAPAAAATAATTAATTAATAAQ,TKAAAAAAAAAPAAAATAATTAATTAATAAQ,AAAAAAAAAPAAAATAATTAATTAATAAQ	3
LRRC34	AINLNRPILYGEQEESTVHVGR	1
TNRC6B	MVSALQQQQQQQR,MEQEDFVMEGHGK	2
TARS1	FENEEAQAVYWHSSAHIMGEAMER	1
IGKV1-37	LLIYSASSLQSGVPSR	1
ADAMTSL1	TSPLGTQLVLGPGNSALLGCPIK	1
IDH1	VTYLVHNFEEGGGIAMGMYNQDK	1
SLAIN1	MSLPLGIYR	1
ABCA1	SEEMIQLGDQEVSELCGLPK	1
UBE3A	AACSATAMEEDSEASSSR	1
COQ8B	GAALKVGQMLSIQDNSFISPQLQR,VGQMLSIQDNSFISPQLQR	2
WASHC2A	TTPDQELAPASEPVWERPWSMEEIRR,TTPDQELAPASEPVWERPWSMEEIR,VSLLFEDDVDSR,TNTFPLLEDEDDLFTDQKVK	4
KIAA1522	VSLQALEAEAEAGAETEAVLQR	1
IGKV1D-17	ASQGISNYLAWFQQKPGKVPK	1
ALMS1	TGIPTVSSTSHSHGEDLLFFYR	1
TRIM36	VNFYDMDQMK	1
AKR1C4	LQLDYVDLYLLHFPMALKPGETPLPKDENEK	1
GNPAT	GVFADEFIFLPGNTLK,GVFADEFIFLPGNTLKDFEEGCYLLCK	2
CEMIP2	SAGVLLLVVDPCNVPFR	1
MRPL12	IQDVGLVPMGGVMPGAVPAAAAQEAVEEDIPIAK	1
VGF	ALAAVLLQALDRPASPPAPSGSQQGPQEEAAEALLTETVR	1
SLFN5	QKIDLTSLR	1
ACAN	CQPSGHWEEPR	1
TRAPPC5	VFSVAELQAR	1
PIBF1	DFELTEEQYVK	1
FAM160B2	SMPVFLDPADIAALEGISWR	1
CES1	FTPPQPAEPWNFVK,KGDVKPLAEQISITAGCK	2
POMGNT1	LLSEAEVLNHSKNPCEDSFLPDTEGHTYVAFIR,NHFLVVGVPASPYSVK	2
SLC7A14	SDKSTYNINHPNYGTVDMTTGIEADESENIYLIK	1
FRZB	NNYNYVIWAK	1
CFHR1	STDTSCVNPPTVQNAYIVSR	1
SYNPO	QRDQGEVGVEEETFALGAEASNFQQEPAPR	1
ATXN7	QVSSLSSSPSTPSGLSSVPSSPMSR	1
TBXAS1	EAAEDCEVLGQR,GALMSAFSPENLNEMVPLISQACDLLLAHLK	2
CPA3	AIFMDCGIHAR	1
CYP4A11	VWPNPEVFDPSR	1
CYP4A22	VWPNPEVFDPSR	1
GEMIN4	ALFREPDLVLR,FLGQILTAFPALR	2
ZFP62	IHTGKKPYQCNECGK	1
GPRIN1	ADPVPLESMDSASTGK,ADPVPLESMDSASTGKTEPGLLGK	2
NUP42	NKLTVEELEQFQSK	1
REXO1	TLAASGSQPSNGPEPGGQQLK	1
NOL10	NGTLSVSNTTVGSK	1
MOCS2	SKDVINFAAEK	1
ISM2	TCDLPSCPGTEDKDTLGLPSEEWELLAR	1
WASHC2C	GLFDDEDEESDLFMEAPQDR,RLAAQESSEAEDMSIPR,LAAQESSEAEDMSIPR	3
MTHFD1	DVDGLTSINAGR,MDTESELDLISR	2
PRNP	HMAGAAAAGAVVGGLGGYVLGSAMSRPIIHFGSDYEDR,HMAGAAAAGAVVGGLGGYVLGSAMSR	2
DOCK1	KQTSVDSGIVQ	1
ZZEF1	ALALLGVLPDGDSSPEDQALPVTVPTGASEEQLEKK,AVHEEVRPVDFKQR,AVHEEVRPVDFK	3
UBR4	VALEELENKPR,RVALEELENKPR	2
SPATA20	TLLNTGLEK	1
IGKV2-28	SSQSLLHSNGYNYLDWYLQKPGKSPQLLIYLGSNR,SSQSLLHSNGYNYLDWYLQKPGK	2
CBWD2	IPVTVITGYLGAGK	1
F12	LCHCPVGYTGPFCDVDTK	1
VIM	LHEEEIQELQAQIREQHVQIDVDVSKPDLTAALR	1
CCDC187	SGMEPQVALPSPWPGEGR,QQIQAGLELAQAHK	2
P2RX7	LPLALHDTPPIPGQPEEIR	1
C2orf15	SATQVSAIHMNSKVDDHLIRGTEK	1
DHRSX	TPDEGAWTSIYAAVTPELEGVGGR,LLAAEGSHVTANVVDPGVVNTDLYK	2
MGA	ISQLEKELIEDLKSLR	1
PLG	GKRVTTVTGTPCQDWAAQEPHR,KCSGTEASVVAPPPVVLLPNVETPSEEDCMFGNGK,CSGTEASVVAPPPVVLLPNVETPSEEDCMFGNGK	3
PRPH	AQYESIATK	1
TCN2	QSIFVLAGSTVEDVLKK	1
RAD18	SAAEIVQEIENIEK	1
TBCC	ENSHFFVATFAR,QNQEVEKENSHFFVATFAR	2
GNPTAB	NIFLVTNGQIPSWLNLDNPR	1
GPX8	FWRPEEPIEVIR,FWRPEEPIEVIRPDIAALVR	2
RSPH9	NYGYIYVGTGEK	1
IGHV3-15	LSCAASGFTFSNAWMNWVR	1
SORBS1	ASGSFAPISQAPPSFSPPPPLVPPAPEDLRR,AVMNGLAPGSNGQDKDMDPTK,NASGLVLPTDMDPTK,SEMSCIDGEK,SKSEMSCIDGEK	5
CRTC1	PAGISPLSLSTEAR	1
MFGE8	CVEPLGMENGNIANSQIAASSVR	1
MBP	TTHYGSLPQK	1
PIP5K1C	AAPTQVLSMTAQPGPGHGK,AAPTQVLSMTAQPGPGHGKK	2
NCAN	QDLSILVAK	1
TTC1	VTDTQEAECGGPPVPDPK	1
IRAG1	SSPGDSPSAVSSNLSPSASPTSSR	1
MED7	TEPMDADDSNNCTGQNKHQR	1
GAMT	MEVMALVPPADCR	1
TANC1	EAGSDFGPETSSVLHLDHSADSPVSSLPTAEDTYR	1
MRC1	HVHLPQEGAFENTLYFNSQSSPGTSDMK,GYEAMYTLLGNANGAICAFPFK,GYEAMYTLLGNANGAICAFPFKFENK	3
B3GNTL1	LDLTGGTFEDNLR	1
ALDOB	YDSICQQNGLVPIVEPEVIPDGDHDLEHCQYVTEK	1
TCHH	QVGEIQSQEGK	1
USP18	VPFQMLLLLEKQDSR	1
FAM221A	AFQASSGSSPETLTDVGTSSQVSSLRRPEEDDMAFFER	1
GBE1	LFAYSSWEVLR,NTGENEGGIDKFSR	2
SIRT5	FHFQGPCGTTLPEALACHGNETVS	1
BMP2	INIYEIIKPATANSKFPVTSLLDTR	1
EIF2B4	RGEHVALANWQNHTSLR	1
RSF1	FYETKEESYSPPKDR	1
CEP135	VAQIQTDYDALKR,LMISECESSVNQLK	2
CINP	WETLNDAGFTTANNIAK	1
NLRP6	LLIAPESAAPEEALGPAEEPEPGR	1
TBL2	LALSPNAQILALASGSSIHLYNTR	1
PALM3	GIVEVVWEGMGGSDAEAMGEIGRVPEVVQTSSPR,KAEESMGIGSEEKPGR,AEESMGIGSEEKPGR	3
IGHV3OR15-7	NTMYLQMSNLK	1
ATPAF1	VFPVRPGSGRPEGGADGSGVGAEAELQANPFYDR	1
RNH1	ELTVSNNDINEAGVHVLCQGLKDSPCQLEALK,ELTVSNNDINEAGVHVLCQGLK,LDFKELTVSNNDINEAGVR	3
HLA-DPB1	YIYNREEYARFDSDVGEFR,ATPENYVHQLR,EEYARFDSDVGEFR,YIYNRQEYAR	4
PLIN2	SQQTIPQLHSTVHLIEFAR	1
RIPK2	KQPFEDVTNPLQIMYSVSQGHRPVINEESLPYDTPHR	1
TBC1D25	ASPEDLEFIR	1
MKI67	SQPAASTLESESVQR,YENESLQSGR	2
ALDH4A1	ETLQLIDSTTSYGLTGAVFSQDKDVVQEATK,MEAIPCVVGDEEVWTSDVQYQMSPFNHGHK,YAVELEGQQPISVPPSTNSMVYR,YKETLQLIDSTTSYGLTGAVFSQDKDVVQEATK,GRMEAIPCVVGDEEVWTSDVQYQMSPFNHGHK	5
NUMA1	EVACLETLVR	1
CUL2	SAVDEDRKMYIQAAIVR	1
GTPBP10	GKDWEIPVPVGISVTDENGK,SSFLSCVSHAKPAIADYAFTTLKPELGK	2
COL6A6	EGVTIFTLGIEGTSDTQLEK	1
HRG	HPLKPDIQPFPQSVSESCPGK	1
APOH	EHSSLAFSK	1
PTPRC	TLLLDVPPGVEK	1
NAAA	NLDYPFGNILR	1
HMGN1	VSSTEGAAKEEPK	1
RNF181	HELPTDDDTYEEHRR	1
PAX9	NNFPAAAPHPVNGLEK	1
FUT2	ENIDTSHSDVVFAGDGIEGSPAK,QEILQEFTLHNHVR	2
LILRB5	SGVGYDIFVLYK	1
GAS2L2	TVTVDLAGSTHGDCSVEVR	1
CLMN	SSESDHFSCVQLR	1
GLB1	TTLPQDCSNPAPLSSPFNGVHDR	1
NAT2	TLTEEEVEEVLKNIFK	1
CRAT	SPMVPLPMPK	1
DENND5B	SQGAANTTSGENFDQSPLKR,FAHYFVLCGIDADSGLEPDELAGENFDQSPLKR	2
ADAMTS5	VTDGTECRPYSNSVCVR	1
EEF1A2	VETGILRPGMGVTFAPVNITTEVK,GPFKYAWVLDK,ATQAALSLLEALDTILPPTRPTDKPLR	3
IGKV2D-24	FSGVPDRFSGSGATDFTLK	1
ANXA2	SALSGHLETLILGLLKTPAQYDASELKASMK,SALSGHLETLILGLLK	2
MRPS2	EPGDQGPAHPPGADMSR,LQGQKEPGDQGPAHPPGADMSR	2
OBP2A	GLSEEDIFTPLQTGSCVLEH	1
KRT23	TFQALEIDLQAQYSTK	1
NBPF10	KGQEEEEDQGPPCPR	1
CNPY1	ALMDEIEHDITK	1
VRK2	MLDVLEYIHENEYVHGDVK	1
TEFM	QFLFDSLLK	1
SUCLG2	LEGANVQEAQK	1
SHANK2	SMTSELEELDKPEEIVPASKPSR	1
POLR1B	IVMEEGCLTQK	1
UBQLN4	AMQALLQIQQGLQTLQTEAPGLVPSLGSFGMSR	1
CMYA5	EESQNEENKPFSPK,CTLHLGIEPLDSVR	2
FOXRED2	RLEDSSQQLGDQEPLGSPLAPGPLAQSVNSNKEEL	1
ADH7	FPVIVGHEATGIVESIGEAVTTVKPGDK	1
SURF6	KAEEAMEAQEVVEATPEGACTEPR	1
ATRX	EQSFTSLEVR	1
FUT8	YATGGWETVFRPVSETCK	1
ARMT1	CGTDWEEYIK	1
CRACR2B	HDLQGLQSDLPLTPEQLEAVFESLDQAHTGFLTAR	1
MYL6	MTEEEVEMLVAGHEDSNGCINYEAFLR	1
PLIN1	LASGGADLALGSIEKVVEYLLPADKEESAPAPGHQQAQK,VVEYLLPADK,VVEYLLPADKEESAPAPGHQQAQK	3
KANSL2	EIAEDTVDILGQMQMAGDGCR	1
MUC3A	HLLHLLLSPLEVR	1
PGP	TILTLTGVSTLGNVKNNQESDCVSK	1
MYZAP	HQLQLQLLERETEMSGELTDSDKER	1
HSD3B2	RACQNVSVVIHTACIIDVFGVTHR	1
TRIM24	SDAPDSTGDQPGLHQDSSSNGK	1
PPIAL4H	HTGSGILSMVNAGPNTNGSQFFICTAK,KHTGSGILSMVNAGPNTNGSQFFICTAK	2
PPIAL4F	HTGSGILSMVNAGPNTNGSQFFICTAK,KHTGSGILSMVNAGPNTNGSQFFICTAK	2
PPIAL4E	HTGSGILSMVNAGPNTNGSQFFICTAK,KHTGSGILSMVNAGPNTNGSQFFICTAK	2
PPIAL4C	HTGSGILSMVNAGPNTNGSQFFICTAK,KHTGSGILSMVNAGPNTNGSQFFICTAK	2
C1orf87	EAPAPPMEPEVPEMSQSK	1
ZC3H3	GSLEEYEDTPWSDQRPR	1
ACADSB	IGIAAQMLGLAQGCFDYTIPYVK	1
CUX1	LEQDLSIIQSIQRPDAEGATEHR	1
AARS1	VDDSSEDKTEFIVK	1
ELAPOR1	VAVPHTPGLCTSLPDPVK,VAVPHTPGLCTSLPDPVKGTECSFSCNAGEFLDMK,TPDGFDSVPLKTSSGGPDMDL,RTPDGFDSVPLKTSSGGPDMDL,DSGTCHSCPPNTILK	5
TOX3	NLVEQDGMLHSSGLHMDQSHTQVSQYR	1
PGLYRP2	WGAAPYQGRPK,VSQTQSHPDLGTEGCWDQLSAPR	2
SAMD9	SLKVELTEDKIDYTK,VELTEDKIDYTK	2
CCZ1	ISGSEKEPQFK	1
LENG9	LDPAYFSVGYVDR	1
FERMT2	KKLDDQSEDEALELEGPLITPGSGTAVLYIGPLK,KLDDQSEDEALELEGPLITPGSGTAVLYIGPLK	2
IRAK2	DLLLSEIPSSTASLCSR	1
MCM5	NTLSNIAMRPGLEGYALPR	1
MVK	LQPHSNGKVDLNLPNIGIK,VDLNLPNIGIK	2
TRIM65	TLTLCHQPGAVFPPGPQEEVLS	1
SLC25A22	ILAAQGQVSAQGGAQPSVEAPAAPR	1
DAB2	DISNDAFTALDPLGDK,DISNDAFTALDPLGDKEIK	2
TCIRG1	RFVVDVWR	1
DHRS1	CVVALAIDPNILSLSGK	1
PSMB3	FGIQAQLVTTDFQK	1
LRPPRC	NNNIDAAIEDIENMLTSENK	1
CUL9	LDNLFLEQEDEEEK	1
ITGA2	KGILGQHQFLEGPEGIENTR	1
DMAC1	PATPATPGAPTSPAEHR	1
GZMH	EQEQTQQFIPVKRPIPHPAYNPK	1
TBC1D13	NSAPSSLNEYEVLPNGCEAHWEVVER	1
EPB41	ISLLDDTVYECVVEK	1
SSH2	AISELVSPDIFMQSHLENAISVK	1
DCAF13	NYDPALHPFEVPREYVR	1
UROS	IGLVTEGETCGNAEK	1
BCO2	FIAVNGATAHPHYDPDGTAYNMGNSFGPYGFSYK	1
F8A1	LHLQLGQPAAAAALCLELAAALR	1
EML4	ADSGVHLCVIDDSNEHMLTVWDWQR,ADSGVHLCVIDDSNEHMLTVWDWQK	2
PLS3	IDLNSNGFICDYELHELFK	1
GSTA3	ALLNYIASKYNLYGK	1
NOP9	KLPQFCAHLCNAVIGYLNTR	1
MME	LLPDIYGWPVATENWEQKYGTSWTAEK	1
BRD3	ADTTTPTTSVITASR	1
PLVAP	SQLMMPVSRPMGPVPNPQPIDPASLEEFKR	1
TAGLN	LVNSLYPDGSKPLKVPENPPSMVFK	1
KIF26B	TRGDSQPAEAGEAAAGK	1
ANO10	VTLSALDTSESSFTPLVVIELAQDVKEQTK	1
HSD11B2	AHTTSTGLWGLINNAGHNEVVADAELSPVATFR	1
GPC4	YLFAVTGNGLVNQGNNPEVQVDTSKPDILILR	1
ATL2	AEGDEAARGQQPHQGLR	1
LMAN2	LFQLMVEHTPDEESVDWTK	1
TBC1D5	GQGQSVQMSGAVK	1
CEP131	ANNAGGGLPAAGPGDR	1
NDUFV3	LEAEGEAMEDAAAPGNDR,TAALKLEAEGEAMEDAAAPGNDR	2
SCFD2	ALAQVFCEESGSSPLLQK,KALAQVFCEESGSSPLLQK	2
PEAK1	LENLLLVHYQPGGTAQGFGPAEPTPTSSYPTR	1
DHCR24	LGCQDAFPEVYNKICK	1
SEPTIN11	LTIVDTVGFGDQLNKDDSYKPIVEYIDAQFEAYLQEELK,LKLTIVDTVGFGDQLNK,LTIVDTVGFGDQLNK	3
AGAP1	SLDLDDWPIELIK	1
ABHD10	LLHGMKDDVVPWHTSMQVADR,DDVVPWHTSMQVADR	2
PARP14	SEDVQSIEVQVK	1
MIOS	LTNEMKEDGNLEGILLTGLTK	1
CAPG	MQYAPNTQVEILPQGR	1
MCM3	DSKEPFSSVEIQAALSK	1
PUS3	DCNDTLEEDNTNLETPTKR,DCNDTLEEDNTNLETPTK	2
PKP3	GVGGAVPGAVLEPVAPAPSVR	1
SERPINB2	SLSSAINASTGDYLLESVNKLFGEK	1
MYO1A	VLEELSMSSGELAFGK	1
CRYBG2	QAPGEEGEEPAQPAPHLCGPEESEGWWEPPQGPHPITGCR	1
ACOX1	HQSEMKPGEPEPQILDFQTQQYK	1
REG1B	ESSTDDSNIWIGLHDPKK	1
USP47	EGSVGSTSDYVSQSYSYSSILNK	1
RESF1	MTNTTYSEPAQNSK	1
ZNF318	ELSEGIVDEGASTSIGPHSIDDSNLNHGNR	1
WARS2	KAVTDFTSEVTYDPPGR	1
SCRN1	CICNQLSLTTK	1
MIA2	NLQTQQASLQSENTHFENENQKLQQK,NLQTQQASLQSENTHFENENQK,HSDENSKPSVDTEGPALVEIDR	3
PPTC7	AGGGGGDYGLVTAGCGFGK	1
NBEA	SSHGSGKPQEVPQSVTATAASK	1
SERPINB8	DGDIHQGFQSLLSEVNR	1
CNTLN	AFEDNLIEAR	1
IGKV2D-40	FSDSGSGTDFTLK	1
IGKV2-40	FSDSGSGTDFTLK	1
ARHGAP6	WQGSPAELESDTQGAR	1
KLK1	ILPNDECEK	1
CD5	LSAYPALEGVLHR	1
ABCB11	ILNDLNMAIKPGEMTALVGPSGAGK	1
KIAA1210	SKVPGVVSGAMSGAVLQNVPTSTVWVAGPK	1
LONRF2	ERPLSAENPGGEPEAPGEGGPAPEPR	1
IGHV3-23	DNSQNTVFLQMNSLR	1
H2BS1	AMGIMNSFINDIFER	1
MBLAC2	GDNFETVTWLSDSEVVRAPSPGWR	1
PPFIA1	LHEIGHERDSLQR	1
LPA	YILQGVTSWGLGCACPNKPGVYAR,DKYILQGVTSWGLGCACPNKPGVYAR	2
CHPF2	SPPGPLGAGPDPPSPPGADPSRGAPIGGRFDR	1
MMP12	INNYTPDMNHEDVDYAIR	1
HMGN4	DASTLQSQKAEGTGNAK	1
MTAP	NVDCILLAR	1
GPATCH1	EEERAPESSANQTVNK	1
SLC12A8	SLQSPQEQIILAPSLAK	1
CYFIP1	SGNGEGTPVEHVR	1
H3C14	YRPGTVALEIR	1
NUDCD3	VAMLEENGECVLMEGK	1
NCF1	AAENHQGTLTEYCSTLMSLPTK,QGTLTEYCGTLMSLPTK	2
NOL9	LLQAQAAGVDWR,LLQAQAAGVDWREGAR	2
LAMB3	SFSGLLTMYQR	1
PPIC	VIDGMTVVHSIELQATDGHDRPLTSCSIINSGK	1
PLSCR4	NNSDQMVYVVTEDTDDFTR	1
UGT2B4	IHHDQPVKPLER	1
TCAP	EECEDTPIQLQELLALETALGGQCVDR	1
PARP1	AEMLDNLLDIEVAYSLLR,IAPPEAPVTGYMFGKGIYFSDMVSK	2
SPHKAP	GQSESTEAPASGPPTGTARPQR,GIAGEDTKSPQHSENECR	2
GYS1	KLYESLLVGSLPDVNK	1
HRC	EEEEDDDDDDDDVSTEYGHQAHR	1
CFAP44	SNDEKSPGVEQTGSGGPVGGFLK	1
BLVRA	MNTEPERK	1
ITGA9	SEDCAADLQLR,HVPEEIGLNYVLMADVAK	2
HPD	PLQDRPTLFLEVIQR,QAASFYCSK	2
ACADL	TVAHLQTVQHQLAELK	1
NPNT	CQCPSPGLHLAPDGR,CQCPSPGLHLAPDGRTCVDVDECATGR	2
PTPRS	VILQPIEGIMGSDYINANYVDGYRR	1
GMPPA	MDSESLFKDGNLLPAITILGCR	1
PLBD1	HWDFNIIDKDTSSSR,TLHQGMAEVYNFDFITMKPILK,HWDFNIIDK,IYKHWDFNIIDKDTSSSR	4
D2HGDH	HLHLASPVQESPFYILIETSGSNAGHDAEK,LGHFLEHVLGSGLVTDGTMATDQR	2
MYOF	SKTTEIIHSTLNPTWDQTIIFDEVEIFGEPQTVLQNPPK,DRDNDSDNVESNLLLPAGIALR	2
HABP2	KEEFHEQSFRVQK	1
CDKN1B	VPAQESQDGSGSRPAAPLIGAPANSEDTHLVDPK	1
RPS6KA1	EITPPFKPAVAQPDDTFYFDTEFTSR	1
FBXW8	AKEHMLQTNWK,GEQASGDPALAQGLLEGAGRPPAAR	2
ABR	GDPGRPDPQAESPR,GGGGDSGDPGRPDPEAESPR	2
CLIP2	YSLIDPSSAPELLR	1
CGNL1	LVEEELRDYQR	1
PTPN3	EYFGLQHDDNSVDSPR	1
MMP14	NNQVMDGYPIPIGQFWR	1
LMBRD1	RCDAEAPEDQCTVTR,CDAEAPEDQCTVTR	2
PPP1R12B	LGQTPFDVADEGLVEHLQLLQK	1
FAM160B1	FFTGVMEPQLMQTSEMGILTSTALLHR	1
UNC79	NAASSPSIPSHPSVLSLSTAPLVQVSVEDCSK	1
TMEM132A	KRVEFVTFVPAPPAQSPEEPVGAPAVQSILVAGEEDIR	1
RAB23	IGVFNTSGGSHSGQNSSTLNGGDVINLRPNK	1
ALPK2	HETGTHEEESANQIDEKEHPYKEEESISPGTPR	1
RELL2	GPSPGLPTQEANGEPSKPDTSDHQVSLPQGAGSM	1
COG4	SEDYEQAAAHIHR	1
ZNF614	THTGEKPYMCSQCGK	1
DUSP15	QGSATSASSAGPHSAASEGTLQR	1
CFAP94	EHLTEECTENPNWALLMFSGDR	1
ZMIZ2	SPFLPDLKPNLNSFHSSPSGSGPCDELR	1
ABCD4	SQDCEILGESK	1
BCHE	VLEMTGNIDETEWEWK	1
SERINC2	LPWVCEEGAGIPTVLQGHINCGSLLGYR	1
NAT10	TLHEVSLQESIR	1
MT1X	MDPNCSCSPVGSCACAGSCKCKQCK	1
MMS19	HPAGQQLDEFLQLAVDKVEAGLDSGPCR	1
GRK5	EIFSACAQSVHEYLR	1
VASN	LQDNELQALPPLRLPR	1
TMED5	SGHIQILLR	1
PDCD11	TFLCLSLTGPHKLEEGEVAMGR	1
ACOX2	DSVQHLQTLTQSGADEHEAWNQTTVIHLQAAK	1
HERC1	IPQDTTQTNVTSAEGWWDQESNCQDGYRK,LQFLAGCFGLGTVGHTGAK	2
ARG1	VARTTECDVKDYGDLPFADIPNDSPFQIVK	1
RAI1	ALPTQQALQGRPAFPGYGVQDSSPYPGR,LSYDQQQQQQQQQQALQSR	2
ATP6V0A2	CLIAEVWCPEADLQDLHR	1
MRPL41	DFKDGTFDPDNLEEYGFEPTQEGK	1
QRSL1	DSTTVHEPISKPFMLPSLADVSK	1
UBXN1	GQELGGGQDPVQLLSGFPR,LYVELHRGQELGGGQDPVQLLSGFPR	2
COMMD2	TLLSELAPSLPSYHNLEWR	1
GPAM	HTSEEWGECGFRPTVFR	1
SLC25A15	TFLNVVKNEGITALYSGLKPTMIR	1
TUBGCP2	ERAELAATAVGSSTTSINVPAAASK	1
DLL3	CGPGLRPCAPLEDECEAPPVCR	1
DMXL1	NEDEFGLNEDAEDLPHQSK	1
CROCC	GLTEALAQSSASLNGTR,QALLQAQLEEQLQDK	2
IQSEC1	YCICNSGVVR	1
LDB3	ASGVGLPGGANYQER	1
FHIT	FHDLRPDEVANLFQTTQR	1
DLG5	IASSYYPEGDGDSSHLLAK	1
PTPRN2	TQLHEDLLPR,THTAQDRPPAEGDDRFSESILTYVAHTSALTYPPGPR	2
ABAT	GFSQEELETCMINQAPGCPDYSILSFTGAFHGR	1
FASN	CVLLSNLSSTSHIPEVDPGSAELQK	1
RDH5	VLASCLTPSGAEALQR	1
COL7A1	ELETPLAVPGLR	1
SUSD5	LFVLESQNGSQGLQLEAAR	1
HTATIP2	FFGSLPDSWAR	1
SARDH	AADWLFSADVSRPPGSTVYTCMLNHHGGTESDLTVSR	1
CRTC3	SNASEFQPSFHQADNVR	1
SIRPG	FYPQSLQLTWLENGNVCQR	1
MOGS	LNSWFQHRPPGASPER	1
UQCR10	AFDQGADAIYDHVNEGK	1
PLCB4	EVPSFLQEGTVFDRYEEESFVFEPNCLFK	1
DCAF6	SEGQEESFVPQSSVQPPEGDSETKAPEESSEDATK	1
ENGASE	EEENFTCR	1
CYP2A6	DPSFFSNPQDFNPQHFLDEK,GTEVYPMLGSVLRDPSFFSNPQDFNPQHFLDEK	2
GDA	NYTSMYDK,NYTSMYDKNNLLTNK	2
VAV3	TPIALATGIRPFPTEESINDENIYK	1
ZNF830	EASQGSSASSAPQSVKR	1
KRT15	SLLEGQDAR	1
SCN7A	THNEDHEEEDLKPNPDLEVGK,VLSEIESGFLLANPFK	2
LILRB2	YGCQYYSHAR	1
CTRB2	KITDVMICAGASGVSSCMGDSGGPLVCQK	1
MCM3AP	GASAEELLAQCLSSSLR	1
CWC22	YTSDKDVPSEQNNYSR	1
TPP1	HLFGGNFAHQASVAR	1
ATIC	TVASPGVSVEEAVEQIDIGGVTLLR,VVACNLYPFVKTVASPGVSVEEAVEQIDIGGVTLLR	2
CYP2E1	GTVVVPTLDSLLYDNQEFPDPEK	1
CCM2	AHQLPGHLTQEHDAVLSLSAYNIK	1
SERPINA5	SSEEELHRGFQQLLQELNQPR	1
CDC37	LGPGGLDPIEVYESLPEELQK	1
DNM1	SQLTATSASWIQGILLSQPPSN	1
ZSCAN18	RPHPEDGDEQSLEGVSSSGDSAGLEAGQGPGADEPGLSR	1
SKAP2	IYQFTASSPK	1
C3orf18	LVFTDVANAIHV	1
SORCS3	AGPELLPQQGGGRGSEMQVEAGGTSPAGER	1
POLRMT	QYWEALGAPEALR	1
MEDAG	LQPGAFQLSGDQLVVAGPGEPAAAR	1
HSPA4L	NVVFIDMGHSAYQVSVCAFNKGK,QLGQDLLNSYTENEGK,NVVFIDMGHSAYQVSVCAFNK,LMNETTAVALVYGIYKQDLPPLDEKPR	4
ARFGAP2	EVENRSSGLESSEAR	1
UNC13A	KGEVPPEEQGPSIK	1
SEC14L4	LFPMAFNLVK	1
IGLV10-54	QTATLTCTGNSNNVGNQGAAWLQQHQGHPPK	1
MICALL1	VEQMPQASPGLALR	1
SMG1	IKEQTVPITSHLMELGLTAAK	1
R3HDM1	DNSSFDKDDNQVR	1
CPN2	LTMSIEAR	1
DBT	LGSVGQLSTTDLTGGTFTLSNIGSIGGTFAK	1
LPCAT3	LVQGELTDIPGKIPNSIIPALK	1
ARHGAP12	HSTIVLDTNDKESPTASKPCSPENESSPSSPK	1
PPIF	HVGLGVLSMANAGPNTNGSQFFICTIK	1
KIZ	VAVQEGINSGTAMSR	1
XIRP1	ETALSVQAPRPLQGGPGQSTGPGREEPGGCTQMTWGPPGK,EILVDEKDFQPSPDLIPPGPDVQQQR	2
CRTC2	TVAWGNFPAEK	1
MTMR7	AALGTLYLTATHVIFVENSPDAR	1
LCP1	VNDDIIVNWVNETLREAEK	1
HTR2A	QYSEEASKDNSDGVNEK	1
ALDH3A1	LIQEQEQQLVGALAADLHK	1
DDX18	SPQKSTVLSNGEAAMQSSNSESK,STVLSNGEAAMQSSNSESKK,STVLSNGEAAMQSSNSESK	3
IGLV3-16	KYAYWYQQKPGQAPVLVIYK	1
PALD1	QVQGGLTVFGMGQPSLLGFR	1
DUOX2	IPPGDLVFDPDQR,IPPGDLVFDPDQRGDVVLPFQR	2
ACO1	KYLQAVGMFRDFNDSSQDPDFTQVVELDLK	1
FAM20C	DGLHSVVDDDLDTEHR	1
ABCA6	NISFCVQEGEILGLLGPSGAGK	1
PEPD	ASFFNREVLQR	1
SCARF2	AATDLPGPETPR	1
PPFIBP1	LNATEEMLQQELLSR	1
EFL1	LAAAQGQAPLEPTQDGSAIETCPKGDEPR	1
UPK3BL2	WSSDTHLQQAQALR	1
UPK3BL1	WSSDTHLQQAQALR	1
SETD6	QSVQAGELLFVVPR	1
FER1L6	LSSDDFLGTLEMNLNSFPQAAK	1
LMTK3	SAPATSRPGSAPTPGAPGEADLR	1
CLCNKB	EGSSGNPVTLQELWGPCPLIR	1
GLOD4	LLDDAMSADKSDEWFAK,LLDDAMADDKSDEWFAK	2
PODXL	GGSSGNPTTTIESPK	1
UGT2A2	AFITHGGTNGIYEAIYHGVPMVGIPIFADQPDNIAHMK	1
UGT2A1	AFITHGGTNGIYEAIYHGVPMVGIPIFADQPDNIAHMK	1
IBTK	SLDVLSNGVLKDLSEFYR	1
CRACD	LEMHREPADTTEGCK,RQEILEEEGEGQEPPLEAER	2
EXD2	ALLNAESLPTHR	1
B3GLCT	LQHLLSCYDSGKPVFLGER	1
IGKV3D-11	ASQGVSSYLAWYQQKPGQAPR	1
CADM4	LEDEGGYFCQLYTEDTHHQIATLTILVAPENPVVEVR	1
C17orf97	GFHPDPEALKGFHPNPEALK	1
TBC1D20	LLNVNASDPPPISGK	1
PLEKHG3	TTSPGGRPSAWSPLSPTETFSWPDVR	1
CAVIN2	VLIFQEENEIPASVFVKEPVSGAVEGK,EPVSGAVEGKEELPDENK	2
PKD1	VLTTGPTPSSFPR	1
EHD4	SISIIDSPGILSGEK	1
POLE4	EEEVPAGEAAASQPQAPTSVPGAR	1
CEP290	QNDHYQLQVQELTDLLK	1
FLNC	CTYRPAMEGPHTVHMAFAGAPITR	1
TDRKH	AVPNMLKDMATETDASLSTLLTETK	1
IPO4	AVGEPMRPLAEECCQLGLGLCDQVDDADLRR	1
TANK	AACLPPGDHNALYVNSFPLLDPSDAPFPSLDSLGK	1
SIGLEC1	FAAITLTQAGAYHCQAQAPGSATTSLAVPISLHVSYAPR	1
SACM1L	LEEQDEFEKIFK,LGVLHVGQKLEEQDEFEKIFK	2
EIF3A	GMDDDWGPR	1
ZSCAN2	LQGHTPGEDHGEVVSQDR	1
GNLY	VIQGLVAGETAQQICEDLR	1
GPC6	DESMTAGTSNEEECWNGHSK	1
C16orf89	QQEGCFGEPDAEDEESSK	1
TNN	NTEDSLLVSWEPSSQVNHYLLSYYPLGK	1
UGT1A4	ITLGYTQGFFETEHLLK	1
TAF4	LRPPPEGSAGACAPVPAAAAVAAGPEPAPAGPAK	1
CFAP52	ETLIATCHFDAVK	1
DMKN	QVPGFGAADALGNR	1
UGT2B10	GHEVTVLASSASILFDPNYSSTLK	1
DCC	VVVLPSGALQISGLQPGDIGIYR	1
AKR1B10	ACNVLQSSHLEDYPFDAEY	1
GPATCH2	IQNEGVVLESEETNQTNK	1
ITIH3	ILEDMKEEDYLNFILFSGDVSTWK,EHLVQAMPENLQEAR	2
IGHV5-51	ASDTAMYYCVR	1
SUCLA2	SFQGPVLIGSSHGGVNIEDVAAETPEAIIK,SFQGPVLIGSSHGGVNIEDVAAETPEAIIKEPIDIEEGIK	2
CLEC3B	GGTLSTPQTGSENDALYEYLR	1
FUT6	DLAGYLQELDKDHAR	1
CFAP46	MSGDEAVNQGEASQTLK	1
MYH4	IEDEQALAMQLQK	1
IGLV1-36	VTISCSGSSSNIGNNTVNWYQQLPGKAPK	1
MOGAT2	VEFAPLFVPWER	1
PDE6D	FFDNDLLVSTSR	1
SQOR	ALQNFKEGNAIFTFPNTPVK	1
VILL	EVVDGSPAAASTISEITAEVNNFR	1
PAH	HGSEPMYTPEPDICHELLGHVPLFSDR	1
PTGES2	HHLQDNVREDLYEAADKWVAAVGK	1
TEKT2	VLCNETNNQTIWDEHDNR	1
SYTL3	LGSKGDTAVGGDACSQSK	1
SLC16A4	NLTVSQNQSEEFYHGPNR	1
OGDH	LLDTAFDLDIFK	1
GGCX	KLVSYCPQR	1
NASP	QEPEVNGGSGDAVLSGNEVSENMEEEAENQAESR	1
CCN3	VTNRNHQCEMLKQTR	1
CAVIN3	MRESALEPGPVPEAPAGGPVHAVTVVTLLEK,ESALEPGPVPEAPAGGPVHAVTVVTLLEK	2
PRELP	INGTQICPSDLVAFHDFSSDLENVPHLR	1
PIGQ	AFFPTCCVSADSGLLVGR	1
KIAA1671	TPVPQEEAGQDHPPSK	1
SREBF2	GDFAAAAANLQTCLAVLGR	1
RAB3IL1	ESPGALVETSAGEEAR	1
ADPGK	APQEFMTSHLEAGSR	1
DCTN1	EQLDMAGAQVR	1
GLMP	LLHTADTCQLEVALVGASPR	1
F13B	IQENMHYGCASGYK	1
KRT1	GSYGSGGGSYGSGGGGGGHGSYGSGSSSGGYR	1
ATG4B	KLSLLGGALPMFELVEQQPSHLACPDVLNLSLDSSDVER	1
UTP14A	ASSEGTIPQAQR	1
SGSM2	HSSGSASEDKLAACAR	1
FLVCR1	AGTFPVNGPPRDSLAAASGVLGGPQTPLAPEEETQAR	1
PRKCSH	SEALPTDLPTPSAPDLTEPK	1
FAM234A	LGEGGPNSDQAIRDR	1
MRM3	VVFPSEEVVEQK	1
SDSL	IQAEGCLPPSLTSVVVIVCGGNNINSR,RIQAEGCLPPSLTSVVVIVCGGNNINSR	2
STN1	EIHATAYYK	1
CDH3	ATYLIMGGDNGDHFTITTHPESNQGILTTR	1
SHCBP1	TGWAVEQELASLEK	1
APC	DFNDKLPNNEDR	1
EGFR	ATGQVCHALCSPEGCWGPEPK	1
CCDC154	RPGGVPEKPHSR	1
GNAS	VPSLGYGSPAAGAASADTAAR	1
PYROXD1	FVVVGGGIAGVTCAEKLATHFPSEDILLVTASPVIK	1
KPRP	LRPEPSISLEPR	1
TYW3	QLQDAQILHSVAIDSGFR	1
KLF16	GRPGPEGAGPTAGLDVR	1
KLKB1	ITQQMVCAGYK	1
MTARC1	DCGEAAAQWITSFLK	1
PI16	AQVSPPASDMLHMR	1
ALKBH3	KKPPPEENGEYTYVER	1
COPE	APPAPGPASGGCGEVDELFDVK	1
NCAPG2	EPPEDEEEEDGRQK	1
UTP20	QAELVPATVNDYK	1
PAPLN	ARDEGSYMCSAYQGSQAVSR	1
HPSE2	TLVIPPVTMGFFVVK	1
CFAP74	VVGVAIDLPVWVPKPSVDLK	1
CNDP1	AIHLNLEEYR	1
PGAM4	HVEGLSEEANMELNLPTGIPIVYELDK	1
GCAT	GILEGELEGICGAGTWK	1
AP3D1	LLESGDLSMSSVK	1
TACC3	ALNSASTSLPTSCPGSEPVPTHQQEQPALELK	1
ALG8	SYCFTASKPDGSIR	1
ANKRD22	NPSLIPLLLEAR	1
HEPACAM	VLMEDDDLYSCVVENPISQGR	1
FBLN2	GCIDMNECWASPGR	1
CA1	SLLSNVEGDNAVPVQHNNRPTQPLK	1
PLS1	HLMPMNPNDDSLFK	1
CAPN7	TSYETTDKVLQNK	1
KLHL15	LDTFLLDNFVPLMSRPDFLSYLSFEKLMSYLDNDYLSR	1
RASAL1	GLAGHFLDYLTRR,GLAGHFLDYLTR	2
MBIP	AAATEHNRPSSGDR	1
STYXL2	SRNWEDVEESSK,NWEDVEESSK	2
CAPN5	QPSNLPGTVAVHIISSTSLMAV	1
IGLC7	ATLVCLVSDFYPGAVTVAWK	1
ALB	AAFTECCQAADKAVCLLPK	1
APBA3	ESGIDPSQVGVHPSPGAR	1
RINL	AGAGPPGAQGPGPEGQSLAPALR	1
CALB2	QHVGSSTEFMEAWR	1
ABCA5	ASLVSTMSLWK	1
PTPN18	RGAPAGAGSGTQTGTGTGAR,GAPAGAGSGTQTGTGTGAR	2
HADH	KFAENPKAGDEFVEK,FAENPKAGDEFVEK	2
UGT1A6	GFPCSLEHAFSSSPDPVSYIPR	1
TM9SF1	WSETSVEHR	1
THG1L	LQGTLAADKNEILFSEFNINYNNEPPMYR	1
TMPRSS4	VVGGEEASVDSWPWQVSIQYDK	1
CELA2B	IVVHKDWNSNQVSK,LQTNGALPDDLKQGR	2
VEZT	TEYLCENALEGK	1
MPC2	LLNKVELMLPEK	1
CILP	RKEPITLEAMETNIIPLGEVVGEDPMAELEIPSR	1
PLEKHA6	CLSLQAEHAGVR	1
UBA6	EIFISNITQTNPGIVTCLENHPHK,EIFISNITQTNPGIVTCLENHPHKLETGQFLTFR	2
ARHGEF37	VQPPPTTQLLLPGSER	1
LVRN	LQFIDDAFSLSK	1
MLH1	KMLHNHSFVGCVNPQWALAQHQTK	1
CD200	EQLYTTASLK	1
DEGS2	NDFEWVYTDQPHTQR	1
TGFBI	GDNHFSMLVAAIQSAGLTETLNR	1
AKAP10	MIVSDVMQQAQYDQPLEK	1
CFI	HPTIQGFASVAQEETEILTADMDAER	1
PCDHB7	TVCSIQDDLPFILKPSVENFYTLVTEKPLDR	1
GRIN2C	ALREAPLGLR	1
DNPEP	LEQQLVHVERPVLR	1
OTUD7A	DAATAAAAAAAAAATAK	1
MOXD1	CASIPDIMQQLQFIGVK	1
WDR81	LVAGEDDLEQATEALDSISLAGK,DRLVAGEDDLEQATEALDSISLAGK	2
EPS8	GFNPVTVNSLGVLNGAQLFSLNKEELR	1
RNASEH2A	LQDSDTDYGSGYPNDPK	1
ERMP1	EAGAQEPLVDGCSGGGR	1
SLC25A4	VFKSDGLRGLYQGFNVSVQGIIIYR	1
FCGR2A	LEPPWINVLQEDSVTLTCWGAR	1
HCFC1	ISVATGALEAAQGSKPQCQTR	1
PXK	SALENSEEHSAR	1
TNS2	NNPSVSVDYNTTEPAVR	1
IKBIP	FLSLESDR	1
AMPD2	ASLQASTTAPEAR	1
HERPUD1	VYPERPHPEDQR	1
WDR91	NASLSQSLRVGFLSSLLPQSK	1
PARP9	SPAINLMGFNVEEMCEAHAWIQR	1
FECH	LFLDQDLMTLPIQNK	1
GPCPD1	SAGILILPIMSR	1
IRF2BPL	YGLSAAAAAAAAAAAVEQR	1
KRT83	LSEGVEAVNVCVSSSR	1
GNA12	GNPHRLEDVQR	1
FGGY	AALVDQSGVLLAFADQPIKK	1
IRAK4	LAAMVDITTEELKQQFNQEIK,MNDADSTSVETMYSVASQCLHEK	2
CASP1	DSVGVSGNLSLPTTEEFEDDAIR	1
ERVW-1	EVISQLTQVHGTSSPYK	1
COL4A2	IAIQPGTVGPQGR	1
MCAT	KPLVSVYSNVHGHR	1
CPAMD8	KLCAGPACNEVER	1
SHMT2	GWTGQESLLDSDPEMWELLQR	1
DNAI4	TMLIPPELK	1
LPP	EPGYTPPGAGNQNPPGMHPVTGPK,REPGYTPPGAGNQNPPGMHPVTGPK	2
CYP11A1	HQAQGDMATMLQLVLLLK	1
OGDHL	MVDWALAEYMAFGSLLK	1
PLEKHM2	LQSYFAACEDETPAIR,KLQSYFAACEDETPAIR	2
RPL10	YIPNRGPLDKWR	1
ZPR1	NEVLQFSTNCPECNVPAQTNMK	1
JMJD1C	IHEDEVDDMEEN	1
WDR47	VLPFNAETCNATVSGPDLEFSMHDGTIR	1
EXOC4	TLSTSDDVKDRENEK	1
C12orf66	VFASLKPGSKG	1
PFKM	LQAAYNLVK	1
CD2	KPQQIPASTPQNPATSQHPPPPPGHR	1
ACOT1	GFAVMALTYYNYEDLPK	1
IST1	GGSGGFTAPVGGPDGTVPMPMPMPMPSANTPFSYPLPK	1
CRACR2A	GDEDLGDMGKDEEAQFR	1
CASR	NAMAHGNSTHQNSLEAQK	1
KCTD3	AGGHCGSVPAAAAGSGEIVQLNVGGTR	1
PRSS35	EASGGDQREGTREHLQER	1
SGPL1	AFEPYLEILELYSTK	1
ADAM15	ESVHTQTPPEHPLGQR	1
CTSS	SNPNWILPDSVDWR	1
MTSS1	DAPQGEDMLNAIR	1
CARD19	YLLAFLADDLGR	1
TBCK	VDIPPLIR	1
TOPORS	EEGEAPSPAPASEGR	1
STK11IP	KQGEQSLAPSPFASPVCHPPGHGDHLDR	1
SLC4A1	VYVELQELVMDEKNQDLR	1
PDZRN3	AVEGISCPSSEGAVGTTEAYGPASK	1
LIMCH1	MPEANQLHLPNLNSQESPGTASVLLR	1
AHDC1	AASYGLTPATSDCR	1
CEP85	ETEFSSAGHSLQDK	1
UNC13D	NGVLALDNFHR	1
LMAN1	NSLSETVR	1
SLFN13	EQDAEGQDYCTLTAFTLK	1
SLFN11	EQDAEGQDYCTLTAFTLK	1
PLPP7	GPYEMSPSLLDYLTMDIYAFPAGHASR	1
GATM	HGGHYFPKDHLK	1
TK2	GSLFPMAAPLLVIEADHHMER	1
TMEM143	LQALYDPINPDRETLDQPSLTNPQR	1
CEP57	VLDEHIQER	1
SLCO1B3	IYVDIGYVDLSTIR	1
KYNU	GCQLTITFSVPNEDVFQELEKR	1
CELSR1	FDAIHEEFPR,EEQGSHRGQYPPDQESGGAAR	2
IGSF1	CKGWLAGMAFALYKEGEQEPVQQLGAVGR	1
AFM	ETLLNHFLYEVAR	1
ZFYVE26	FPSESPQHIAHPER	1
PYCR3	GRHVGSSETNLLQHLLEACGR,HVGSSETNLLQHLLEACGR	2
MTUS1	QINDLKSQNDALNEK	1
PDIA3	SDVLELTDDNFESLISDTGSAGLMLVEFFAPWCGHCKR	1
HNF1A	EALLQALGEPGPYLLAGEGPLDKGESCGGGR	1
PNLIPRP2	LLPWSPEHIDTR	1
RTF2	AEVCHTCGAAFQEDDVIVLNGTKEDVDVLK	1
EID2	SKLPTDSSVPQTGAANGDRDVPQAEVGR	1
TRIP10	HARPPDSPASAPPDSSSNSASQDTK	1
ANKRD24	QLEAASACLDEAR	1
ACAD9	DSLGQTVDLGLTGNHGVVHPSLADSANKFEENTYCFGR	1
RIMBP2	VYGNKDADGFYR	1
SMC5	VAALNIQVGNLCEFLPQDKVGEFAK	1
CEP350	GFLPIEIR	1
SART3	AGPKAEGEEDEVK	1
RRAD	DLQAALTPGALTAAAAGTGTPGPR	1
NRXN1	YVCDCSGTGYIGR	1
ABCC8	HVNALISPGQK	1
AAK1	KKSMEELTVIQCTSQELPAQTGLLSQTGDVPLPASR	1
CYB5A	MAEQADEAVKYYTLEEIQK	1
PTPN21	FQDVLPYDDAR	1
KCP	GHVECYLEECQALSCPHGWAK	1
DMRT2	CGPISDTLLYQQCLLNATTSVQALKPGASWDLKGPR	1
RNF25	DTQELPPPEGPLKEPMDLKPQPHSQGVEGPPQEK	1
NUP160	LAYSPAMGLYLGIYMHAPK	1
KDM5A	AQEAMTDETPDSSK	1
FBP2	KLDVLSNSLVINMLQSSYSTCVLVSEENKDAIITAK	1
FOXD2	AFYPASLSPPAAGTAAGLPTALLR	1
C2orf69	QCLQLSTVPGAEPQR	1
IGHV1-2	QAPGQGLEWMGR	1
PARD3B	EVLNGVQTELLTSPK	1
HNRNPC	QAVEMKNKSEEEQSSSSVK	1
EIF2A	NTVLATWQPYSTSK	1
ZPBP2	ILDILISDLSCHVIEPSYK	1
DHTKD1	HAMVVCQETDDTYIPLNHMDPNQK	1
GALNT4	FNSVTELCAEIPEQK	1
TLN2	QAAAAATQTIAAAQNAAVSNKNPAAQQQLVQSCK	1
PRAP1	AWMETEDTLGR	1
